"ID","DATE.OF.INTERVIEW","Families_on_the_plot","adults.using.toilet","children.using.toilet","people.using.toilet","People_on_the_plot","Landlord.live.in.the.plot.","How.many.people.use.the.toilets.on.this.plot...Children...Male","How.many.people.use.the.toilets.on.this.plot...Children...Female","How.many.people.use.the.toilets.on.this.plot...Adults...Male","How.many.people.use.the.toilets.on.this.plot...Adults...Female"
"1","2017-03-20",4,7,17,24,25,"Yes",4,13,3,4
"2","2017-03-20",4,15,7,22,22,"No",4,3,8,7
"3","2017-03-20",13,17,21,38,38,"No",10,11,7,10
"4","2017-03-20",4,7,6,13,14,"Yes",NA,6,4,3
"5","2017-03-20",4,9,9,18,12,"Yes",5,4,4,5
"6","2017-03-20",7,3,3,6,6,"No",2,1,2,1
"7",NA,2,4,4,8,8,"Yes",NA,4,2,2
"8","2017-03-20",7,10,9,19,19,"Yes",4,5,6,4
"9","2017-03-20",4,8,4,12,8,"Yes",1,3,3,5
"10","2017-03-20",3,5,2,7,7,"No",2,0,3,2
"11","2017-03-20",2,4,9,13,14,"No",7,2,2,2
"12","2017-03-20",2,7,4,11,12,"Yes",1,3,6,1
"13","2017-03-20",NA,270,120,390,NA,"No",40,80,120,150
"14","2017-03-20",6,8,9,17,17,"No",4,5,3,5
"15","2017-03-27",10,22,11,33,50,"Yes",8,3,13,9
"16","2017-03-20",13,24,8,32,31,"Yes",2,6,11,13
"17","2017-03-20",3,7,4,11,11,"Yes",2,2,2,5
"18","2017-03-20",1,7,2,9,9,"Yes",1,1,6,1
"19","2017-03-20",5,20,10,30,25,"Yes",4,6,4,16
"20","2017-03-20",4,7,9,16,16,"Yes",5,4,4,3
"21","2017-03-20",4,9,10,19,19,"Yes",6,4,5,4
"22","2017-03-20",NA,70,29,99,NA,"Yes",13,16,30,40
"23","2017-03-20",5,11,12,23,13,"Yes",9,3,7,4
"24","2017-03-20",4,8,5,13,13,"Yes",2,3,2,6
"25","2017-03-20",1,2,4,6,5,"Yes",2,2,1,1
"26","2017-03-20",3,9,6,15,15,"No",1,5,6,3
"27",NA,5,8,3,11,11,"Yes",2,1,5,3
"28","2017-03-20",1,2,5,7,7,"Yes",4,1,1,1
"29","2017-03-20",10,28,12,40,38,NA,4,8,15,13
"30","2017-03-20",NA,6,16,22,NA,"No",7,9,3,3
"31","2017-03-20",7,16,7,23,23,"Yes",4,3,8,8
"32",NA,8,20,21,41,NA,"No",15,6,16,4
"33","2017-03-20",1,4,1,5,3,"Yes",NA,1,2,2
"34","2017-03-20",1,2,4,6,6,"Yes",1,3,1,1
"35","2017-03-20",5,10,8,18,18,"No",4,4,6,4
"36","2017-03-20",3,5,7,12,12,"No",6,1,1,4
"37","2017-03-20",4,8,1,9,9,"Yes",1,0,4,4
"38","2017-03-20",5,8,8,16,16,"No",3,5,4,4
"39","2017-03-20",6,18,4,22,18,"Yes",2,2,10,8
"40","2017-03-20",NA,4,0,4,NA,"No",0,0,1,3
"41","2017-03-20",3,8,11,19,16,NA,4,7,3,5
"42","2017-03-20",NA,7,6,13,9,"Yes",2,4,5,2
"43","2017-03-20",4,8,15,23,22,"Yes",7,8,4,4
"44","2017-03-20",3,12,7,19,19,"No",4,3,6,6
"45","2017-03-20",NA,25,0,25,NA,"No",0,0,12,13
"46","2017-03-20",1,2,2,4,4,"Yes",1,1,1,1
"47","2017-03-20",2,4,1,5,5,"Yes",1,0,2,2
"48","2017-03-20",4,5,0,5,23,"Yes",0,0,2,3
"49","2017-03-20",2,437,11,448,17,"Yes",5,6,3,434
"50","2017-03-20",3,7,7,14,14,"Yes",1,6,3,4
"51","2017-03-20",NA,17,0,17,NA,"No",NA,NA,15,2
"52","2017-03-20",6,14,12,26,26,"No",5,7,7,7
"53","2017-03-20",7,14,18,32,40,"No",10,8,7,7
"54","2017-03-20",NA,16,27,43,9,"No",13,14,8,8
"55","2017-03-20",3,7,2,9,9,"Yes",0,2,4,3
"56","2017-03-20",1,4,2,6,6,"Yes",1,1,1,3
"57","2017-03-20",8,20,1,21,22,"Yes",1,0,10,10
"58","2017-03-20",1,2,4,6,6,"Yes",4,NA,1,1
"59","2017-03-20",6,9,7,16,15,"Yes",4,3,5,4
"60","2017-03-20",2,7,1,8,8,"Yes",NA,1,2,5
"61","2017-03-20",2,8,4,12,11,"Yes",1,3,4,4
"62","2017-03-20",6,11,4,15,15,"Yes",3,1,8,3
"63","2017-03-20",5,10,19,29,29,"Yes",12,7,5,5
"64","2017-03-20",1,6,3,9,9,"Yes",1,2,3,3
"65","2017-03-20",4,12,4,16,16,"Yes",2,2,5,7
"66","2017-03-20",3,7,8,15,16,"Yes",5,3,3,4
"67","2017-03-20",7,14,7,21,21,"No",3,4,8,6
"68","2017-03-20",3,8,7,15,14,"Yes",6,1,4,4
"69","2017-03-20",15,34,12,46,46,"Yes",6,6,21,13
"70","2017-03-20",2,4,6,10,10,"Yes",2,4,2,2
"71","2017-03-20",4,8,7,15,15,"No",3,4,4,4
"72",NA,1,3,7,10,10,"No",3,4,NA,3
"73","2017-03-20",1,4,0,4,5,"Yes",0,0,3,1
"74","2017-03-20",7,13,11,24,24,"Yes",7,4,6,7
"75","2017-03-20",5,8,15,23,23,"No",4,11,3,5
"76","2017-03-20",12,8,7,15,12,"No",2,5,4,4
"77","2017-03-20",3,8,4,12,12,"Yes",2,2,5,3
"78","2017-03-20",4,12,3,15,21,"Yes",0,3,6,6
"79","2017-03-20",6,11,10,21,21,"Yes",5,5,5,6
"80","2017-03-20",4,8,2,10,10,"Yes",2,0,4,4
"81","2017-03-20",4,9,8,17,16,"Yes",4,4,2,7
"82","2017-03-20",3,8,11,19,19,"Yes",3,8,3,5
"83","2017-03-20",2,4,5,9,9,"No",NA,5,3,1
"84","2017-03-20",3,4,8,12,12,"Yes",6,2,1,3
"85","2017-03-20",2,2,3,5,7,"Yes",1,2,2,NA
"86","2017-03-20",1,6,12,18,185,"Yes",6,6,2,4
"87","2017-03-20",3,5,8,13,13,"No",4,4,2,3
"88",NA,5,10,7,17,17,"No",3,4,5,5
"89","2017-03-20",3,11,10,21,21,"Yes",6,4,7,4
"90","2017-03-20",8,16,1,17,21,"Yes",1,0,7,9
"91",NA,4,7,7,14,14,"Yes",5,2,4,3
"92","2017-03-20",3,7,10,17,17,"Yes",4,6,2,5
"93","2017-03-20",5,8,6,14,15,"No",2,4,4,4
"94","2017-03-20",5,8,12,20,19,"Yes",6,6,4,4
"95","2017-03-20",4,11,9,20,20,"No",5,4,4,7
"96","2017-03-20",2,4,10,14,17,NA,4,6,2,2
"97","2017-03-20",1,4,3,7,7,"No",1,2,3,1
"98","2017-03-20",5,7,4,11,11,"Yes",2,2,3,4
"99","2017-03-20",2,9,6,15,15,"Yes",3,3,5,4
"100","2017-03-20",56,8,2,10,10,"Yes",2,0,6,2
"101","2017-03-20",3,6,3,9,9,"Yes",3,0,2,4
"102","2017-03-20",3,5,4,9,9,"Yes",3,1,4,1
"103","2017-03-20",1,2,5,7,7,"Yes",4,1,1,1
"104","2017-03-20",4,8,4,12,12,"Yes",2,2,4,4
"105","2017-03-20",1,3,5,8,8,"Yes",2,3,1,2
"106","2017-03-20",1,4,2,6,6,"Yes",NA,2,2,2
"107","2017-03-20",NA,3,0,3,NA,"Yes",0,0,2,1
"108","2017-03-20",8,16,7,23,24,"No",4,3,7,9
"109","2017-03-20",3,8,7,15,15,"Yes",5,2,5,3
"110","2017-03-20",2,4,10,14,14,"No",6,4,2,2
"111","2017-03-20",6,11,5,16,14,"Yes",3,2,3,8
"112","2017-03-21",5,12,3,15,17,"No",0,3,4,8
"113","2017-03-21",4,6,1,7,7,"Yes",0,1,3,3
"114","2017-03-21",2,5,2,7,7,"No",1,1,2,3
"115","2017-03-21",7,15,6,21,21,"Yes",2,4,7,8
"116","2017-03-21",3,5,8,13,17,"Yes",4,4,2,3
"117","2017-03-21",4,9,7,16,16,"Yes",3,4,4,5
"118","2017-03-21",4,9,2,11,19,"No",0,2,4,5
"119","2017-03-21",2,8,4,12,12,"Yes",1,3,2,6
"120","2017-03-14",2,6,5,11,8,"No",1,4,4,2
"121","2017-03-21",NA,40,0,40,NA,"No",0,0,30,10
"122","2017-03-21",6,11,3,14,14,"Yes",2,1,7,4
"123","2017-03-21",5,12,4,16,18,"Yes",3,1,8,4
"124","2017-03-21",1,2,2,4,1,"Yes",NA,2,1,1
"125","2017-03-21",3,7,4,11,17,"No",1,3,3,4
"126","2017-03-21",4,12,7,19,19,"Yes",4,3,6,6
"127","2017-03-21",5,3,5,8,8,"Yes",2,3,2,1
"128","2017-03-21",NA,25,19,44,NA,"Yes",10,9,13,12
"129","2017-03-21",8,16,7,23,23,"Yes",3,4,9,7
"130","2017-03-21",5,11,9,20,29,"Yes",3,6,7,4
"131","2017-03-21",2,5,4,9,9,"Yes",4,0,3,2
"132","2017-03-21",2,10,8,18,18,"Yes",4,4,7,3
"133","2017-03-21",1,7,0,7,8,"Yes",0,0,3,4
"134","2017-03-21",1,2,2,4,3,"No",1,1,1,1
"135","2017-03-21",8,20,16,36,30,"No",5,11,12,8
"136","2017-03-21",10,20,28,48,48,"Yes",11,17,10,10
"137","2017-03-21",4,11,4,15,12,"No",2,2,7,4
"138","2017-03-21",7,13,7,20,20,"No",4,3,5,8
"139","2017-03-21",2,4,2,6,6,"Yes",1,1,2,2
"140","2017-03-21",1,3,3,6,6,"Yes",1,2,2,1
"141","2017-03-21",NA,5,12,17,NA,"Yes",8,4,3,2
"142","2017-03-21",8,16,15,31,38,"Yes",5,10,8,8
"143","2017-03-21",4,12,12,24,24,"Yes",8,4,5,7
"144","2017-03-21",6,10,4,14,15,"Yes",0,4,4,6
"145","2017-03-21",4,7,7,14,14,"Yes",3,4,3,4
"146","2017-03-21",3,5,5,10,10,"No",2,3,3,2
"147","2017-03-21",1,6,0,6,6,"No",NA,NA,3,3
"148","2017-03-21",7,9,13,22,20,"Yes",4,9,5,4
"149","2017-03-21",1,4,6,10,9,"Yes",4,2,1,3
"150","2017-03-21",6,13,5,18,18,"No",3,2,7,6
"151","2017-03-21",4,8,3,11,11,"Yes",1,2,4,4
"152","2017-03-21",3,13,5,18,18,"Yes",3,2,6,7
"153","2017-03-21",4,6,1,7,13,"No",0,1,4,2
"154","2017-03-21",2,5,4,9,7,"Yes",3,1,2,3
"155","2017-03-21",5,14,7,21,21,"Yes",4,3,6,8
"156","2017-03-28",4,11,7,18,19,"No",0,7,8,3
"157","2017-03-21",3,6,2,8,11,"No",0,2,3,3
"158","2017-03-21",4,7,7,14,14,"Yes",4,3,3,4
"159","2017-03-21",8,15,6,21,21,"No",1,5,10,5
"160","2017-03-28",6,14,10,24,25,"Yes",6,4,8,6
"161","2017-03-21",5,4,5,9,8,"Yes",2,3,2,2
"162","2017-03-21",12,20,5,25,25,"Yes",2,3,14,6
"163","2017-03-21",5,9,7,16,17,"No",3,4,6,3
"164","2017-03-21",2,6,5,11,12,"No",1,4,3,3
"165","2017-03-21",3,13,7,20,22,"No",2,5,7,6
"166","2017-03-21",5,12,12,24,24,"Yes",7,5,6,6
"167","2017-03-21",NA,12,0,12,NA,"No",NA,NA,7,5
"168","2017-03-21",1,2,3,5,4,"Yes",1,2,1,1
"169","2017-03-21",1,2,3,5,5,"No",2,1,1,1
"170","2017-03-21",1,2,2,4,4,"Yes",1,1,1,1
"171","2017-03-21",7,13,14,27,27,"Yes",6,8,5,8
"172","2017-03-21",5,10,5,15,16,"Yes",4,1,5,5
"173","2017-03-21",3,11,10,21,21,"Yes",4,6,5,6
"174","2017-03-21",6,9,6,15,18,"Yes",3,3,4,5
"175","2017-03-21",2,7,5,12,12,NA,3,2,4,3
"176","2017-03-21",2,6,4,10,10,"Yes",2,2,3,3
"177","2017-03-21",4,7,3,10,10,"Yes",3,0,4,3
"178","2017-03-21",6,11,4,15,19,"No",1,3,6,5
"179","2017-03-21",1,6,0,6,6,"Yes",0,0,5,1
"180","2017-03-21",7,10,11,21,32,"No",4,7,5,5
"181","2017-03-21",3,3,5,8,8,"Yes",2,3,1,2
"182","2017-03-21",13,23,20,43,44,"Yes",16,4,12,11
"183","2017-03-21",4,10,13,23,23,"Yes",7,6,4,6
"184","2017-03-21",6,11,11,22,22,"Yes",6,5,7,4
"185","2017-03-21",NA,13,300,313,NA,"No",120,180,6,7
"186","2017-03-21",7,9,7,16,13,"Yes",6,1,5,4
"187","2017-03-21",3,5,2,7,7,"Yes",1,1,3,2
"188","2017-03-21",2,4,8,12,12,"No",6,2,2,2
"189","2017-03-21",4,8,2,10,10,"No",0,2,4,4
"190","2017-03-21",1,5,1,6,8,"Yes",1,0,3,2
"191","2017-03-21",7,12,11,23,23,"Yes",5,6,7,5
"192","2017-03-21",7,10,7,17,16,"No",1,6,5,5
"193","2017-03-21",4,16,12,28,28,"Yes",4,8,7,9
"194","2017-03-21",4,11,0,11,14,"No",0,0,6,5
"195","2017-03-21",8,12,3,15,15,"Yes",2,1,6,6
"196","2017-03-21",3,3,5,8,8,"No",2,3,2,1
"197","2017-03-21",3,6,3,9,9,"No",1,2,3,3
"198","2017-03-20",2,4,2,6,6,"Yes",1,1,2,2
"199","2017-03-21",4,12,6,18,18,"Yes",3,3,9,3
"200","2017-03-21",9,13,23,36,28,"No",14,9,8,5
"201","2017-03-21",4,12,6,18,15,"Yes",1,5,7,5
"202","2017-03-21",4,11,4,15,15,"Yes",1,3,5,6
"203","2017-03-21",3,4,5,9,91,"No",1,4,1,3
"204","2017-03-21",5,7,0,7,16,"No",0,0,2,5
"205","2017-03-21",6,14,8,22,22,"No",5,3,6,8
"206","2017-03-21",4,11,8,19,19,"Yes",3,5,6,5
"207","2017-03-21",6,11,5,16,16,"Yes",3,2,3,8
"208","2017-03-21",5,9,9,18,18,NA,3,6,4,5
"209","2017-03-21",3,5,6,11,11,"No",4,2,2,3
"210","2017-03-21",5,10,12,22,22,"Yes",7,5,5,5
"211","2017-03-21",NA,1,0,1,NA,"No",0,0,1,0
"212","2017-03-21",1,2,10,12,12,"Yes",6,4,1,1
"213",NA,NA,70,0,70,NA,"No",NA,NA,50,20
"214","2017-03-21",2,9,5,14,18,"Yes",3,2,3,6
"215","2017-03-21",3,6,8,14,14,"No",5,3,3,3
"216","2017-03-21",14,22,16,38,38,"Yes",10,6,12,10
"217","2017-03-21",4,13,5,18,20,"Yes",3,2,8,5
"218","2017-03-21",10,19,14,33,46,"Yes",6,8,9,10
"219","2017-03-21",7,14,15,29,20,"Yes",5,10,7,7
"220","2017-03-21",2,4,5,9,9,"Yes",2,3,2,2
"221","2017-03-21",6,9,16,25,25,"No",9,7,3,6
"222","2017-03-21",1,7,1,8,8,"Yes",1,0,3,4
"223","2017-03-21",2,3,1,4,4,"No",1,0,1,2
"224","2017-03-21",1,2,2,4,2,"No",1,1,1,1
"225","2017-03-21",5,10,8,18,25,"No",2,6,6,4
"226","2017-03-21",3,12,7,19,19,"Yes",4,3,5,7
"227","2017-03-21",3,6,10,16,16,"No",6,4,3,3
"228","2017-03-21",15,15,25,40,40,"No",12,13,5,10
"229","2017-03-21",6,12,7,19,19,"No",2,5,6,6
"230","2017-03-21",7,13,22,35,35,"Yes",8,14,7,6
"231","2017-03-21",2,7,3,10,10,"Yes",3,0,3,4
"232","2017-03-21",NA,4,8,12,2,"Yes",4,4,2,2
"233","2017-03-21",2,5,5,10,10,"No",1,4,1,4
"234","2017-03-21",6,12,12,24,27,"No",5,7,5,7
"235","2017-03-21",3,14,8,22,22,"No",5,3,7,7
"236","2017-03-21",3,5,1,6,4,"Yes",0,1,2,3
"237","2017-03-21",1,3,3,6,6,"Yes",3,0,1,2
"238","2017-03-21",7,15,6,21,21,"Yes",4,2,8,7
"239","2017-03-21",NA,12,0,12,NA,NA,NA,NA,7,5
"240","2017-03-21",6,13,8,21,20,"Yes",3,5,7,6
"241","2017-03-21",3,13,4,17,17,"Yes",3,1,5,8
"242","2017-03-21",1,5,1,6,5,"Yes",1,0,2,3
"243","2017-03-21",2,6,3,9,9,"Yes",1,2,2,4
"244","2017-03-22",2,4,3,7,7,"Yes",3,0,2,2
"245","2017-03-22",7,9,8,17,20,"Yes",4,4,6,3
"246","2017-03-22",2,7,6,13,13,"Yes",3,3,3,4
"247","2017-03-22",NA,8,7,15,NA,"Yes",4,3,4,4
"248","2017-03-22",3,6,4,10,10,"No",0,4,4,2
"249",NA,15,2,5,7,5,"Yes",3,2,1,1
"250","2017-03-22",5,6,10,16,15,"Yes",5,5,3,3
"251","2017-03-22",11,20,12,32,39,"No",4,8,9,11
"252","2017-03-22",1,4,3,7,7,"Yes",2,1,0,4
"253","2017-03-22",4,8,11,19,19,"Yes",8,3,5,3
"254","2017-03-22",6,8,4,12,17,"No",1,3,4,4
"255","2017-03-22",6,15,13,28,28,"Yes",9,4,7,8
"256","2017-03-22",NA,7,5,12,NA,"No",2,3,4,3
"257","2017-03-22",7,14,24,38,40,"No",6,18,7,7
"258","2017-03-22",NA,3,5,8,NA,NA,1,4,1,2
"259","2017-03-22",4,12,3,15,16,"Yes",2,1,5,7
"260","2017-03-22",3,7,2,9,10,"No",1,1,4,3
"261","2017-03-22",6,12,7,19,23,"No",5,2,6,6
"262","2017-03-22",2,2,2,4,4,"Yes",1,1,1,1
"263","2017-03-22",4,10,5,15,15,"Yes",1,4,3,7
"264",NA,7,11,5,16,16,NA,4,1,5,6
"265","2017-03-22",4,10,4,14,20,NA,3,1,4,6
"266","2017-03-22",3,7,1,8,11,"No",1,0,4,3
"267","2017-03-22",1,3,5,8,8,"No",2,3,2,1
"268","2017-03-22",2,9,3,12,9,"Yes",2,1,5,4
"269","2017-03-22",4,13,13,26,16,"Yes",6,7,5,8
"270","2017-03-22",1,4,3,7,7,"Yes",1,2,3,1
"271","2017-03-22",5,10,2,12,14,"Yes",1,1,5,5
"272","2017-03-22",5,7,8,15,15,"No",3,5,3,4
"273","2017-03-22",3,7,9,16,16,"Yes",3,6,3,4
"274","2017-03-22",3,9,4,13,13,"Yes",2,2,4,5
"275","2017-03-22",3,10,3,13,18,"No",2,1,2,8
"276","2017-03-22",4,10,15,25,22,"No",9,6,5,5
"277","2017-03-22",6,8,8,16,16,"No",5,3,2,6
"278","2017-03-22",1,9,3,12,8,"Yes",2,1,5,4
"279",NA,2,5,8,13,13,"Yes",2,6,1,4
"280","2017-03-22",NA,7,266,273,NA,"No",121,145,4,3
"281","2017-03-22",4,10,6,16,16,"Yes",3,3,3,7
"282","2017-03-22",6,8,15,23,25,"Yes",10,5,5,3
"283","2017-03-22",8,14,6,20,21,"No",3,3,7,7
"284","2017-03-22",5,13,4,17,17,"No",2,2,6,7
"285","2017-03-22",3,4,9,13,13,"Yes",4,5,1,3
"286","2017-03-22",NA,3,70,73,NA,"No",40,30,1,2
"287","2017-03-22",1,4,1,5,5,"Yes",NA,1,NA,4
"288","2017-03-22",7,13,10,23,23,"No",5,5,7,6
"289","2017-03-22",5,13,1,14,25,"No",1,NA,10,3
"290","2017-03-22",4,7,13,20,20,"Yes",6,7,3,4
"291","2017-03-29",2,8,4,12,10,"No",3,1,4,4
"292","2017-03-22",5,10,6,16,8,"Yes",2,4,4,6
"293","2017-03-22",5,9,2,11,14,"Yes",1,1,4,5
"294","2017-03-22",7,17,9,26,26,"Yes",2,7,10,7
"295","2017-03-22",1,2,1,3,3,"Yes",0,1,1,1
"296","2017-03-22",6,19,3,22,20,"Yes",2,1,11,8
"297","2017-03-22",3,8,1,9,9,"Yes",NA,1,3,5
"298","2017-03-22",4,7,5,12,12,"Yes",2,3,4,3
"299","2017-03-22",1,1,3,4,4,"Yes",1,2,NA,1
"300","2017-03-22",5,13,5,18,17,"No",0,5,11,2
"301","2017-03-22",3,5,4,9,9,NA,3,1,3,2
"302","2017-03-22",2,4,8,12,11,"No",3,5,2,2
"303","2017-03-22",2,9,2,11,11,"Yes",2,0,6,3
"304","2017-03-22",4,8,13,21,21,"Yes",10,3,4,4
"305","2017-03-22",3,6,8,14,14,"Yes",5,3,3,3
"306","2017-03-22",5,14,7,21,21,"Yes",4,3,3,11
"307","2017-03-22",1,7,1,8,10,"Yes",1,0,3,4
"308","2017-03-22",1,3,0,3,3,"Yes",0,0,3,0
"309","2017-03-22",14,28,14,42,46,"Yes",3,11,17,11
"310","2017-03-22",6,9,9,18,18,"Yes",2,7,4,5
"311","2017-03-22",6,11,10,21,21,"Yes",6,4,6,5
"312","2017-03-22",6,476,6,482,16,"No",2,4,9,467
"313","2017-03-22",4,8,6,14,14,"No",4,2,4,4
"314","2017-03-22",2,4,7,11,11,"No",3,4,2,2
"315","2017-03-22",1,1,2,3,3,"Yes",2,0,1,0
"316","2017-03-22",2,3,5,8,8,"Yes",3,2,2,1
"317",NA,3,3,5,8,10,"Yes",3,2,2,1
"318","2017-03-22",3,4,4,8,10,"Yes",0,4,1,3
"319","2017-03-22",3,8,2,10,11,"Yes",0,2,5,3
"320","2017-03-22",2,7,4,11,9,"Yes",4,0,3,4
"321",NA,2,4,4,8,8,"Yes",3,1,2,2
"322","2017-03-22",3,4,5,9,12,"No",1,4,1,3
"323","2017-03-22",5,9,6,15,15,"Yes",2,4,5,4
"324","2017-03-22",7,13,9,22,22,"Yes",4,5,7,6
"325","2017-03-22",1,3,4,7,7,"Yes",1,3,2,1
"326","2017-03-22",2,4,1,5,6,"Yes",1,0,2,2
"327","2017-03-22",3,4,4,8,9,NA,1,3,2,2
"328","2017-03-22",1,6,2,8,12,"Yes",1,1,3,3
"329","2017-03-22",6,12,4,16,16,"Yes",1,3,4,8
"330","2017-03-22",3,7,0,7,8,"Yes",0,0,4,3
"331","2017-03-22",1,3,4,7,7,"Yes",2,2,1,2
"332","2017-03-22",3,8,2,10,10,"Yes",1,1,5,3
"333","2017-03-22",1,2,4,6,6,"Yes",2,2,1,1
"334","2017-03-22",1,6,2,8,8,"Yes",1,1,3,3
"335","2017-03-22",2,2,7,9,10,"Yes",2,5,0,2
"336","2017-03-22",2,6,5,11,10,"Yes",3,2,2,4
"337","2017-03-22",8,14,13,27,27,NA,6,7,9,5
"338","2017-03-22",1,2,3,5,5,"No",0,3,2,0
"339","2017-03-22",4,10,2,12,13,"No",1,1,7,3
"340","2017-03-22",4,5,8,13,13,"Yes",2,6,2,3
"341","2017-03-22",1,7,0,7,7,"Yes",0,0,3,4
"342","2017-03-22",4,8,6,14,11,"No",2,4,4,4
"343","2017-03-22",2,26,0,26,10,"No",0,0,18,8
"344","2017-03-22",4,8,5,13,14,"No",2,3,4,4
"345","2017-03-22",2,4,8,12,12,"Yes",6,2,1,3
"346","2017-03-22",NA,0,70,70,NA,"No",30,40,NA,NA
"347","2017-03-22",3,6,1,7,7,"Yes",1,NA,5,1
"348","2017-03-22",11,17,17,34,34,"Yes",6,11,10,7
"349","2017-03-22",1,4,2,6,6,"No",2,0,1,3
"350","2017-03-22",5,7,4,11,13,"Yes",2,2,4,3
"351","2017-03-22",6,13,9,22,22,"Yes",7,2,7,6
"352","2017-03-22",3,10,4,14,15,"No",1,3,5,5
"353","2017-03-22",1,2,4,6,5,"Yes",1,3,1,1
"354","2017-03-22",3,9,13,22,22,"Yes",5,8,4,5
"355","2017-03-22",5,10,12,22,20,NA,10,2,5,5
"356","2017-03-22",8,14,11,25,25,"Yes",5,6,4,10
"357","2017-03-22",4,12,6,18,18,"Yes",2,4,7,5
"358","2017-03-22",3,6,9,15,15,"No",4,5,3,3
"359","2017-03-22",8,11,1,12,13,"Yes",1,0,7,4
"360","2017-03-22",2,5,4,9,5,"Yes",3,1,2,3
"361","2017-03-22",2,8,3,11,11,"Yes",1,2,4,4
"362","2017-03-22",5,11,9,20,20,"No",5,4,7,4
"363","2017-03-22",5,12,21,33,33,"Yes",10,11,5,7
"364","2017-03-22",4,9,10,19,19,"No",5,5,7,2
"365","2017-03-22",6,8,7,15,15,"Yes",4,3,2,6
"366","2017-03-22",5,9,14,23,23,"Yes",8,6,5,4
"367","2017-03-22",1,7,5,12,12,"Yes",4,1,4,3
"368","2017-03-22",5,14,10,24,19,"Yes",8,2,7,7
"369","2017-03-22",1,7,3,10,10,"Yes",NA,3,5,2
"370","2017-03-22",NA,0,0,0,NA,"No",NA,NA,NA,NA
"371","2017-03-22",10,20,17,37,39,"Yes",9,8,10,10
"372","2017-03-22",1,6,2,8,8,"Yes",1,1,3,3
"373","2017-03-22",9,23,5,28,29,"Yes",2,3,11,12
"374","2017-03-22",5,12,10,22,22,"No",5,5,6,6
"375","2017-03-22",1,6,3,9,9,"Yes",3,0,2,4
"376","2017-03-22",4,9,2,11,16,"No",2,0,5,4
"377","2017-03-22",2,7,3,10,10,"No",1,2,4,3
"378","2017-03-22",7,10,10,20,20,"Yes",4,6,3,7
"379","2017-03-22",7,18,17,35,35,"Yes",15,2,9,9
"380","2017-03-22",6,14,10,24,24,"Yes",6,4,6,8
"381","2017-03-22",4,9,3,12,13,"Yes",1,2,3,6
"382","2017-03-22",5,15,14,29,18,"Yes",1,13,10,5
"383",NA,3,7,5,12,12,"Yes",1,4,3,4
"384","2017-03-22",5,12,10,22,27,"Yes",6,4,4,8
"385","2017-03-22",8,19,7,26,26,"No",2,5,9,10
"386","2017-03-22",2,6,9,15,15,"Yes",4,5,0,6
"387","2017-03-22",NA,10,320,330,NA,"No",150,170,4,6
"388","2017-03-22",3,6,7,13,13,"No",0,7,3,3
"389","2017-03-22",4,11,7,18,16,"Yes",6,1,5,6
"390","2017-03-22",2,10,4,14,14,"Yes",3,1,6,4
"391","2017-03-22",3,8,6,14,14,"No",3,3,3,5
"392","2017-03-22",NA,7,149,156,NA,"No",64,85,4,3
"393","2017-03-22",3,8,4,12,13,"No",4,0,4,4
"394","2017-03-22",9,0,0,0,NA,"No",0,0,0,0
"395","2017-03-22",7,10,5,15,16,"Yes",2,3,5,5
"396","2017-03-22",3,10,10,20,17,"No",3,7,4,6
"397","2017-03-22",3,9,3,12,10,"No",0,3,3,6
"398","2017-03-22",4,9,5,14,14,"Yes",1,4,5,4
"399","2017-03-22",3,9,11,20,19,"Yes",7,4,4,5
"400","2017-03-22",3,8,7,15,12,"Yes",5,2,3,5
"401","2017-03-22",2,5,10,15,15,"Yes",5,5,3,2
"402","2017-03-22",5,18,9,27,23,"No",6,3,9,9
"403","2017-03-22",5,12,8,20,20,"Yes",2,6,8,4
"404","2017-03-22",3,3,2,5,5,"No",1,1,NA,3
"405","2017-03-22",5,6,3,9,9,"Yes",2,1,2,4
"406","2017-03-22",3,7,3,10,10,"Yes",1,2,3,4
"407","2017-03-22",5,16,8,24,24,"No",2,6,9,7
"408","2017-03-22",4,5,9,14,13,"Yes",5,4,1,4
"409","2017-03-22",3,6,5,11,11,"Yes",2,3,2,4
"410","2017-03-22",3,6,3,9,8,"No",0,3,4,2
"411","2017-03-22",5,11,6,17,19,"Yes",3,3,5,6
"412","2017-03-22",2,4,1,5,5,"Yes",0,1,2,2
"413","2017-03-22",1,2,4,6,4,"Yes",3,1,1,1
"414","2017-03-22",6,8,6,14,14,"Yes",3,3,3,5
"415","2017-03-22",3,10,4,14,12,"Yes",0,4,5,5
"416","2017-03-29",4,8,10,18,14,"Yes",3,7,4,4
"417","2017-03-22",NA,176,55,231,NA,"No",25,30,98,78
"418","2017-03-22",7,21,7,28,23,NA,1,6,12,9
"419","2017-03-22",6,8,6,14,14,"Yes",5,1,2,6
"420","2017-03-22",3,7,6,13,16,"Yes",2,4,4,3
"421","2017-03-22",2,5,1,6,6,"Yes",0,1,2,3
"422","2017-03-22",4,9,7,16,15,"Yes",5,2,6,3
"423","2017-03-22",1,4,1,5,4,"Yes",1,0,3,1
"424","2017-03-22",8,24,12,36,34,"No",6,6,19,5
"425","2017-03-22",2,4,5,9,9,"Yes",3,2,1,3
"426","2017-03-22",1,7,5,12,12,"Yes",4,1,2,5
"427","2017-03-23",3,6,10,16,16,"Yes",6,4,3,3
"428","2017-03-23",4,10,3,13,13,"Yes",1,2,4,6
"429","2017-03-23",3,10,4,14,14,"Yes",3,1,6,4
"430","2017-03-23",4,6,3,9,9,"Yes",1,2,4,2
"431","2017-03-23",1,2,2,4,4,"Yes",2,0,1,1
"432","2017-03-23",7,15,13,28,28,"No",3,10,7,8
"433","2017-03-23",4,12,11,23,23,"Yes",8,3,5,7
"434","2017-03-23",2,6,1,7,8,"No",0,1,3,3
"435","2017-03-30",1,2,12,14,12,"Yes",7,5,1,1
"436","2017-03-23",3,9,8,17,17,"Yes",2,6,4,5
"437","2017-03-23",4,13,8,21,10,"Yes",7,1,6,7
"438","2017-03-23",10,20,20,40,40,"No",11,9,10,10
"439","2017-03-23",5,10,5,15,14,"Yes",2,3,5,5
"440","2017-03-23",1,2,6,8,6,"Yes",2,4,1,1
"441","2017-03-23",5,10,3,13,13,"Yes",3,0,5,5
"442","2017-03-23",5,10,6,16,8,NA,3,3,5,5
"443","2017-03-23",2,10,4,14,14,"Yes",1,3,6,4
"444","2017-03-23",3,6,10,16,16,"Yes",5,5,2,4
"445","2017-03-23",2,9,1,10,10,"No",1,0,7,2
"446","2017-03-23",3,8,11,19,19,"Yes",7,4,3,5
"447","2017-03-23",6,12,2,14,14,"No",1,1,5,7
"448",NA,3,6,12,18,18,"Yes",8,4,3,3
"449","2017-03-23",1,2,6,8,8,"Yes",2,4,1,1
"450","2017-03-02",3,6,7,13,13,"Yes",5,2,3,3
"451","2017-03-23",1,5,1,6,8,"Yes",0,1,0,5
"452","2017-03-23",6,15,0,15,13,"Yes",0,0,7,8
"453","2017-03-23",6,2,8,10,10,"No",4,4,1,1
"454","2017-03-23",4,8,10,18,18,"Yes",3,7,3,5
"455","2017-03-23",4,12,4,16,18,"Yes",3,1,7,5
"456","2017-03-23",9,9,12,21,30,"Yes",10,2,NA,9
"457","2017-03-23",2,5,3,8,8,"Yes",1,2,2,3
"458","2017-03-23",8,18,14,32,32,"No",6,8,11,7
"459","2017-03-23",4,7,10,17,17,"No",7,3,3,4
"460","2017-03-23",8,15,15,30,32,"Yes",8,7,8,7
"461","2017-03-23",5,10,7,17,17,"No",3,4,5,5
"462","2017-03-23",4,4,5,9,9,"Yes",3,2,2,2
"463","2017-03-23",3,7,7,14,16,"Yes",6,1,6,1
"464","2017-03-23",1,4,0,4,4,"Yes",0,0,3,1
"465","2017-03-23",2,9,5,14,14,"Yes",1,4,6,3
"466","2017-03-23",6,11,10,21,24,"Yes",4,6,4,7
"467","2017-03-23",NA,0,0,0,NA,"No",NA,NA,NA,NA
"468","2017-03-23",2,2,10,12,12,"Yes",4,6,2,NA
"469","2017-03-23",1,6,1,7,7,"Yes",0,1,3,3
"470","2017-03-23",5,8,8,16,16,"Yes",6,2,4,4
"471","2017-03-23",5,10,4,14,14,"No",3,1,6,4
"472","2017-03-23",3,7,2,9,9,"Yes",1,1,3,4
"473","2017-03-23",3,4,2,6,6,"No",0,2,2,2
"474","2017-03-23",6,16,10,26,29,"No",7,3,10,6
"475","2017-03-23",2,4,8,12,12,"Yes",3,5,2,2
"476","2017-03-23",2,5,5,10,10,"Yes",2,3,3,2
"477","2017-03-23",4,9,4,13,13,"Yes",3,1,3,6
"478","2017-03-23",7,15,8,23,23,"Yes",2,6,10,5
"479","2017-03-23",3,10,5,15,17,"Yes",3,2,4,6
"480","2017-03-23",7,13,7,20,19,"No",4,3,7,6
"481","2017-03-23",NA,10,5,15,NA,"Yes",2,3,5,5
"482","2017-03-23",18,19,15,34,34,"Yes",8,7,10,9
"483","2017-03-23",2,4,8,12,12,"No",6,2,2,2
"484",NA,1,1,4,5,6,"Yes",2,2,NA,1
"485","2017-03-23",1,2,4,6,7,"No",2,2,0,2
"486","2017-03-23",4,7,10,17,17,"Yes",6,4,4,3
"487","2017-03-23",4,9,5,14,14,"No",3,2,4,5
"488","2017-03-23",3,6,1,7,6,"Yes",1,0,3,3
"489","2017-03-23",5,16,6,22,22,"Yes",4,2,8,8
"490","2017-03-23",1,4,6,10,10,"Yes",4,2,1,3
"491","2017-03-23",5,12,2,14,18,"Yes",0,2,5,7
"492","2017-03-23",9,6,6,12,12,"Yes",2,4,2,4
"493","2017-03-23",1,3,5,8,8,"No",3,2,1,2
"494","2017-03-23",1,3,0,3,3,NA,NA,NA,1,2
"495","2017-03-23",4,13,21,34,34,"No",9,12,5,8
"496","2017-03-23",2,4,4,8,8,"Yes",1,3,2,2
"497","2017-03-23",2,7,3,10,10,"Yes",3,0,4,3
"498","2017-03-23",2,5,3,8,8,"No",0,3,2,3
"499","2017-03-23",3,4,10,14,14,"Yes",4,6,3,1
"500",NA,3,9,6,15,12,"Yes",3,3,3,6
"501","2017-03-23",NA,6,300,306,NA,"Yes",70,230,2,4
"502","2017-03-23",3,3,3,6,6,NA,1,2,1,2
"503","2017-03-23",3,9,0,9,10,"Yes",0,0,3,6
"504","2017-03-23",NA,35,0,35,NA,"No",0,0,20,15
"505","2017-03-23",7,9,6,15,15,"No",4,2,4,5
"506","2017-03-23",5,6,3,9,11,"Yes",2,1,4,2
"507","2017-03-23",7,10,3,13,16,"Yes",3,0,10,NA
"508","2017-03-23",3,11,7,18,18,"Yes",4,3,5,6
"509","2017-03-23",3,7,7,14,14,"Yes",3,4,4,3
"510","2017-03-23",2,8,6,14,14,"Yes",5,1,4,4
"511","2017-03-23",1,6,2,8,8,"Yes",1,1,2,4
"512","2017-03-23",1,6,1,7,7,"Yes",0,1,2,4
"513","2017-03-23",1,6,0,6,6,"Yes",0,0,3,3
"514","2017-03-23",1,4,2,6,6,NA,1,1,1,3
"515","2017-03-23",9,16,18,34,34,"No",9,9,8,8
"516","2017-03-23",7,9,5,14,16,"Yes",3,2,4,5
"517","2017-03-23",3,7,4,11,11,"Yes",3,1,5,2
"518","2017-03-23",5,10,9,19,19,"Yes",5,4,5,5
"519","2017-03-23",1,3,3,6,6,"No",NA,3,1,2
"520","2017-03-23",4,9,9,18,18,"No",6,3,3,6
"521","2017-03-23",1,3,5,8,8,"Yes",1,4,1,2
"522","2017-03-23",5,10,13,23,26,"No",7,6,5,5
"523","2017-03-23",4,8,5,13,13,"Yes",2,3,4,4
"524","2017-03-23",2,4,10,14,14,"Yes",4,6,2,2
"525","2017-03-23",4,11,10,21,17,"Yes",3,7,5,6
"526","2017-03-23",4,5,4,9,9,"Yes",2,2,2,3
"527","2017-03-23",3,11,5,16,16,"No",2,3,5,6
"528","2017-03-23",5,9,4,13,13,"No",4,0,4,5
"529","2017-03-23",3,6,3,9,9,"No",1,2,3,3
"530","2017-03-23",3,7,10,17,17,"No",8,2,4,3
"531","2017-03-23",7,12,16,28,28,"No",8,8,6,6
"532","2017-03-23",1,4,3,7,7,"Yes",2,1,2,2
"533","2017-03-23",6,22,13,35,41,"Yes",7,6,10,12
"534","2017-03-23",NA,3,64,67,NA,"No",28,36,2,1
"535","2017-03-23",5,14,4,18,18,"No",3,1,8,6
"536","2017-03-23",6,12,8,20,21,"Yes",6,2,5,7
"537","2017-03-23",7,13,10,23,23,"Yes",2,8,6,7
"538","2017-03-23",5,10,8,18,19,"No",3,5,4,6
"539","2017-03-23",2,7,5,12,13,"Yes",3,2,2,5
"540","2017-03-23",4,8,13,21,21,"Yes",6,7,4,4
"541","2017-03-23",3,5,6,11,11,"Yes",3,3,3,2
"542","2017-03-23",10,18,36,54,66,"Yes",26,10,9,9
"543","2017-03-23",4,7,5,12,12,"Yes",1,4,3,4
"544","2017-03-23",7,6,4,10,10,NA,2,2,4,2
"545","2017-03-23",5,10,13,23,24,"Yes",6,7,5,5
"546","2017-03-23",6,12,8,20,20,"Yes",4,4,8,4
"547","2017-03-23",7,14,9,23,24,"No",4,5,8,6
"548","2017-03-23",2,5,4,9,9,"No",2,2,2,3
"549","2017-03-23",4,8,3,11,11,"Yes",2,1,4,4
"550",NA,5,0,0,0,30,"Yes",NA,NA,NA,NA
"551","2017-03-23",6,12,13,25,25,"No",8,5,5,7
"552","2017-03-23",4,10,5,15,15,"No",3,2,2,8
"553","2017-03-23",4,6,5,11,11,"Yes",1,4,2,4
"554","2017-03-23",3,7,6,13,13,"Yes",3,3,3,4
"555","2017-03-23",2,5,5,10,8,"Yes",3,2,1,4
"556","2017-03-23",2,3,6,9,9,"No",2,4,1,2
"557","2017-03-23",1,3,5,8,6,"Yes",3,2,1,2
"558","2017-03-23",6,13,7,20,20,"Yes",3,4,6,7
"559","2017-03-23",2,4,3,7,7,"Yes",1,2,1,3
"560","2017-03-23",8,19,20,39,34,"Yes",11,9,10,9
"561","2017-03-23",1,3,6,9,9,"Yes",4,2,1,2
"562","2017-03-23",1,5,3,8,8,"Yes",2,1,3,2
"563","2017-03-23",1,2,5,7,7,"Yes",NA,5,1,1
"564","2017-03-23",7,14,8,22,22,"No",3,5,6,8
"565","2017-03-23",4,12,6,18,19,"No",4,2,6,6
"566","2017-03-23",1,3,2,5,4,"Yes",1,1,0,3
"567","2017-03-23",5,10,12,22,15,"Yes",5,7,5,5
"568","2017-03-23",1,3,7,10,10,"Yes",3,4,2,1
"569","2017-03-23",6,13,15,28,30,"Yes",5,10,6,7
"570","2017-03-23",2,0,0,0,8,"Yes",NA,NA,NA,NA
"571","2017-03-23",NA,90,0,90,NA,"Yes",NA,NA,60,30
"572","2017-03-23",1,2,2,4,4,"Yes",1,1,1,1
"573","2017-03-23",4,8,9,17,17,"No",3,6,4,4
"574","2017-03-23",3,6,0,6,6,"Yes",0,0,5,1
"575","2017-03-23",3,9,1,10,10,"Yes",1,0,6,3
"576","2017-03-23",2,3,2,5,4,"No",1,1,2,1
"577","2017-03-23",1,1,0,1,1,"Yes",0,0,0,1
"578","2017-03-23",4,10,0,10,11,"Yes",0,0,5,5
"579","2017-03-23",1,4,5,9,9,"Yes",1,4,2,2
"580","2017-03-23",8,16,26,42,42,"No",9,17,8,8
"581","2017-03-23",4,11,14,25,25,"Yes",10,4,6,5
"582","2017-03-23",4,8,4,12,13,"Yes",3,1,5,3
"583","2017-03-23",3,2,7,9,4,"No",2,5,1,1
"584","2017-03-23",2,4,13,17,12,"No",8,5,2,2
"585","2017-03-23",2,6,5,11,14,"Yes",4,1,3,3
"586","2017-03-23",5,10,10,20,20,"No",3,7,5,5
"587","2017-03-23",6,14,6,20,20,"Yes",3,3,5,9
"588","2017-03-23",4,6,12,18,18,"Yes",8,4,2,4
"589","2017-03-23",17,41,43,84,84,"Yes",23,20,19,22
"590","2017-03-23",1,5,2,7,7,"Yes",2,NA,2,3
"591","2017-03-23",4,12,5,17,17,"Yes",2,3,4,8
"592","2017-03-23",1,2,2,4,4,"Yes",1,1,1,1
"593","2017-03-23",3,7,7,14,14,"Yes",4,3,4,3
"594","2017-03-23",24,41,12,53,53,"No",8,4,36,5
"595","2017-03-23",3,8,6,14,14,"Yes",3,3,3,5
"596",NA,5,10,8,18,18,"No",3,5,5,5
"597","2017-03-23",7,14,17,31,31,"Yes",9,8,7,7
"598","2017-03-23",6,12,4,16,16,"Yes",2,2,5,7
"599","2017-03-23",3,7,3,10,10,"Yes",1,2,4,3
"600","2017-03-23",4,9,0,9,9,"Yes",0,0,6,3
"601","2017-03-23",4,11,9,20,20,"Yes",6,3,6,5
"602","2017-03-23",1,2,5,7,6,"Yes",4,1,1,1
"603","2017-03-23",6,12,5,17,17,"Yes",3,2,5,7
"604","2017-03-23",3,5,5,10,10,"Yes",2,3,3,2
"605","2017-03-23",6,30,20,50,50,"Yes",10,10,10,20
"606","2017-03-23",4,10,2,12,7,"Yes",2,0,5,5
"607","2017-03-23",6,12,18,30,30,"Yes",8,10,6,6
"608","2017-03-23",NA,35,0,35,NA,"No",NA,NA,20,15
"609",NA,4,6,11,17,17,"Yes",6,5,3,3
"610","2017-03-23",4,6,2,8,8,"No",0,2,4,2
"611","2017-03-23",2,8,2,10,10,NA,2,0,5,3
"612","2017-03-23",3,6,14,20,20,"No",7,7,5,1
"613","2017-03-23",5,4,3,7,7,"Yes",0,3,3,1
"614","2017-03-23",53,10,14,24,32,"Yes",7,7,6,4
"615","2017-03-29",4,3,9,12,22,"Yes",5,4,1,2
"616","2017-03-23",4,8,4,12,10,"Yes",2,2,4,4
"617",NA,8,20,20,40,45,"Yes",12,8,10,10
"618","2017-03-23",3,6,6,12,12,"Yes",2,4,3,3
"619","2017-03-23",1,3,1,4,5,"Yes",1,0,1,2
"620","2017-03-23",2,9,3,12,12,"No",1,2,3,6
"621","2017-03-23",4,10,4,14,14,"Yes",0,4,4,6
"622","2017-03-23",12,24,11,35,41,"No",5,6,12,12
"623",NA,4,12,6,18,18,"No",4,2,6,6
"624","2017-03-23",1,3,5,8,5,"Yes",3,2,1,2
"625","2017-03-23",2,5,5,10,10,"Yes",1,4,4,1
"626","2017-03-23",4,11,5,16,16,"Yes",4,1,5,6
"627","2017-03-23",7,6,4,10,10,"No",2,2,2,4
"628","2017-03-23",8,6,12,18,18,"Yes",6,6,3,3
"629","2017-03-23",2,5,5,10,6,"No",3,2,2,3
"630","2017-03-23",NA,7,0,7,NA,"No",0,0,4,3
"631","2017-03-23",6,11,5,16,27,"Yes",2,3,6,5
"632","2017-03-23",NA,55,0,55,NA,"No",NA,NA,30,25
"633","2017-03-23",2,4,4,8,8,"Yes",4,NA,3,1
"634","2017-03-23",1,8,1,9,9,"Yes",0,1,7,1
"635","2017-03-23",5,6,4,10,10,"No",2,2,3,3
"636","2017-03-23",7,16,8,24,36,"Yes",4,4,4,12
"637","2017-03-23",10,14,11,25,25,"No",5,6,10,4
"638","2017-03-23",5,10,6,16,16,"Yes",3,3,3,7
"639","2017-03-23",5,11,17,28,28,"Yes",8,9,5,6
"640","2017-03-23",1,8,0,8,8,"Yes",NA,NA,1,7
"641","2017-03-23",6,12,18,30,34,"No",8,10,6,6
"642","2017-03-23",2,8,3,11,11,"Yes",2,1,3,5
"643","2017-03-23",2,3,4,7,7,"No",2,2,2,1
"644","2017-03-23",4,6,10,16,16,"No",4,6,2,4
"645","2017-03-23",11,11,7,18,21,"Yes",1,6,5,6
"646","2017-03-23",2,4,2,6,6,"No",2,0,2,2
"647","2017-03-23",NA,14,350,364,NA,"No",180,170,5,9
"648","2017-03-23",2,4,8,12,12,"Yes",2,6,1,3
"649","2017-03-23",4,16,5,21,21,"Yes",2,3,5,11
"650","2017-03-23",1,6,3,9,9,"Yes",1,2,3,3
"651","2017-03-23",5,11,9,20,20,"Yes",7,2,3,8
"652",NA,4,12,3,15,15,"Yes",3,0,5,7
"653","2017-03-23",1,2,4,6,6,"Yes",1,3,1,1
"654","2017-03-23",3,4,2,6,6,"Yes",1,1,2,2
"655","2017-03-23",8,11,9,20,20,"Yes",5,4,4,7
"656","2017-03-23",5,11,3,14,14,"Yes",1,2,5,6
"657","2017-03-23",4,11,12,23,21,"Yes",7,5,6,5
"658","2017-03-23",2,4,5,9,9,"Yes",3,2,2,2
"659",NA,5,10,2,12,12,"Yes",0,2,5,5
"660","2017-03-30",3,8,4,12,11,"No",1,3,6,2
"661","2017-03-23",4,7,3,10,1,"No",1,2,2,5
"662","2017-03-23",4,10,4,14,10,"Yes",1,3,4,6
"663","2017-03-23",3,7,5,12,12,"Yes",2,3,3,4
"664","2017-03-23",3,6,9,15,15,"No",4,5,3,3
"665","2017-03-23",5,11,8,19,19,"Yes",2,6,3,8
"666","2017-03-23",7,17,12,29,29,"Yes",7,5,8,9
"667","2017-03-23",7,15,6,21,27,"No",4,2,7,8
"668","2017-03-23",3,6,13,19,19,"Yes",8,5,2,4
"669","2017-03-23",2,8,1,9,9,"Yes",1,0,4,4
"670","2017-03-23",2,7,5,12,12,"No",2,3,5,2
"671","2017-03-23",3,8,5,13,13,"Yes",4,1,5,3
"672","2017-03-30",4,12,7,19,22,"No",2,5,6,6
"673","2017-03-24",5,19,7,26,24,"Yes",4,3,13,6
"674","2017-03-24",4,8,5,13,13,"No",0,5,4,4
"675","2017-03-24",3,11,4,15,17,"Yes",3,1,3,8
"676","2017-03-24",4,9,8,17,15,"Yes",4,4,4,5
"677","2017-03-24",4,4,4,8,8,"Yes",1,3,2,2
"678","2017-03-24",1,3,2,5,6,"Yes",1,1,1,2
"679","2017-03-24",3,6,5,11,12,NA,2,3,4,2
"680","2017-03-24",2,4,6,10,10,"No",2,4,2,2
"681","2017-03-24",6,10,9,19,18,"No",6,3,5,5
"682","2017-03-24",5,11,9,20,20,"Yes",5,4,7,4
"683","2017-03-24",4,4,11,15,15,"No",4,7,2,2
"684","2017-03-24",3,6,10,16,16,"Yes",5,5,3,3
"685","2017-03-24",3,5,7,12,14,"No",3,4,1,4
"686","2017-03-24",5,19,11,30,36,"Yes",4,7,11,8
"687","2017-03-24",1,5,2,7,8,"Yes",0,2,4,1
"688","2017-03-24",2,4,8,12,12,"No",3,5,2,2
"689","2017-03-24",1,4,4,8,8,"Yes",2,2,1,3
"690","2017-03-24",7,8,5,13,13,"Yes",2,3,4,4
"691","2017-03-24",NA,8,0,8,NA,"Yes",NA,NA,7,1
"692","2017-03-24",7,14,11,25,27,"No",6,5,8,6
"693","2017-03-24",2,5,4,9,9,"Yes",1,3,3,2
"694","2017-03-24",1,3,3,6,6,"Yes",1,2,1,2
"695","2017-03-24",1,5,6,11,11,"Yes",2,4,3,2
"696","2017-03-24",3,8,9,17,17,"Yes",7,2,4,4
"697","2017-03-24",7,14,10,24,23,"Yes",4,6,7,7
"698","2017-03-24",3,6,7,13,13,"Yes",4,3,3,3
"699","2017-03-24",2,4,9,13,11,"Yes",4,5,3,1
"700","2017-03-24",2,4,4,8,8,"Yes",1,3,2,2
"701","2017-03-24",1,6,1,7,8,"Yes",0,1,1,5
"702","2017-03-24",2,5,4,9,9,"Yes",2,2,3,2
"703","2017-03-24",1,14,5,19,19,"Yes",1,4,4,10
"704","2017-03-24",1,7,1,8,8,"Yes",1,0,5,2
"705","2017-03-24",7,0,0,0,19,"Yes",NA,NA,NA,NA
"706","2017-03-24",2,7,7,14,14,"Yes",1,6,2,5
"707","2017-03-24",2,4,4,8,8,"No",1,3,2,2
"708","2017-03-24",8,10,16,26,26,"Yes",12,4,4,6
"709","2017-03-24",8,16,4,20,21,"Yes",2,2,11,5
"710","2017-03-24",1,2,5,7,7,"Yes",1,4,1,1
"711","2017-03-24",3,8,6,14,14,"Yes",3,3,4,4
"712","2017-03-24",2,2,2,4,4,"No",1,1,1,1
"713","2017-03-24",1,2,6,8,8,"Yes",3,3,1,1
"714","2017-03-24",4,10,5,15,17,"No",3,2,6,4
"715","2017-03-24",3,9,6,15,12,"No",1,5,5,4
"716","2017-03-24",7,14,7,21,21,"Yes",3,4,7,7
"717","2017-03-24",5,9,6,15,11,"Yes",3,3,6,3
"718","2017-03-24",4,7,8,15,19,"Yes",6,2,5,2
"719","2017-03-24",6,20,10,30,30,"No",5,5,10,10
"720","2017-03-24",5,10,5,15,15,"Yes",3,2,5,5
"721","2017-03-24",5,13,1,14,18,"Yes",1,0,7,6
"722","2017-03-24",7,15,11,26,27,"Yes",5,6,7,8
"723","2017-03-24",4,12,1,13,11,"Yes",0,1,6,6
"724","2017-03-24",4,9,12,21,21,"Yes",3,9,4,5
"725","2017-03-24",2,3,4,7,7,NA,1,3,0,3
"726","2017-03-24",8,37,40,77,27,"Yes",25,15,19,18
"727","2017-03-24",1,4,1,5,5,"No",1,0,2,2
"728","2017-03-24",6,12,0,12,NA,"Yes",NA,NA,6,6
"729","2017-03-24",2,5,2,7,7,"Yes",1,1,2,3
"730","2017-03-24",3,5,5,10,4,"Yes",2,3,2,3
"731","2017-03-24",3,6,4,10,10,"Yes",2,2,3,3
"732","2017-03-24",10,7,5,12,12,"Yes",2,3,6,1
"733","2017-03-24",2,4,2,6,NA,"Yes",NA,2,2,2
"734","2017-03-24",4,2,8,10,10,"Yes",3,5,2,0
"735","2017-03-24",2,4,2,6,6,"Yes",1,1,2,2
"736","2017-03-24",3,8,7,15,11,"Yes",3,4,4,4
"737","2017-03-24",2,7,5,12,12,"Yes",2,3,5,2
"738","2017-03-24",1,4,0,4,4,"Yes",0,0,3,1
"739","2017-03-24",9,16,16,32,36,"Yes",8,8,9,7
"740","2017-03-24",2,4,4,8,8,"Yes",2,2,1,3
"741","2017-03-24",6,15,10,25,23,"No",6,4,6,9
"742","2017-03-24",5,2,4,6,6,"Yes",1,3,1,1
"743","2017-03-24",3,14,7,21,21,"No",6,1,9,5
"744","2017-03-24",3,5,2,7,7,"Yes",0,2,3,2
"745","2017-03-24",6,11,5,16,17,"Yes",2,3,8,3
"746","2017-03-24",6,12,12,24,27,"No",7,5,4,8
"747","2017-03-24",4,6,2,8,8,"Yes",1,1,3,3
"748","2017-03-24",2,4,3,7,7,"Yes",1,2,1,3
"749","2017-03-24",5,6,5,11,11,"No",2,3,3,3
"750","2017-03-24",1,11,12,23,26,"No",4,8,6,5
"751",NA,5,13,8,21,19,"Yes",5,3,7,6
"752","2017-03-24",3,12,6,18,18,NA,3,3,7,5
"753","2017-03-24",5,14,9,23,22,"Yes",6,3,4,10
"754","2017-03-24",4,9,4,13,13,"Yes",1,3,4,5
"755","2017-03-24",4,8,4,12,12,"No",1,3,4,4
"756","2017-03-24",2,6,6,12,12,"No",4,2,4,2
"757","2017-03-24",9,23,9,32,21,"Yes",5,4,15,8
"758","2017-03-24",6,7,7,14,14,"Yes",5,2,4,3
"759","2017-03-24",1,2,2,4,4,"Yes",1,1,1,1
"760",NA,5,12,5,17,17,"Yes",3,2,8,4
"761","2017-03-24",6,11,13,24,25,"Yes",6,7,5,6
"762","2017-03-24",6,18,13,31,37,"Yes",6,7,9,9
"763","2017-03-24",5,4,6,10,10,"No",2,4,2,2
"764","2017-03-24",2,8,4,12,13,"Yes",1,3,4,4
"765","2017-03-24",3,6,0,6,6,"No",NA,NA,5,1
"766","2017-03-24",2,8,3,11,11,"No",2,1,6,2
"767","2017-03-24",1,6,4,10,10,"Yes",1,3,5,1
"768","2017-03-24",6,13,14,27,22,"Yes",5,9,4,9
"769","2017-03-24",1,2,4,6,6,"Yes",3,1,1,1
"770","2017-03-24",6,9,13,22,22,"Yes",5,8,4,5
"771","2017-03-24",11,0,15,15,35,"No",7,8,NA,NA
"772","2017-03-24",1,5,4,9,9,"No",4,0,4,1
"773","2017-03-24",4,11,3,14,14,"Yes",1,2,6,5
"774","2017-03-24",4,8,10,18,18,"Yes",4,6,4,4
"775","2017-03-24",2,4,8,12,12,"Yes",5,3,3,1
"776","2017-03-24",4,7,11,18,18,"Yes",8,3,3,4
"777","2017-03-24",5,15,3,18,16,"Yes",1,2,7,8
"778","2017-03-24",8,8,8,16,16,"Yes",4,4,5,3
"779","2017-03-24",9,22,12,34,34,"Yes",7,5,12,10
"780","2017-03-24",2,9,2,11,11,"Yes",2,0,5,4
"781","2017-03-24",3,10,9,19,19,"Yes",5,4,6,4
"782","2017-03-24",3,8,4,12,10,"Yes",1,3,5,3
"783","2017-03-24",3,6,5,11,11,"Yes",4,1,3,3
"784","2017-03-24",3,5,8,13,13,"No",2,6,2,3
"785","2017-03-24",1,2,1,3,7,"Yes",0,1,1,1
"786","2017-03-24",6,6,6,12,12,"Yes",3,3,3,3
"787","2017-03-31",9,16,5,21,21,"Yes",2,3,11,5
"788","2017-03-24",5,16,11,27,28,"Yes",5,6,8,8
"789","2017-03-24",8,14,9,23,23,"Yes",4,5,6,8
"790","2017-03-24",1,2,3,5,5,"Yes",3,0,1,1
"791","2017-03-24",2,5,13,18,7,"Yes",0,13,4,1
"792","2017-03-24",9,27,8,35,35,"Yes",4,4,13,14
"793","2017-03-24",2,4,5,9,9,"Yes",2,3,2,2
"794","2017-03-24",1,3,3,6,6,"Yes",2,1,1,2
"795","2017-03-24",1,2,7,9,9,"Yes",5,2,1,1
"796","2017-03-24",6,13,12,25,14,"No",7,5,5,8
"797","2017-03-24",4,7,8,15,15,"Yes",2,6,1,6
"798","2017-03-24",3,6,7,13,13,"Yes",4,3,3,3
"799","2017-03-24",5,14,11,25,25,"Yes",6,5,10,4
"800","2017-03-24",3,9,4,13,13,"Yes",NA,4,4,5
"801","2017-03-24",8,0,0,0,32,"No",NA,NA,NA,NA
"802","2017-03-24",4,8,7,15,15,"No",3,4,4,4
"803","2017-03-24",5,7,11,18,12,"Yes",6,5,3,4
"804","2017-03-24",7,14,19,33,33,"No",7,12,7,7
"805","2017-03-31",4,7,11,18,17,"Yes",4,7,3,4
"806","2017-03-24",1,3,2,5,5,"Yes",1,1,2,1
"807","2017-03-24",4,8,2,10,10,"Yes",1,1,4,4
"808","2017-03-24",4,4,3,7,7,"No",2,1,2,2
"809","2017-03-24",13,25,15,40,40,"Yes",8,7,14,11
"810","2017-03-25",5,6,6,12,12,"Yes",4,2,3,3
"811","2017-03-24",2,4,5,9,9,"No",3,2,2,2
"812","2017-03-24",6,12,13,25,75,"No",4,9,6,6
"813","2017-03-24",4,13,7,20,16,"Yes",4,3,8,5
"814","2017-03-24",9,18,13,31,31,"Yes",6,7,11,7
"815","2017-03-24",6,11,11,22,22,"Yes",7,4,6,5
"816","2017-03-24",2,5,4,9,9,"Yes",2,2,2,3
"817","2017-03-24",4,8,16,24,24,"Yes",7,9,4,4
"818",NA,2,3,2,5,5,"Yes",1,1,2,1
"819","2017-03-24",16,10,10,20,20,"Yes",4,6,5,5
"820","2017-03-24",4,7,7,14,14,"Yes",4,3,4,3
"821","2017-03-24",4,11,4,15,15,"Yes",3,1,6,5
"822","2017-03-24",416,7,9,16,16,"Yes",5,4,3,4
"823","2017-03-24",4,8,9,17,18,"Yes",6,3,4,4
"824","2017-03-24",1,6,0,6,6,"Yes",0,0,3,3
"825","2017-03-24",1,3,2,5,5,"Yes",1,1,2,1
"826","2017-03-24",4,10,7,17,18,NA,3,4,4,6
"827","2017-03-24",3,10,6,16,17,"Yes",2,4,6,4
"828","2017-03-24",5,13,9,22,25,"Yes",3,6,5,8
"829","2017-03-24",4,10,7,17,17,"Yes",3,4,4,6
"830","2017-03-24",6,14,3,17,17,"Yes",1,2,6,8
"831","2017-03-23",9,14,4,18,18,"Yes",2,2,9,5
"832",NA,1,3,0,3,3,"Yes",NA,NA,1,2
"833","2017-03-24",4,9,5,14,14,"No",4,1,3,6
"834","2017-03-24",5,10,10,20,20,"Yes",3,7,5,5
"835","2017-03-24",8,18,10,28,NA,"Yes",3,7,8,10
"836","2017-03-24",8,15,6,21,21,"Yes",3,3,11,4
"837","2017-03-24",3,6,0,6,2,"Yes",NA,NA,1,5
"838","2017-03-24",4,9,2,11,11,"Yes",0,2,6,3
"839","2017-03-24",3,6,3,9,9,"No",2,1,3,3
"840","2017-03-24",3,6,9,15,15,"Yes",4,5,3,3
"841","2017-03-24",1,9,0,9,9,"No",0,0,8,1
"842","2017-03-24",3,6,6,12,12,"No",2,4,3,3
"843","2017-03-24",2,3,2,5,5,"Yes",0,2,1,2
"844","2017-03-24",3,6,6,12,12,"Yes",1,5,3,3
"845","2017-03-24",4,7,7,14,15,"Yes",3,4,4,3
"846","2017-03-24",5,6,9,15,15,"No",6,3,NA,6
"847","2017-03-24",4,8,8,16,16,"Yes",3,5,4,4
"848","2017-03-24",3,9,1,10,9,"Yes",0,1,5,4
"849","2017-03-24",5,10,8,18,18,"Yes",6,2,5,5
"850","2017-03-24",3,11,7,18,18,"Yes",3,4,6,5
"851","2017-03-24",3,6,3,9,9,"Yes",1,2,3,3
"852","2017-03-24",4,20,10,30,22,"Yes",5,5,10,10
"853","2017-03-24",3,11,9,20,20,"Yes",4,5,3,8
"854","2017-03-24",1,3,0,3,3,"Yes",0,NA,0,3
"855","2017-03-24",2,4,1,5,5,"Yes",0,1,2,2
"856","2017-03-24",6,5,5,10,10,"Yes",3,2,2,3
"857","2017-03-24",2,7,9,16,13,"No",5,4,4,3
"858","2017-03-24",1,0,0,0,9,"Yes",NA,NA,NA,NA
"859","2017-03-24",1,3,5,8,8,"Yes",3,2,1,2
"860",NA,4,10,6,16,16,"No",3,3,3,7
"861","2017-03-24",11,31,12,43,43,"No",8,4,22,9
"862","2017-03-24",3,10,4,14,14,"Yes",3,1,6,4
"863","2017-03-24",2,3,8,11,11,"Yes",2,6,2,1
"864","2017-03-24",7,10,10,20,20,"Yes",4,6,4,6
"865",NA,2,8,5,13,10,"Yes",1,4,5,3
"866","2017-03-24",1,1,0,1,1,"No",0,0,0,1
"867","2017-03-24",1,2,3,5,6,"Yes",0,3,1,1
"868","2017-03-24",3,6,7,13,13,"Yes",1,6,3,3
"869","2017-03-24",4,10,15,25,25,"Yes",9,6,4,6
"870","2017-03-24",2,5,6,11,11,"Yes",5,1,2,3
"871","2017-03-24",7,17,7,24,25,"Yes",5,2,11,6
"872","2017-03-24",3,8,1,9,6,"No",0,1,4,4
"873","2017-03-24",4,12,5,17,17,"No",1,4,5,7
"874","2017-03-24",2,4,6,10,10,"No",2,4,2,2
"875","2017-03-24",9,14,17,31,27,"No",5,12,6,8
"876","2017-03-24",5,7,5,12,12,"Yes",2,3,4,3
"877","2017-03-24",1,2,4,6,6,"Yes",3,1,1,1
"878","2017-03-24",5,7,3,10,10,"Yes",0,3,4,3
"879","2017-03-24",3,6,6,12,12,"Yes",3,3,4,2
"880","2017-03-24",2,4,14,18,16,"Yes",7,7,2,2
"881","2017-03-24",2,3,2,5,6,"No",2,0,1,2
"882","2017-03-24",2,12,9,21,15,"Yes",8,1,5,7
"883","2017-03-24",NA,7,6,13,NA,"Yes",4,2,5,2
"884","2017-03-24",6,7,20,27,27,"Yes",10,10,5,2
"885","2017-03-24",4,15,7,22,22,"No",3,4,8,7
"886","2017-03-24",5,9,7,16,16,"No",3,4,5,4
"887",NA,1,0,0,0,6,"Yes",NA,NA,NA,NA
"888","2017-03-24",2,4,4,8,7,"Yes",1,3,2,2
"889","2017-03-24",4,10,11,21,18,"No",6,5,4,6
"890","2017-03-24",3,6,11,17,17,"Yes",8,3,4,2
"891","2017-03-24",1,3,0,3,10,"Yes",0,0,3,0
"892","2017-03-24",1,2,6,8,6,"Yes",2,4,1,1
"893","2017-03-24",2,8,4,12,10,"No",2,2,4,4
"894",NA,2,4,6,10,10,"Yes",4,2,2,2
"895","2017-03-24",5,10,0,10,10,"Yes",0,0,5,5
"896","2017-03-24",4,5,1,6,6,"Yes",0,1,3,2
"897","2017-03-24",12,25,25,50,50,"No",15,10,15,10
"898","2017-03-24",5,9,10,19,19,"Yes",6,4,4,5
"899","2017-03-31",4,4,5,9,9,"Yes",3,2,2,2
"900","2017-03-24",2,4,5,9,9,"No",2,3,2,2
"901","2017-03-24",2,4,6,10,10,"Yes",2,4,2,2
"902","2017-03-24",10,14,8,22,22,"No",2,6,7,7
"903","2017-03-24",2,5,2,7,7,"Yes",1,1,4,1
"904","2017-03-24",1,4,1,5,5,"Yes",NA,1,2,2
"905","2017-03-24",7,12,6,18,19,"Yes",2,4,7,5
"906","2017-03-24",1,3,1,4,4,"Yes",0,1,1,2
"907","2017-03-24",2,6,0,6,9,"Yes",0,0,1,5
"908","2017-03-24",2,11,14,25,19,"Yes",10,4,4,7
"909","2017-03-24",3,6,10,16,16,"Yes",3,7,3,3
"910","2017-03-24",2,7,1,8,8,"Yes",0,1,3,4
"911","2017-03-24",NA,4,5,9,NA,"Yes",2,3,3,1
"912","2017-03-24",2,6,6,12,10,"Yes",4,2,4,2
"913","2017-03-24",2,2,0,2,2,"No",0,0,1,1
"914","2017-03-24",1,4,3,7,7,"Yes",2,1,2,2
"915","2017-03-24",1,6,5,11,10,"Yes",3,2,1,5
"916","2017-03-24",2,8,3,11,11,"Yes",0,3,4,4
"917","2017-03-24",7,10,5,15,15,"No",2,3,3,7
"918","2017-03-24",2,6,2,8,8,"Yes",1,1,3,3
"919","2017-03-24",2,3,2,5,5,"No",1,1,2,1
"920","2017-03-24",4,6,4,10,10,"Yes",1,3,3,3
"921","2017-03-24",NA,4,19,23,NA,"No",6,13,2,2
"922","2017-03-24",1,5,4,9,9,"Yes",2,2,2,3
"923","2017-03-24",5,10,10,20,20,"Yes",5,5,4,6
"924","2017-03-25",2,4,4,8,8,"Yes",3,1,2,2
"925","2017-03-25",3,10,1,11,11,"Yes",1,0,7,3
"926","2017-03-25",NA,7,0,7,NA,"No",NA,NA,5,2
"927","2017-03-25",2,4,2,6,6,"Yes",1,1,2,2
"928","2017-03-25",3,4,6,10,10,"Yes",3,3,2,2
"929","2017-03-25",3,6,0,6,6,"Yes",NA,0,5,1
"930","2017-03-25",2,6,4,10,10,"Yes",2,2,2,4
"931","2017-03-25",3,4,7,11,11,"Yes",1,6,2,2
"932","2017-03-25",9,8,3,11,11,"Yes",1,2,4,4
"933","2017-03-25",6,15,13,28,28,"No",4,9,8,7
"934","2017-03-25",NA,120,0,120,NA,"No",NA,NA,40,80
"935","2017-03-25",4,7,10,17,17,"Yes",6,4,4,3
"936","2017-04-01",3,5,8,13,13,"Yes",4,4,1,4
"937","2017-03-25",5,7,4,11,26,"Yes",2,2,3,4
"938","2017-03-25",NA,10,408,418,NA,"Yes",180,228,3,7
"939","2017-03-25",1,4,2,6,6,"Yes",2,NA,3,1
"940","2017-03-25",4,6,8,14,12,"Yes",1,7,2,4
"941","2017-03-25",7,14,8,22,NA,"No",3,5,7,7
"942","2017-03-25",1,2,3,5,5,"Yes",2,1,1,1
"943","2017-03-25",2,8,5,13,13,"Yes",3,2,2,6
"944","2017-03-25",5,8,16,24,17,"Yes",9,7,4,4
"945","2017-03-25",5,6,5,11,11,"No",2,3,3,3
"946","2017-03-25",4,10,7,17,17,"Yes",3,4,8,2
"947","2017-03-25",4,7,8,15,15,"No",4,4,3,4
"948","2017-03-25",2,4,8,12,9,"Yes",3,5,2,2
"949","2017-03-25",3,6,7,13,6,"No",3,4,3,3
"950",NA,7,8,3,11,11,"No",0,3,4,4
"951","2017-03-25",7,14,16,30,30,"Yes",4,12,7,7
"952","2017-03-25",4,13,5,18,14,"No",3,2,6,7
"953","2017-03-25",8,10,5,15,15,"Yes",2,3,5,5
"954","2017-03-25",3,7,6,13,14,"Yes",1,5,4,3
"955","2017-03-25",1,8,0,8,8,"Yes",0,0,5,3
"956","2017-03-25",4,6,3,9,15,"Yes",2,1,3,3
"957","2017-03-25",NA,10,14,24,NA,"Yes",8,6,5,5
"958","2017-03-25",1,3,6,9,9,"No",2,4,2,1
"959","2017-03-25",1,3,5,8,8,"Yes",3,2,1,2
"960","2017-03-25",5,10,7,17,17,"Yes",3,4,5,5
"961","2017-03-25",1,5,5,10,6,"Yes",2,3,3,2
"962",NA,7,14,6,20,20,"No",1,5,7,7
"963","2017-03-25",3,8,11,19,18,"No",4,7,1,7
"964","2017-03-18",3,4,1,5,10,"Yes",0,1,2,2
"965","2017-03-25",1,7,2,9,8,"Yes",1,1,5,2
"966","2017-03-25",2,4,5,9,9,"Yes",1,4,2,2
"967","2017-03-25",2,4,4,8,8,"Yes",1,3,2,2
"968","2017-03-25",1,3,0,3,3,"Yes",0,0,2,1
"969","2017-03-25",1,2,7,9,9,"Yes",6,1,1,1
"970","2017-03-25",4,8,7,15,15,"Yes",4,3,4,4
"971","2017-03-25",4,13,6,19,20,"No",2,4,6,7
"972","2017-03-25",1,1,7,8,8,"No",4,3,1,0
"973","2017-03-25",4,12,7,19,19,"No",3,4,8,4
"974","2017-03-25",3,9,6,15,15,"Yes",3,3,4,5
"975","2017-03-25",11,22,21,43,24,"Yes",9,12,11,11
"976","2017-03-25",1,9,7,16,16,"Yes",4,3,3,6
"977","2017-03-25",3,3,1,4,10,"Yes",0,1,2,1
"978","2017-03-25",1,5,4,9,9,"Yes",2,2,2,3
"979","2017-03-25",1,4,0,4,4,"Yes",0,0,4,0
"980","2017-03-25",4,7,0,7,7,"Yes",NA,NA,4,3
"981","2017-03-25",6,14,15,29,29,"No",5,10,7,7
"982","2017-03-25",5,8,2,10,8,"Yes",2,0,7,1
"983","2017-03-25",1,3,4,7,7,"Yes",2,2,1,2
"984","2017-03-25",1,2,6,8,8,"Yes",1,5,1,1
"985","2017-03-25",4,9,4,13,15,"Yes",2,2,3,6
"986","2017-03-25",5,6,4,10,10,"Yes",1,3,3,3
"987","2017-03-25",1,2,5,7,7,"Yes",2,3,1,1
"988","2017-03-25",3,6,3,9,5,"Yes",1,2,4,2
"989","2017-03-25",3,5,6,11,9,"Yes",3,3,3,2
"990",NA,1,1,1,2,2,"Yes",NA,1,NA,1
"991","2017-03-25",3,6,4,10,10,"Yes",1,3,2,4
"992","2017-03-25",2,2,4,6,6,"Yes",1,3,1,1
"993","2017-04-01",12,17,11,28,40,"Yes",4,7,6,11
"994","2017-03-25",7,14,10,24,24,"Yes",6,4,7,7
"995","2017-03-25",1,2,1,3,3,"Yes",1,NA,1,1
"996","2017-03-25",3,5,12,17,17,"Yes",9,3,2,3
"997","2017-03-25",1,3,6,9,9,"Yes",2,4,0,3
"998","2017-03-25",3,8,11,19,19,"Yes",3,8,4,4
"999","2017-03-25",4,6,2,8,8,"Yes",0,2,4,2
"1000","2017-03-25",3,6,9,15,15,"No",4,5,2,4
"1001","2017-03-25",4,13,9,22,22,"Yes",5,4,8,5
"1002","2017-03-25",3,8,11,19,19,"Yes",2,9,2,6
"1003","2017-03-25",3,9,10,19,19,"Yes",4,6,5,4
"1004","2017-03-25",4,14,7,21,21,"Yes",4,3,8,6
"1005","2017-03-25",2,4,8,12,12,"Yes",2,6,2,2
"1006","2017-03-25",NA,8,11,19,NA,"No",3,8,5,3
"1007","2017-03-25",5,10,24,34,34,"No",8,16,5,5
"1008","2017-03-25",3,4,4,8,8,"Yes",1,3,2,2
"1009","2017-03-25",2,5,2,7,7,"Yes",NA,2,3,2
"1010","2017-03-25",1,7,1,8,8,"No",0,1,5,2
"1011","2017-03-25",4,9,13,22,22,"No",7,6,4,5
"1012","2017-03-24",1,8,2,10,10,"Yes",1,1,5,3
"1013","2017-03-24",17,53,15,68,73,"No",6,9,33,20
"1014","2017-03-24",4,11,4,15,16,"Yes",3,1,5,6
"1015","2017-03-24",2,6,3,9,9,"No",2,1,2,4
"1016","2017-03-24",3,10,5,15,15,"Yes",2,3,6,4
"1017","2017-03-24",3,6,3,9,8,"No",1,2,3,3
"1018","2017-03-24",2,11,9,20,10,"No",3,6,4,7
"1019","2017-03-27",8,4,11,15,15,"Yes",5,6,1,3
"1020","2017-03-27",3,8,4,12,14,"Yes",2,2,5,3
"1021","2017-03-27",7,14,0,14,NA,"No",NA,NA,7,7
"1022","2017-03-27",1,6,10,16,16,"Yes",8,2,3,3
"1023","2017-03-27",8,25,12,37,47,"No",4,8,18,7
"1024","2017-03-27",2,3,1,4,4,"Yes",1,0,1,2
"1025","2017-03-27",9,14,26,40,40,"No",11,15,6,8
"1026","2017-03-27",5,22,3,25,25,"No",2,1,13,9
"1027","2017-03-27",3,7,0,7,7,"No",0,0,4,3
"1028","2017-03-27",1,3,3,6,6,"Yes",2,1,1,2
"1029","2017-03-27",2,4,5,9,9,"No",1,4,2,2
"1030","2017-03-27",3,6,5,11,6,"No",3,2,3,3
"1031","2017-03-27",6,12,13,25,25,"Yes",7,6,7,5
"1032","2017-03-27",5,10,12,22,21,"Yes",7,5,5,5
"1033","2017-03-27",2,3,4,7,7,"No",1,3,1,2
"1034","2017-03-27",6,20,11,31,28,"Yes",5,6,11,9
"1035","2017-03-27",1,2,4,6,5,"No",2,2,1,1
"1036","2017-03-27",3,5,6,11,11,NA,3,3,2,3
"1037","2017-03-27",NA,6,6,12,NA,"No",5,1,3,3
"1038","2017-03-27",4,13,8,21,21,"Yes",5,3,6,7
"1039","2017-03-27",6,13,6,19,19,"Yes",3,3,5,8
"1040","2017-03-27",3,6,9,15,15,"Yes",4,5,3,3
"1041","2017-03-27",4,11,6,17,17,"No",3,3,8,3
"1042","2017-04-03",1,2,2,4,4,"Yes",2,NA,1,1
"1043","2017-03-27",3,5,3,8,8,"Yes",NA,3,4,1
"1044","2017-03-27",8,16,18,34,34,NA,11,7,8,8
"1045","2017-03-27",1,4,4,8,8,"Yes",2,2,2,2
"1046","2017-03-27",2,4,2,6,6,"No",0,2,2,2
"1047","2017-03-27",2,7,3,10,10,"No",2,1,5,2
"1048","2017-03-27",4,5,1,6,6,"No",0,1,2,3
"1049","2017-03-27",7,14,21,35,35,"Yes",11,10,7,7
"1050","2017-03-27",1,3,7,10,9,"Yes",3,4,1,2
"1051","2017-03-27",5,7,11,18,18,"Yes",5,6,4,3
"1052","2017-03-27",6,12,18,30,30,"Yes",7,11,6,6
"1053","2017-03-27",6,2,2,4,4,"Yes",1,1,1,1
"1054","2017-03-27",1,6,1,7,7,"Yes",0,1,4,2
"1055","2017-03-27",17,29,3,32,32,"Yes",1,2,21,8
"1056","2017-03-27",5,15,10,25,25,"No",4,6,10,5
"1057","2017-03-27",4,6,2,8,8,"Yes",0,2,3,3
"1058","2017-03-27",11,25,10,35,35,"Yes",5,5,10,15
"1059","2017-03-24",1,2,3,5,5,"Yes",1,2,1,1
"1060","2017-03-27",1,2,3,5,7,"Yes",1,2,1,1
"1061","2017-03-27",2,4,9,13,11,"No",7,2,2,2
"1062","2017-03-24",1,3,1,4,5,"Yes",0,1,1,2
"1063","2017-03-27",7,13,13,26,26,"Yes",5,8,6,7
"1064","2017-03-27",7,11,12,23,22,"Yes",5,7,5,6
"1065","2017-03-27",4,7,2,9,9,"No",1,1,3,4
"1066","2017-03-27",1,2,6,8,8,"Yes",3,3,1,1
"1067","2017-03-27",6,10,5,15,15,"No",2,3,5,5
"1068","2017-03-27",2,3,6,9,9,"Yes",2,4,1,2
"1069","2017-03-27",3,9,3,12,12,"Yes",1,2,4,5
"1070","2017-03-27",3,4,5,9,8,"Yes",3,2,1,3
"1071",NA,8,11,7,18,15,"No",3,4,5,6
"1072","2017-03-27",1,3,4,7,7,"Yes",2,2,2,1
"1073","2017-03-27",5,6,8,14,14,"Yes",4,4,4,2
"1074","2017-03-27",6,10,10,20,20,"No",4,6,5,5
"1075","2017-03-27",1,6,1,7,6,"Yes",0,1,2,4
"1076","2017-03-27",5,9,16,25,25,"No",5,11,4,5
"1077","2017-03-27",NA,270,180,450,NA,"No",80,100,120,150
"1078","2017-03-27",6,12,10,22,24,"Yes",4,6,6,6
"1079","2017-03-27",5,15,3,18,19,NA,NA,3,8,7
"1080","2017-03-27",3,6,6,12,12,"No",5,1,3,3
"1081","2017-03-27",1,2,0,2,2,"Yes",NA,NA,1,1
"1082","2017-03-27",3,7,3,10,10,"No",1,2,4,3
"1083","2017-03-27",1,4,4,8,4,"No",2,2,2,2
"1084","2017-03-27",3,5,9,14,14,"Yes",5,4,2,3
"1085","2017-03-27",5,5,7,12,12,"No",4,3,2,3
"1086","2017-03-27",4,10,5,15,15,"Yes",3,2,6,4
"1087","2017-03-27",2,4,1,5,6,"Yes",0,1,2,2
"1088","2017-03-27",1,2,4,6,6,"Yes",2,2,1,1
"1089","2017-03-27",1,2,0,2,2,"Yes",0,0,2,0
"1090","2017-03-27",NA,8,3,11,NA,"Yes",2,1,4,4
"1091","2017-03-27",24,100,44,144,144,"Yes",22,22,45,55
"1092","2017-03-27",3,7,9,16,16,"No",5,4,3,4
"1093","2017-03-27",8,16,9,25,23,"No",5,4,8,8
"1094","2017-03-27",1,4,6,10,10,"Yes",2,4,1,3
"1095","2017-03-27",1,3,3,6,5,"Yes",1,2,2,1
"1096","2017-03-27",3,8,12,20,20,"Yes",6,6,2,6
"1097","2017-03-27",4,8,9,17,17,"No",3,6,4,4
"1098","2017-03-27",5,10,10,20,20,"Yes",4,6,5,5
"1099","2017-03-27",9,10,10,20,20,"No",4,6,5,5
"1100","2017-03-27",6,6,9,15,15,"No",6,3,3,3
"1101","2017-03-27",NA,38,0,38,NA,"No",NA,NA,23,15
"1102","2017-03-27",NA,6,3,9,6,"Yes",2,1,3,3
"1103","2017-03-27",5,9,9,18,18,"Yes",5,4,4,5
"1104","2017-03-27",1,4,2,6,5,"Yes",2,NA,3,1
"1105","2017-03-27",8,14,13,27,27,NA,9,4,7,7
"1106","2017-03-27",2,4,4,8,8,"No",1,3,2,2
"1107","2017-03-27",3,5,1,6,6,"Yes",1,0,4,1
"1108","2017-03-27",2,4,4,8,8,"Yes",2,2,2,2
"1109","2017-03-27",1,3,1,4,4,"Yes",NA,1,2,1
"1110","2017-03-27",3,7,10,17,17,"No",4,6,4,3
"1111","2017-03-27",2,3,7,10,10,"Yes",4,3,2,1
"1112","2017-03-27",4,8,13,21,21,"Yes",5,8,3,5
"1113","2017-03-27",1,2,4,6,6,"Yes",2,2,1,1
"1114","2017-03-27",5,10,8,18,20,"Yes",3,5,5,5
"1115","2017-03-27",8,5,8,13,13,"Yes",3,5,2,3
"1116","2017-03-27",1,9,0,9,9,"Yes",NA,NA,2,7
"1117","2017-03-27",5,7,5,12,12,"Yes",3,2,3,4
"1118","2017-03-27",9,18,8,26,26,NA,5,3,10,8
"1119","2017-03-27",9,12,4,16,6,"Yes",1,3,7,5
"1120","2017-03-27",4,5,10,15,15,"Yes",5,5,2,3
"1121","2017-03-27",5,9,7,16,15,"No",6,1,6,3
"1122","2017-03-27",10,26,16,42,42,"Yes",6,10,11,15
"1123","2017-03-27",2,4,2,6,6,"Yes",2,NA,2,2
"1124","2017-03-27",6,8,6,14,16,"Yes",2,4,4,4
"1125","2017-03-27",12,31,29,60,60,"Yes",14,15,15,16
"1126","2017-03-27",2,5,11,16,11,"Yes",4,7,4,1
"1127","2017-03-27",6,11,11,22,22,"Yes",7,4,5,6
"1128","2017-03-27",NA,9,130,139,NA,"Yes",70,60,4,5
"1129","2017-03-27",3,7,6,13,11,"Yes",3,3,2,5
"1130","2017-03-27",1,2,2,4,4,"Yes",1,1,1,1
"1131","2017-03-27",NA,120,0,120,NA,"No",NA,NA,100,20
"1132","2017-03-27",6,10,5,15,25,"Yes",2,3,5,5
"1133","2017-03-27",1,5,4,9,9,"Yes",3,1,2,3
"1134","2017-03-27",1,5,4,9,9,"Yes",2,2,2,3
"1135","2017-03-27",2,8,4,12,12,"Yes",3,1,4,4
"1136","2017-03-27",2,7,0,7,7,"Yes",0,0,5,2
"1137","2017-03-27",9,10,11,21,21,"No",5,6,5,5
"1138","2017-03-27",13,30,45,75,60,"No",20,25,15,15
"1139","2017-03-27",3,11,5,16,12,"No",3,2,8,3
"1140","2017-03-27",4,9,12,21,9,"Yes",7,5,4,5
"1141","2017-03-27",4,8,5,13,16,"No",2,3,4,4
"1142","2017-03-27",4,9,7,16,16,"Yes",2,5,4,5
"1143","2017-03-27",3,6,3,9,9,"Yes",1,2,3,3
"1144","2017-03-27",3,4,2,6,6,"Yes",2,0,2,2
"1145","2017-03-27",2,7,4,11,11,"No",2,2,3,4
"1146","2017-03-27",6,5,7,12,12,"Yes",3,4,3,2
"1147","2017-03-27",2,5,0,5,5,"Yes",0,0,3,2
"1148","2017-03-27",3,6,3,9,9,"Yes",2,1,3,3
"1149","2017-03-27",2,8,1,9,8,"Yes",1,0,4,4
"1150","2017-03-20",3,10,5,15,15,"No",3,2,4,6
"1151","2017-03-27",12,27,20,47,47,"Yes",8,12,12,15
"1152","2017-03-27",1,3,2,5,5,"Yes",NA,2,2,1
"1153","2017-03-27",4,8,8,16,16,"Yes",2,6,4,4
"1154","2017-03-27",3,6,4,10,10,"Yes",3,1,3,3
"1155","2017-03-27",1,2,4,6,6,"Yes",3,1,1,1
"1156","2017-03-28",7,15,2,17,17,"Yes",1,1,8,7
"1157","2017-03-27",5,5,7,12,12,"Yes",5,2,3,2
"1158","2017-03-27",3,6,4,10,10,"Yes",3,1,3,3
"1159","2017-03-27",3,5,6,11,12,"Yes",2,4,2,3
"1160","2017-03-27",3,5,8,13,5,"No",0,8,3,2
"1161","2017-03-27",8,8,22,30,30,NA,11,11,4,4
"1162","2017-03-27",1,3,2,5,4,"No",1,1,1,2
"1163","2017-03-27",3,4,5,9,9,"Yes",4,1,2,2
"1164","2017-03-27",6,19,11,30,30,"No",5,6,9,10
"1165","2017-03-27",6,10,9,19,19,"Yes",6,3,5,5
"1166","2017-03-27",7,0,0,0,NA,"No",NA,NA,NA,NA
"1167","2017-03-27",4,6,6,12,16,"Yes",3,3,1,5
"1168","2017-03-27",1,2,5,7,7,"Yes",1,4,1,1
"1169","2017-03-27",3,6,8,14,14,"Yes",2,6,2,4
"1170","2017-03-27",4,5,11,16,16,"No",4,7,2,3
"1171","2017-03-27",9,18,8,26,26,"Yes",4,4,10,8
"1172","2017-03-27",5,4,6,10,10,"Yes",5,1,2,2
"1173","2017-03-27",NA,2,0,2,NA,"Yes",0,0,1,1
"1174","2017-03-27",5,10,6,16,18,"Yes",3,3,8,2
"1175","2017-03-27",8,16,4,20,21,"Yes",2,2,8,8
"1176","2017-03-27",6,10,12,22,22,"Yes",8,4,5,5
"1177","2017-03-27",1,7,4,11,11,"Yes",3,1,5,2
"1178","2017-03-27",2,6,3,9,9,"Yes",2,1,2,4
"1179","2017-03-27",3,7,10,17,17,"Yes",4,6,4,3
"1180","2017-03-27",10,28,23,51,57,"Yes",11,12,16,12
"1181","2017-03-27",4,4,2,6,6,"No",2,0,2,2
"1182","2017-03-27",7,12,12,24,24,"No",9,3,7,5
"1183","2017-03-27",2,5,4,9,8,"Yes",3,1,3,2
"1184","2017-03-27",4,8,2,10,10,"Yes",0,2,4,4
"1185","2017-04-03",6,28,6,34,34,"Yes",3,3,18,10
"1186","2017-03-27",7,13,17,30,30,"Yes",8,9,6,7
"1187","2017-04-03",3,4,4,8,11,"Yes",3,1,2,2
"1188","2017-03-27",7,14,12,26,26,"Yes",7,5,7,7
"1189","2017-03-27",3,7,6,13,13,"Yes",4,2,3,4
"1190","2017-03-27",4,8,10,18,18,"No",4,6,5,3
"1191","2017-03-27",4,11,9,20,24,"Yes",5,4,7,4
"1192","2017-03-27",2,8,15,23,23,"Yes",3,12,4,4
"1193","2017-03-27",5,12,10,22,22,"Yes",8,2,9,3
"1194","2017-03-27",2,5,3,8,8,"Yes",1,2,1,4
"1195","2017-03-27",1,3,0,3,4,"Yes",0,0,2,1
"1196","2017-03-27",6,14,14,28,28,"Yes",8,6,9,5
"1197","2017-03-27",4,10,5,15,15,"Yes",3,2,5,5
"1198","2017-03-27",2,5,4,9,8,"Yes",1,3,2,3
"1199","2017-03-27",2,7,3,10,10,"No",1,2,4,3
"1200","2017-03-27",7,7,7,14,21,"Yes",3,4,4,3
"1201","2017-03-27",5,5,6,11,11,NA,3,3,2,3
"1202","2017-03-27",4,9,3,12,12,"Yes",2,1,3,6
"1203","2017-03-27",3,10,7,17,17,"No",3,4,5,5
"1204","2017-03-27",2,5,2,7,7,"No",1,1,2,3
"1205","2017-03-27",3,7,7,14,14,"Yes",3,4,3,4
"1206","2017-03-27",2,4,0,4,4,"No",0,0,2,2
"1207","2017-03-27",1,1,0,1,1,"Yes",NA,NA,1,NA
"1208","2017-03-27",5,12,8,20,20,"No",5,3,5,7
"1209","2017-03-27",3,12,4,16,10,"Yes",1,3,6,6
"1210","2017-03-27",2,7,3,10,10,"Yes",2,1,3,4
"1211","2017-03-27",4,7,2,9,9,"No",1,1,4,3
"1212","2017-03-27",3,6,3,9,9,"Yes",0,3,4,2
"1213","2017-03-27",3,5,11,16,16,"Yes",7,4,2,3
"1214",NA,2,4,8,12,12,"Yes",3,5,2,2
"1215","2017-03-27",3,4,4,8,8,"Yes",2,2,1,3
"1216","2017-03-27",5,11,3,14,15,"Yes",2,1,5,6
"1217","2017-03-27",2,4,7,11,11,NA,3,4,2,2
"1218","2017-03-27",3,9,6,15,15,"Yes",2,4,6,3
"1219","2017-03-27",5,10,13,23,21,"Yes",5,8,4,6
"1220","2017-03-27",2,4,1,5,5,"No",1,0,2,2
"1221","2017-03-27",5,9,6,15,15,"No",2,4,4,5
"1222","2017-03-27",1,2,3,5,5,"Yes",1,2,1,1
"1223","2017-03-27",2,6,2,8,10,"Yes",1,1,2,4
"1224","2017-03-27",5,9,12,21,24,"Yes",4,8,4,5
"1225","2017-03-27",7,0,0,0,NA,"Yes",NA,NA,NA,NA
"1226","2017-03-27",NA,1,4,5,NA,"Yes",3,1,NA,1
"1227","2017-03-27",8,16,8,24,18,"No",8,NA,8,8
"1228","2017-03-27",2,4,5,9,8,NA,2,3,2,2
"1229","2017-03-27",NA,0,470,470,NA,"No",170,300,NA,NA
"1230","2017-03-27",7,16,5,21,22,"Yes",5,0,7,9
"1231","2017-03-27",3,7,4,11,11,"Yes",2,2,5,2
"1232","2017-03-27",1,2,5,7,7,"Yes",2,3,1,1
"1233","2017-03-27",1,2,4,6,6,"No",1,3,1,1
"1234","2017-03-27",4,10,2,12,7,"Yes",2,0,3,7
"1235","2017-03-27",3,8,5,13,13,"Yes",2,3,5,3
"1236","2017-03-27",6,12,20,32,32,"No",5,15,6,6
"1237","2017-03-27",1,4,6,10,10,"Yes",4,2,2,2
"1238","2017-03-27",4,9,7,16,16,"Yes",2,5,4,5
"1239","2017-03-27",1,4,3,7,7,"Yes",2,1,2,2
"1240","2017-03-27",6,10,2,12,12,"No",0,2,6,4
"1241","2017-03-27",4,13,14,27,27,"Yes",6,8,5,8
"1242","2017-03-27",5,8,9,17,NA,NA,5,4,4,4
"1243","2017-03-27",2,8,3,11,11,"Yes",1,2,3,5
"1244","2017-03-27",4,14,3,17,17,"Yes",0,3,7,7
"1245","2017-03-27",3,8,3,11,16,"Yes",1,2,5,3
"1246","2017-03-27",2,6,8,14,11,"Yes",3,5,3,3
"1247","2017-03-27",4,8,10,18,18,"No",4,6,4,4
"1248","2017-03-27",3,7,14,21,21,"Yes",6,8,3,4
"1249","2017-03-27",3,7,9,16,16,"Yes",6,3,3,4
"1250","2017-03-27",1,5,2,7,7,"Yes",2,0,2,3
"1251","2017-03-27",6,10,10,20,20,"No",4,6,5,5
"1252","2017-03-27",3,4,3,7,4,"Yes",1,2,3,1
"1253","2017-03-27",4,8,8,16,16,"No",5,3,4,4
"1254","2017-03-27",8,16,6,22,22,"No",1,5,8,8
"1255","2017-03-27",1,2,2,4,4,"Yes",1,1,0,2
"1256","2017-03-27",8,13,4,17,NA,"No",2,2,5,8
"1257","2017-03-27",2,4,10,14,8,"No",6,4,2,2
"1258","2017-03-27",5,8,10,18,20,"No",5,5,4,4
"1259","2017-03-27",7,10,8,18,22,"No",4,4,4,6
"1260","2017-03-27",9,19,7,26,26,"Yes",2,5,10,9
"1261","2017-03-27",3,9,5,14,14,"Yes",2,3,5,4
"1262","2017-03-27",4,7,1,8,12,"No",0,1,5,2
"1263","2017-03-27",3,25,9,34,18,"Yes",5,4,17,8
"1264","2017-03-27",2,3,1,4,4,"No",0,1,1,2
"1265","2017-03-27",2,5,0,5,5,"Yes",0,0,2,3
"1266","2017-03-27",3,10,5,15,15,"Yes",2,3,4,6
"1267","2017-03-27",3,6,1,7,7,"No",0,1,3,3
"1268","2017-03-27",3,7,8,15,15,"No",2,6,4,3
"1269","2017-03-27",7,10,11,21,21,"Yes",5,6,4,6
"1270","2017-03-27",2,4,1,5,5,"Yes",1,0,2,2
"1271","2017-03-27",5,10,13,23,23,"No",4,9,5,5
"1272","2017-03-27",3,5,0,5,5,"No",0,0,5,0
"1273","2017-03-27",5,10,5,15,15,"No",3,2,4,6
"1274","2017-03-27",4,9,4,13,13,"Yes",2,2,5,4
"1275","2017-03-27",1,8,9,17,13,"Yes",7,2,4,4
"1276","2017-03-27",2,7,4,11,11,"Yes",1,3,3,4
"1277","2017-03-27",7,14,5,19,14,"Yes",2,3,5,9
"1278","2017-03-27",3,8,6,14,14,"Yes",3,3,5,3
"1279","2017-03-27",3,7,4,11,13,"No",2,2,3,4
"1280","2017-03-27",4,9,3,12,12,"Yes",1,2,6,3
"1281","2017-03-27",5,5,5,10,8,"No",2,3,1,4
"1282","2017-03-27",3,5,6,11,11,"Yes",2,4,3,2
"1283","2017-03-27",3,4,0,4,5,"Yes",0,0,2,2
"1284","2017-03-27",8,8,7,15,15,"No",4,3,4,4
"1285","2017-03-27",5,9,4,13,14,"Yes",1,3,4,5
"1286","2017-03-27",1,4,3,7,7,"Yes",2,1,3,1
"1287","2017-03-27",2,9,0,9,10,"No",0,0,4,5
"1288","2017-03-27",5,11,5,16,28,"Yes",2,3,4,7
"1289",NA,4,11,8,19,19,"No",4,4,5,6
"1290","2017-03-27",5,10,8,18,18,"Yes",2,6,5,5
"1291","2017-03-27",4,7,5,12,12,"Yes",2,3,4,3
"1292","2017-03-27",2,4,5,9,9,"No",2,3,2,2
"1293","2017-03-27",NA,9,12,21,NA,"No",4,8,4,5
"1294","2017-03-27",2,4,4,8,8,"Yes",1,3,2,2
"1295","2017-03-27",4,9,10,19,19,"Yes",6,4,4,5
"1296","2017-03-27",6,17,6,23,23,"Yes",3,3,7,10
"1297","2017-03-27",8,18,7,25,25,"No",4,3,10,8
"1298","2017-03-27",1,5,9,14,19,"Yes",8,1,2,3
"1299","2017-03-27",4,11,3,14,14,"No",2,1,5,6
"1300","2017-03-27",4,11,6,17,17,"Yes",2,4,6,5
"1301","2017-03-27",3,9,6,15,15,"Yes",2,4,5,4
"1302","2017-03-27",6,14,8,22,27,"Yes",5,3,6,8
"1303","2017-03-27",2,4,5,9,9,"Yes",2,3,2,2
"1304","2017-03-27",6,10,2,12,12,"Yes",0,2,4,6
"1305","2017-03-27",6,13,10,23,25,"Yes",6,4,5,8
"1306","2017-03-27",5,10,11,21,22,"No",4,7,5,5
"1307","2017-03-27",2,9,1,10,10,"Yes",1,0,5,4
"1308","2017-03-27",4,8,12,20,20,"No",6,6,4,4
"1309",NA,2,10,4,14,14,"Yes",2,2,5,5
"1310","2017-03-27",3,13,5,18,20,"No",1,4,7,6
"1311","2017-03-27",3,7,3,10,10,"Yes",2,1,4,3
"1312","2017-03-27",3,6,7,13,13,"No",3,4,3,3
"1313","2017-03-27",6,21,8,29,31,"No",3,5,9,12
"1314","2017-03-27",6,15,13,28,28,"No",6,7,9,6
"1315","2017-03-27",5,6,10,16,16,"No",3,7,4,2
"1316","2017-04-03",2,4,6,10,11,"Yes",2,4,2,2
"1317","2017-03-27",1,2,4,6,6,"No",2,2,1,1
"1318","2017-03-27",7,14,12,26,26,"Yes",4,8,7,7
"1319","2017-03-27",6,16,4,20,25,"No",1,3,7,9
"1320","2017-03-27",1,5,7,12,8,"Yes",3,4,1,4
"1321","2017-03-27",1,2,6,8,8,"No",3,3,1,1
"1322","2017-03-27",2,6,3,9,10,"Yes",2,1,2,4
"1323","2017-03-27",4,6,2,8,8,"No",1,1,4,2
"1324","2017-03-27",5,4,6,10,10,"No",3,3,2,2
"1325","2017-03-27",2,5,0,5,6,"Yes",0,0,3,2
"1326","2017-03-27",9,23,10,33,32,"Yes",6,4,7,16
"1327","2017-03-27",5,13,8,21,22,"Yes",1,7,3,10
"1328","2017-03-27",5,10,12,22,22,"Yes",7,5,5,5
"1329","2017-03-27",2,4,6,10,11,"Yes",5,1,2,2
"1330","2017-03-27",5,11,9,20,26,"No",4,5,5,6
"1331","2017-03-27",5,12,5,17,18,"No",1,4,5,7
"1332","2017-03-27",2,4,3,7,7,"Yes",1,2,3,1
"1333","2017-03-27",5,12,7,19,25,"Yes",3,4,5,7
"1334","2017-03-27",2,7,3,10,13,"Yes",2,1,1,6
"1335","2017-03-27",4,9,3,12,12,"Yes",2,1,3,6
"1336","2017-03-27",2,5,5,10,10,"No",3,2,2,3
"1337","2017-03-27",3,13,5,18,19,"No",3,2,5,8
"1338","2017-03-27",1,2,2,4,4,"No",1,1,1,1
"1339","2017-03-27",6,15,7,22,24,"No",3,4,6,9
"1340","2017-03-27",1,4,0,4,4,"Yes",0,0,3,1
"1341","2017-03-27",8,9,11,20,20,"Yes",5,6,4,5
"1342","2017-03-27",3,6,3,9,9,"No",1,2,3,3
"1343","2017-03-27",3,9,5,14,14,"No",2,3,3,6
"1344","2017-03-27",5,11,5,16,16,"Yes",2,3,6,5
"1345","2017-03-27",5,8,0,8,8,"Yes",0,0,4,4
"1346","2017-03-24",3,10,6,16,16,"Yes",3,3,4,6
"1347","2017-03-27",7,13,10,23,27,"Yes",4,6,5,8
"1348","2017-03-27",4,6,3,9,9,"Yes",2,1,3,3
"1349","2017-03-24",1,2,4,6,6,"Yes",2,2,1,1
"1350","2017-03-24",1,5,5,10,10,"Yes",2,3,3,2
"1351","2017-03-28",6,12,10,22,22,"Yes",4,6,6,6
"1352","2017-03-28",3,11,4,15,15,"Yes",1,3,5,6
"1353","2017-03-28",4,10,7,17,17,NA,4,3,5,5
"1354","2017-03-28",5,15,7,22,22,"No",3,4,7,8
"1355","2017-03-28",1,6,3,9,9,"Yes",2,1,3,3
"1356","2017-03-28",1,3,4,7,8,"Yes",1,3,1,2
"1357","2017-03-28",8,16,13,29,29,"Yes",6,7,8,8
"1358","2017-03-28",4,7,9,16,16,"Yes",7,2,3,4
"1359","2017-03-28",2,4,5,9,9,"No",3,2,3,1
"1360","2017-03-27",3,7,5,12,13,"Yes",3,2,4,3
"1361","2017-03-28",2,9,3,12,10,"Yes",3,0,6,3
"1362","2017-03-24",5,13,8,21,21,"Yes",3,5,5,8
"1363","2017-03-28",6,6,7,13,14,"Yes",3,4,3,3
"1364","2017-03-28",5,16,9,25,25,"Yes",5,4,6,10
"1365","2017-03-28",5,11,2,13,13,"Yes",1,1,6,5
"1366","2017-03-28",4,10,3,13,14,"Yes",1,2,5,5
"1367","2017-03-28",6,12,13,25,25,"No",4,9,6,6
"1368","2017-03-28",6,10,13,23,23,"No",5,8,5,5
"1369","2017-03-28",1,5,2,7,7,"Yes",1,1,2,3
"1370","2017-03-28",3,9,0,9,9,"Yes",0,0,3,6
"1371","2017-03-28",5,10,14,24,24,"Yes",6,8,6,4
"1372","2017-03-28",1,3,5,8,8,"Yes",4,1,1,2
"1373","2017-03-28",6,12,23,35,35,"No",10,13,6,6
"1374","2017-03-28",8,14,8,22,25,"No",5,3,8,6
"1375","2017-03-28",14,27,12,39,49,"Yes",6,6,14,13
"1376","2017-03-28",5,16,0,16,16,"Yes",0,0,8,8
"1377","2017-03-28",1,5,8,13,15,"Yes",7,1,4,1
"1378","2017-03-28",3,8,9,17,17,"Yes",4,5,4,4
"1379","2017-03-28",NA,7,9,16,NA,"No",7,2,4,3
"1380","2017-03-28",3,7,7,14,14,"Yes",5,2,4,3
"1381",NA,5,13,9,22,21,"Yes",4,5,6,7
"1382","2017-03-28",NA,6,4,10,10,"Yes",2,2,2,4
"1383","2017-03-28",8,16,12,28,28,"No",3,9,8,8
"1384","2017-03-28",7,10,5,15,15,"No",3,2,5,5
"1385","2017-03-28",3,6,2,8,8,"No",1,1,3,3
"1386","2017-03-28",3,10,2,12,12,"Yes",2,0,7,3
"1387","2017-03-28",2,6,3,9,9,"No",1,2,2,4
"1388","2017-03-28",4,10,7,17,17,"No",4,3,5,5
"1389","2017-03-28",2,6,3,9,9,"Yes",1,2,3,3
"1390","2017-03-28",3,6,6,12,17,"No",4,2,2,4
"1391","2017-03-28",3,11,6,17,17,"No",3,3,3,8
"1392","2017-03-28",5,8,7,15,15,"Yes",2,5,3,5
"1393","2017-03-28",1,7,5,12,12,"Yes",2,3,3,4
"1394","2017-03-28",2,5,3,8,8,"Yes",1,2,2,3
"1395","2017-03-28",3,6,6,12,12,"Yes",2,4,3,3
"1396","2017-03-28",1,2,1,3,3,"No",1,0,1,1
"1397","2017-03-28",9,18,38,56,56,"Yes",22,16,9,9
"1398","2017-03-28",1,2,3,5,5,"Yes",1,2,1,1
"1399","2017-03-28",5,10,6,16,24,"Yes",4,2,6,4
"1400","2017-03-28",NA,3,106,109,NA,"No",54,52,2,1
"1401","2017-03-28",4,8,8,16,16,"Yes",2,6,4,4
"1402","2017-03-28",8,16,6,22,32,"No",4,2,8,8
"1403","2017-03-28",6,10,13,23,23,"No",4,9,6,4
"1404","2017-03-28",3,9,5,14,14,"Yes",2,3,5,4
"1405","2017-03-28",5,17,16,33,33,"Yes",4,12,9,8
"1406","2017-03-28",2,5,9,14,13,"Yes",7,2,2,3
"1407","2017-03-28",4,9,10,19,19,"No",7,3,6,3
"1408","2017-04-04",5,10,7,17,17,"Yes",4,3,5,5
"1409","2017-03-28",4,8,8,16,16,"Yes",4,4,4,4
"1410","2017-03-28",4,8,6,14,14,"No",2,4,4,4
"1411","2017-03-28",9,10,4,14,24,"Yes",2,2,5,5
"1412","2017-03-28",9,21,14,35,35,"Yes",4,10,14,7
"1413","2017-03-28",3,8,3,11,11,"Yes",2,1,5,3
"1414","2017-03-28",9,20,7,27,27,"No",2,5,9,11
"1415","2017-03-28",11,19,16,35,35,NA,9,7,11,8
"1416","2017-03-28",2,4,3,7,7,"Yes",1,2,2,2
"1417","2017-03-28",3,6,3,9,9,"Yes",2,1,3,3
"1418","2017-03-28",4,8,5,13,12,"Yes",4,1,3,5
"1419",NA,4,9,9,18,18,"Yes",6,3,4,5
"1420","2017-03-28",2,3,2,5,5,"No",NA,2,2,1
"1421","2017-03-28",4,10,10,20,22,"Yes",7,3,5,5
"1422","2017-03-28",4,7,8,15,15,"No",3,5,3,4
"1423","2017-03-28",5,11,0,11,12,"Yes",0,0,6,5
"1424","2017-03-28",12,29,21,50,50,"No",10,11,20,9
"1425","2017-03-28",5,12,10,22,23,"Yes",5,5,5,7
"1426","2017-03-28",3,11,9,20,20,"Yes",3,6,7,4
"1427","2017-03-28",3,9,6,15,15,"Yes",3,3,4,5
"1428","2017-03-28",5,11,6,17,17,"No",3,3,5,6
"1429","2017-03-28",4,4,4,8,8,"Yes",1,3,2,2
"1430","2017-03-28",2,4,4,8,8,"Yes",1,3,2,2
"1431","2017-03-28",4,13,3,16,15,"Yes",1,2,2,11
"1432","2017-03-28",1,7,5,12,NA,"Yes",0,5,3,4
"1433","2017-03-28",1,2,2,4,4,"Yes",0,2,0,2
"1434","2017-03-28",NA,5,6,11,NA,"No",2,4,2,3
"1435","2017-03-28",4,10,4,14,14,"Yes",3,1,4,6
"1436","2017-03-28",3,11,13,24,25,"No",5,8,5,6
"1437","2017-03-28",2,3,0,3,3,"Yes",NA,NA,2,1
"1438","2017-03-28",6,10,7,17,17,"No",6,1,5,5
"1439","2017-03-28",7,14,8,22,22,"Yes",1,7,9,5
"1440","2017-03-28",2,4,3,7,6,"No",1,2,2,2
"1441","2017-03-28",4,17,10,27,27,"Yes",5,5,11,6
"1442","2017-03-28",1,9,3,12,13,"Yes",1,2,4,5
"1443","2017-03-28",1,2,2,4,4,"Yes",1,1,1,1
"1444","2017-03-28",3,5,6,11,11,"Yes",4,2,3,2
"1445","2017-03-28",6,13,7,20,27,"Yes",3,4,9,4
"1446","2017-03-28",1,2,2,4,4,"No",1,1,1,1
"1447","2017-03-28",3,6,4,10,10,"No",3,1,3,3
"1448","2017-03-28",6,15,2,17,17,"No",1,1,8,7
"1449","2017-03-28",1,5,0,5,5,"Yes",0,0,3,2
"1450","2017-03-28",4,6,5,11,11,"No",0,5,2,4
"1451","2017-03-28",3,5,2,7,7,"Yes",1,1,2,3
"1452","2017-03-28",5,10,20,30,30,"Yes",8,12,5,5
"1453","2017-03-28",1,2,5,7,7,"Yes",4,1,1,1
"1454","2017-03-28",2,2,1,3,3,"No",1,0,2,0
"1455","2017-03-28",5,12,4,16,14,"No",1,3,4,8
"1456","2017-03-28",3,5,5,10,10,"Yes",2,3,3,2
"1457","2017-03-28",5,12,10,22,22,"Yes",7,3,7,5
"1458","2017-03-28",4,7,3,10,10,"Yes",1,2,3,4
"1459","2017-03-28",1,2,1,3,3,"Yes",1,0,1,1
"1460","2017-03-28",1,4,2,6,6,"Yes",1,1,2,2
"1461","2017-03-28",4,13,8,21,21,"Yes",3,5,5,8
"1462","2017-03-28",3,6,5,11,11,"Yes",2,3,3,3
"1463","2017-03-28",5,10,8,18,18,"No",2,6,5,5
"1464","2017-03-28",2,6,7,13,13,"Yes",2,5,1,5
"1465","2017-03-28",NA,8,410,418,NA,"No",180,230,3,5
"1466","2017-03-28",1,2,7,9,9,"Yes",3,4,1,1
"1467","2017-03-28",2,4,4,8,8,"Yes",2,2,2,2
"1468","2017-03-28",4,7,10,17,18,"Yes",8,2,2,5
"1469","2017-03-28",2,5,3,8,8,"No",0,3,2,3
"1470","2017-03-28",6,12,6,18,24,"Yes",4,2,6,6
"1471","2017-03-28",1,9,0,9,9,"Yes",0,0,2,7
"1472","2017-03-28",2,4,3,7,7,"Yes",2,1,2,2
"1473","2017-03-28",6,11,13,24,24,"No",6,7,6,5
"1474","2017-03-28",3,10,2,12,17,"No",0,2,7,3
"1475","2017-03-28",1,6,6,12,12,"Yes",2,4,4,2
"1476","2017-03-28",6,9,11,20,20,"Yes",5,6,4,5
"1477","2017-03-28",1,4,3,7,7,"Yes",2,1,1,3
"1478","2017-03-28",4,9,10,19,19,"Yes",6,4,4,5
"1479","2017-03-28",2,7,3,10,11,"Yes",2,1,4,3
"1480","2017-03-28",4,5,4,9,9,"No",0,4,4,1
"1481","2017-03-28",2,4,6,10,10,"No",2,4,2,2
"1482","2017-03-28",4,10,8,18,18,"No",5,3,4,6
"1483","2017-03-28",6,9,2,11,11,"Yes",1,1,5,4
"1484","2017-03-28",8,10,15,25,25,"No",10,5,4,6
"1485","2017-03-28",2,4,5,9,9,"No",2,3,2,2
"1486","2017-03-28",3,11,9,20,18,"Yes",2,7,5,6
"1487","2017-03-28",3,8,9,17,17,"Yes",4,5,4,4
"1488","2017-03-28",6,10,14,24,24,"No",6,8,5,5
"1489","2017-03-28",7,14,0,14,14,"No",0,0,7,7
"1490","2017-03-28",5,10,8,18,18,"No",3,5,6,4
"1491","2017-03-28",4,9,6,15,15,"Yes",2,4,4,5
"1492","2017-03-28",7,14,12,26,26,"Yes",10,2,4,10
"1493","2017-03-28",7,11,7,18,18,"Yes",3,4,4,7
"1494","2017-03-28",1,7,6,13,13,"Yes",4,2,4,3
"1495","2017-03-28",2,4,2,6,6,"Yes",2,0,2,2
"1496","2017-03-28",3,6,9,15,20,"Yes",5,4,3,3
"1497","2017-03-28",2,5,5,10,10,"Yes",4,1,2,3
"1498","2017-03-28",1,5,3,8,8,"Yes",0,3,1,4
"1499","2017-03-28",2,6,8,14,12,"No",2,6,4,2
"1500","2017-03-28",3,6,6,12,11,"Yes",1,5,4,2
"1501","2017-03-28",4,2,3,5,5,"No",1,2,1,1
"1502","2017-03-28",2,11,4,15,15,"Yes",2,2,5,6
"1503","2017-03-28",8,14,17,31,31,"Yes",11,6,8,6
"1504","2017-03-28",3,5,5,10,10,"No",1,4,2,3
"1505","2017-03-28",2,5,4,9,9,"Yes",2,2,3,2
"1506","2017-03-28",4,6,7,13,13,"Yes",2,5,3,3
"1507","2017-03-28",4,9,3,12,12,"Yes",2,1,5,4
"1508","2017-03-28",2,5,2,7,7,"Yes",0,2,3,2
"1509","2017-03-28",4,9,0,9,9,"Yes",NA,NA,5,4
"1510","2017-03-28",9,23,20,43,43,"No",11,9,11,12
"1511","2017-03-28",4,10,6,16,16,"No",1,5,4,6
"1512","2017-03-28",8,10,5,15,15,"No",2,3,5,5
"1513","2017-03-28",3,0,0,0,8,"Yes",NA,NA,NA,NA
"1514","2017-03-28",3,8,2,10,10,"No",0,2,3,5
"1515","2017-03-28",5,10,5,15,15,"Yes",2,3,6,4
"1516","2017-03-28",4,11,4,15,15,"Yes",0,4,5,6
"1517","2017-03-28",1,6,2,8,6,"No",0,2,4,2
"1518","2017-03-28",3,6,3,9,9,"Yes",NA,3,3,3
"1519","2017-03-28",1,5,3,8,7,"Yes",3,0,2,3
"1520","2017-03-28",7,18,11,29,29,"Yes",5,6,8,10
"1521","2017-03-28",1,3,2,5,5,"Yes",2,0,1,2
"1522","2017-03-28",2,5,5,10,10,"No",3,2,3,2
"1523","2017-03-28",NA,9,0,9,NA,"No",0,0,4,5
"1524","2017-03-28",4,8,12,20,20,"No",7,5,4,4
"1525","2017-03-28",4,8,6,14,14,"No",2,4,4,4
"1526","2017-03-28",5,9,7,16,20,"Yes",2,5,2,7
"1527","2017-03-28",1,5,4,9,9,"Yes",1,3,2,3
"1528","2017-03-28",3,9,7,16,12,"Yes",2,5,3,6
"1529","2017-03-28",5,13,13,26,26,"Yes",5,8,7,6
"1530","2017-03-28",1,3,1,4,4,"Yes",1,NA,1,2
"1531","2017-03-28",4,8,4,12,12,"Yes",2,2,4,4
"1532","2017-03-28",3,11,3,14,15,"Yes",2,1,4,7
"1533","2017-03-28",3,13,7,20,20,"Yes",5,2,7,6
"1534","2017-03-28",5,8,6,14,14,"Yes",4,2,4,4
"1535","2017-03-28",5,10,10,20,20,"Yes",3,7,5,5
"1536","2017-03-28",1,4,3,7,7,"No",1,2,3,1
"1537","2017-03-28",2,8,2,10,10,"Yes",1,1,3,5
"1538","2017-03-28",4,7,1,8,8,"Yes",1,NA,3,4
"1539","2017-03-28",2,6,4,10,9,"Yes",1,3,2,4
"1540","2017-03-28",3,7,7,14,14,"Yes",2,5,3,4
"1541","2017-03-28",NA,35,3,38,NA,"Yes",2,1,25,10
"1542","2017-03-28",1,4,4,8,8,NA,1,3,2,2
"1543","2017-03-28",5,8,1,9,9,"Yes",0,1,6,2
"1544","2017-03-28",6,13,12,25,25,"Yes",6,6,7,6
"1545","2017-03-28",4,9,4,13,13,"Yes",3,1,3,6
"1546","2017-03-28",3,10,7,17,17,"Yes",2,5,4,6
"1547","2017-03-28",6,18,8,26,25,"No",3,5,8,10
"1548","2017-03-28",7,14,31,45,37,NA,13,18,7,7
"1549","2017-03-28",2,6,8,14,14,"No",5,3,3,3
"1550","2017-03-28",3,11,5,16,16,"No",3,2,5,6
"1551","2017-03-28",1,7,3,10,10,"Yes",1,2,4,3
"1552","2017-03-28",3,6,1,7,7,"Yes",0,1,3,3
"1553","2017-03-28",1,5,3,8,8,"No",1,2,1,4
"1554","2017-03-28",2,5,3,8,8,"Yes",1,2,3,2
"1555","2017-03-28",2,3,5,8,8,"Yes",4,1,2,1
"1556","2017-03-27",1,6,6,12,12,"No",3,3,2,4
"1557","2017-03-28",18,13,7,20,20,"Yes",4,3,10,3
"1558","2017-03-28",3,8,5,13,13,"Yes",2,3,5,3
"1559","2017-03-28",3,5,9,14,14,"Yes",6,3,2,3
"1560","2017-03-28",6,8,12,20,NA,"No",4,8,4,4
"1561","2017-03-28",2,4,5,9,9,"Yes",3,2,2,2
"1562","2017-03-28",3,10,6,16,16,"Yes",2,4,4,6
"1563","2017-03-28",3,3,0,3,3,"Yes",0,0,2,1
"1564","2017-03-28",7,21,15,36,38,"Yes",6,9,11,10
"1565","2017-03-28",4,8,8,16,16,"No",2,6,4,4
"1566","2017-03-28",7,11,19,30,30,"Yes",13,6,7,4
"1567","2017-03-28",4,12,6,18,19,"Yes",2,4,4,8
"1568","2017-03-28",1,4,5,9,8,"No",1,4,2,2
"1569","2017-03-28",2,4,6,10,10,"No",5,1,2,2
"1570","2017-03-28",6,9,16,25,25,"Yes",10,6,5,4
"1571","2017-03-28",3,8,8,16,16,"Yes",2,6,5,3
"1572","2017-03-28",6,17,7,24,24,"No",5,2,10,7
"1573","2017-03-28",NA,4,96,100,NA,"No",56,40,2,2
"1574","2017-03-28",1,7,2,9,9,"Yes",1,1,5,2
"1575","2017-03-28",1,5,1,6,6,"Yes",1,0,2,3
"1576","2017-03-28",1,2,9,11,12,"Yes",5,4,1,1
"1577","2017-03-28",1,7,2,9,9,"Yes",1,1,2,5
"1578","2017-03-28",1,4,4,8,8,"Yes",4,0,2,2
"1579","2017-03-28",1,2,8,10,10,"Yes",4,4,1,1
"1580","2017-03-28",2,6,3,9,7,"Yes",0,3,2,4
"1581","2017-03-28",4,8,9,17,17,"No",2,7,4,4
"1582","2017-03-28",2,5,4,9,9,"Yes",2,2,2,3
"1583","2017-03-28",2,4,6,10,10,"Yes",3,3,2,2
"1584","2017-03-28",1,5,8,13,13,"Yes",6,2,1,4
"1585","2017-04-08",10,21,8,29,29,"No",5,3,10,11
"1586","2017-03-28",11,20,16,36,36,"Yes",4,12,11,9
"1587","2017-03-28",1,6,2,8,8,"No",2,0,3,3
"1588","2017-03-28",4,10,10,20,20,"Yes",4,6,6,4
"1589","2017-03-28",4,9,9,18,18,"Yes",4,5,4,5
"1590","2017-03-28",1,3,5,8,7,"Yes",2,3,2,1
"1591","2017-03-28",1,2,3,5,5,"Yes",2,1,1,1
"1592","2017-03-28",1,2,1,3,4,"Yes",NA,1,1,1
"1593","2017-03-28",2,4,10,14,14,"Yes",6,4,2,2
"1594","2017-03-28",6,12,11,23,23,"Yes",3,8,6,6
"1595","2017-03-28",4,8,3,11,11,"Yes",3,0,4,4
"1596","2017-03-28",6,10,11,21,21,"Yes",6,5,4,6
"1597","2017-03-28",2,8,7,15,17,"Yes",5,2,3,5
"1598","2017-03-28",2,4,4,8,8,"Yes",1,3,2,2
"1599","2017-03-28",2,2,6,8,8,"Yes",3,3,1,1
"1600","2017-03-28",3,6,9,15,12,"Yes",8,1,4,2
"1601","2017-03-28",4,13,7,20,20,"Yes",5,2,7,6
"1602","2017-04-04",4,11,9,20,21,"No",3,6,5,6
"1603","2017-03-28",11,19,14,33,33,"Yes",8,6,9,10
"1604","2017-03-28",1,6,6,12,12,"No",2,4,3,3
"1605","2017-03-28",7,19,12,31,31,"Yes",5,7,10,9
"1606","2017-03-28",3,3,10,13,13,"Yes",4,6,1,2
"1607","2017-03-28",2,4,4,8,12,"Yes",4,NA,2,2
"1608","2017-03-28",4,9,8,17,17,"Yes",3,5,5,4
"1609","2017-03-28",2,5,3,8,8,"Yes",3,0,4,1
"1610","2017-03-28",3,4,7,11,11,NA,6,1,2,2
"1611","2017-03-28",4,8,15,23,23,"No",8,7,4,4
"1612","2017-03-28",1,1,3,4,9,"No",0,3,0,1
"1613","2017-03-28",6,16,10,26,24,"Yes",6,4,5,11
"1614","2017-03-28",1,6,4,10,10,"Yes",1,3,2,4
"1615","2017-03-28",4,10,11,21,22,NA,5,6,6,4
"1616","2017-03-28",1,2,5,7,7,"Yes",3,2,1,1
"1617","2017-03-28",4,16,14,30,30,"No",6,8,7,9
"1618","2017-03-28",1,3,2,5,5,"Yes",1,1,1,2
"1619","2017-03-28",1,4,2,6,6,"Yes",1,1,1,3
"1620","2017-03-28",2,3,3,6,6,"Yes",1,2,NA,3
"1621","2017-03-28",NA,6,8,14,NA,"No",5,3,3,3
"1622","2017-03-28",6,15,5,20,20,"No",3,2,7,8
"1623","2017-03-28",4,7,6,13,14,"Yes",4,2,2,5
"1624","2017-03-28",12,19,15,34,35,"No",8,7,7,12
"1625","2017-03-28",NA,6,20,26,NA,"No",10,10,2,4
"1626","2017-03-28",4,10,1,11,11,"Yes",1,0,3,7
"1627","2017-03-28",9,26,14,40,47,"No",6,8,14,12
"1628","2017-03-28",6,13,8,21,22,"Yes",5,3,6,7
"1629","2017-03-28",11,7,6,13,14,"Yes",3,3,2,5
"1630","2017-03-28",11,16,23,39,41,"No",10,13,5,11
"1631","2017-03-28",4,11,3,14,15,"No",2,1,3,8
"1632","2017-03-28",1,2,6,8,8,"Yes",2,4,1,1
"1633","2017-03-28",11,16,12,28,35,"No",4,8,7,9
"1634","2017-03-28",5,9,9,18,18,"No",4,5,3,6
"1635","2017-03-28",3,6,2,8,8,"No",2,0,3,3
"1636","2017-03-28",3,9,5,14,14,"No",3,2,5,4
"1637","2017-03-28",5,7,12,19,16,"Yes",6,6,4,3
"1638","2017-03-28",1,3,3,6,6,"Yes",1,2,2,1
"1639","2017-03-28",4,8,15,23,25,"No",8,7,4,4
"1640","2017-03-28",3,5,4,9,2,"Yes",1,3,2,3
"1641","2017-03-28",6,29,14,43,40,"No",8,6,11,18
"1642","2017-03-28",5,5,4,9,15,"No",1,3,3,2
"1643","2017-03-28",1,4,1,5,6,"Yes",0,1,3,1
"1644","2017-03-28",3,7,7,14,14,"Yes",3,4,4,3
"1645","2017-03-28",2,5,8,13,12,"Yes",2,6,3,2
"1646","2017-03-28",5,13,7,20,21,"No",4,3,6,7
"1647","2017-03-28",2,8,1,9,9,"Yes",0,1,3,5
"1648","2017-03-28",3,5,9,14,14,"No",2,7,2,3
"1649","2017-03-28",3,6,0,6,6,"No",0,0,3,3
"1650","2017-03-28",1,3,5,8,8,"No",3,2,2,1
"1651","2017-03-28",5,12,9,21,21,"Yes",3,6,8,4
"1652","2017-03-28",3,6,6,12,12,"No",2,4,3,3
"1653","2017-03-28",4,8,7,15,15,"Yes",4,3,4,4
"1654","2017-03-28",3,7,5,12,12,"No",2,3,4,3
"1655","2017-03-28",7,18,11,29,29,"Yes",7,4,11,7
"1656","2017-03-28",3,6,3,9,9,"Yes",1,2,3,3
"1657","2017-03-28",5,6,4,10,10,"Yes",1,3,2,4
"1658","2017-03-28",2,5,6,11,11,"Yes",3,3,4,1
"1659","2017-03-28",2,4,5,9,9,"Yes",1,4,2,2
"1660","2017-03-28",2,4,3,7,7,"Yes",1,2,2,2
"1661","2017-03-28",5,10,16,26,26,"No",6,10,5,5
"1662","2017-04-04",3,7,0,7,10,"Yes",0,0,5,2
"1663","2017-03-28",3,3,7,10,10,"Yes",3,4,1,2
"1664","2017-03-28",3,9,9,18,15,"Yes",4,5,3,6
"1665","2017-03-28",5,7,6,13,13,"Yes",2,4,5,2
"1666","2017-03-28",1,4,3,7,7,"Yes",2,1,1,3
"1667","2017-03-28",3,4,2,6,7,"Yes",1,1,2,2
"1668","2017-03-28",6,14,10,24,NA,"Yes",5,5,7,7
"1669","2017-03-28",2,6,3,9,9,"Yes",NA,3,4,2
"1670","2017-03-28",5,4,9,13,13,"Yes",4,5,2,2
"1671","2017-03-28",3,3,0,3,4,"Yes",0,0,1,2
"1672","2017-03-28",1,2,3,5,5,"Yes",1,2,1,1
"1673","2017-03-28",2,5,6,11,14,"Yes",1,5,1,4
"1674","2017-03-28",2,9,6,15,15,"No",3,3,5,4
"1675","2017-03-28",5,10,9,19,NA,"Yes",5,4,5,5
"1676","2017-03-28",3,5,5,10,11,"Yes",3,2,2,3
"1677","2017-03-28",7,10,2,12,12,"No",0,2,5,5
"1678","2017-03-28",2,8,7,15,15,"Yes",1,6,4,4
"1679","2017-03-28",2,5,8,13,13,"Yes",3,5,2,3
"1680","2017-03-28",1,5,4,9,6,"Yes",3,1,3,2
"1681","2017-03-28",3,6,3,9,16,"Yes",2,1,3,3
"1682","2017-03-28",7,14,7,21,21,"No",3,4,7,7
"1683","2017-03-28",5,15,12,27,27,"No",7,5,5,10
"1684","2017-03-28",5,10,7,17,17,"No",4,3,5,5
"1685","2017-03-29",0,0,0,0,0,NA,0,0,0,0
"1686","2017-03-29",3,9,7,16,17,NA,4,3,4,5
"1687","2017-03-29",NA,22,6,28,NA,NA,3,3,18,4
"1688","2017-03-29",6,9,6,15,15,"No",4,2,4,5
"1689","2017-03-29",2,2,6,8,8,"No",3,3,1,1
"1690","2017-03-29",5,14,2,16,16,"Yes",1,1,6,8
"1691","2017-03-29",2,4,5,9,9,"Yes",2,3,2,2
"1692","2017-03-29",NA,9,13,22,NA,"No",8,5,4,5
"1693","2017-03-29",5,10,2,12,12,"Yes",0,2,5,5
"1694","2017-03-29",3,10,5,15,15,"No",3,2,4,6
"1695","2017-03-27",1,2,2,4,4,"No",1,1,1,1
"1696","2017-03-29",3,5,2,7,6,"No",2,0,3,2
"1697","2017-03-29",1,24,0,24,4,"Yes",0,0,20,4
"1698","2017-03-29",3,8,4,12,12,"Yes",1,3,3,5
"1699","2017-03-29",1,4,3,7,7,"Yes",2,1,3,1
"1700","2017-03-29",3,9,5,14,18,"No",2,3,4,5
"1701","2017-03-29",1,2,9,11,11,"No",8,1,1,1
"1702","2017-03-29",7,13,2,15,15,"Yes",1,1,6,7
"1703","2017-03-29",4,2,10,12,12,"Yes",2,8,1,1
"1704","2017-03-29",2,7,3,10,5,"Yes",1,2,3,4
"1705","2017-03-29",8,16,9,25,25,"No",4,5,8,8
"1706","2017-03-29",1,4,1,5,8,"Yes",0,1,1,3
"1707","2017-04-05",9,14,6,20,20,"Yes",3,3,7,7
"1708","2017-03-29",4,8,3,11,11,"Yes",2,1,5,3
"1709","2017-03-29",4,8,3,11,11,"Yes",2,1,3,5
"1710","2017-03-29",1,4,2,6,6,"No",1,1,1,3
"1711","2017-03-29",2,5,4,9,8,"Yes",0,4,1,4
"1712","2017-03-29",5,20,10,30,30,"Yes",6,4,15,5
"1713","2017-03-29",4,7,12,19,19,"Yes",5,7,4,3
"1714","2017-03-29",6,10,4,14,14,"Yes",2,2,5,5
"1715","2017-03-29",5,25,16,41,38,NA,6,10,10,15
"1716","2017-03-29",2,4,7,11,11,"Yes",3,4,2,2
"1717","2017-03-29",1,9,5,14,18,"Yes",2,3,5,4
"1718","2017-03-29",1,2,5,7,7,"Yes",2,3,1,1
"1719","2017-03-29",4,6,9,15,15,"No",4,5,2,4
"1720","2017-03-29",2,4,38,42,11,"Yes",18,20,2,2
"1721","2017-03-29",1,0,0,0,7,NA,NA,NA,NA,NA
"1722","2017-03-29",5,10,10,20,20,"Yes",3,7,4,6
"1723","2017-03-29",4,8,5,13,15,"No",2,3,3,5
"1724","2017-03-29",7,14,8,22,25,"Yes",5,3,7,7
"1725","2017-03-29",3,6,6,12,12,"Yes",1,5,3,3
"1726","2017-03-29",6,10,10,20,17,"Yes",3,7,3,7
"1727","2017-03-29",1,3,7,10,10,"Yes",3,4,2,1
"1728","2017-03-29",5,10,4,14,13,"Yes",3,1,5,5
"1729","2017-03-29",2,4,12,16,18,"Yes",6,6,2,2
"1730","2017-03-29",4,10,8,18,25,"Yes",3,5,4,6
"1731","2017-03-29",6,9,6,15,15,"Yes",5,1,4,5
"1732","2017-03-29",2,4,5,9,10,"Yes",2,3,2,2
"1733","2017-03-29",6,15,10,25,25,"Yes",6,4,5,10
"1734","2017-03-29",4,8,7,15,15,"No",2,5,4,4
"1735","2017-03-29",5,10,4,14,14,"Yes",3,1,5,5
"1736","2017-03-29",4,10,2,12,12,"Yes",1,1,4,6
"1737","2017-03-29",4,10,4,14,15,"No",1,3,4,6
"1738","2017-03-29",5,9,12,21,21,"No",7,5,4,5
"1739","2017-04-05",NA,18,10,28,NA,"No",4,6,10,8
"1740","2017-03-29",1,4,4,8,8,"No",3,1,2,2
"1741","2017-03-27",9,20,13,33,36,"No",5,8,8,12
"1742","2017-03-29",7,15,7,22,21,"No",3,4,11,4
"1743","2017-03-29",4,7,7,14,14,"Yes",3,4,4,3
"1744","2017-03-29",8,8,4,12,12,"Yes",1,3,7,1
"1745","2017-03-29",2,2,5,7,7,"Yes",2,3,1,1
"1746","2017-03-29",2,4,3,7,7,"Yes",2,1,3,1
"1747","2017-03-29",7,19,18,37,38,"No",10,8,9,10
"1748","2017-03-29",3,8,4,12,12,"No",1,3,3,5
"1749","2017-03-29",3,4,2,6,6,"Yes",2,0,1,3
"1750","2017-03-29",3,7,7,14,14,"Yes",2,5,3,4
"1751","2017-03-29",5,10,3,13,13,"Yes",2,1,6,4
"1752","2017-03-29",4,0,0,0,13,"Yes",0,0,0,0
"1753","2017-03-29",1,7,5,12,12,"No",3,2,3,4
"1754","2017-03-29",2,5,4,9,10,"No",3,1,4,1
"1755","2017-03-29",3,7,2,9,9,"Yes",1,1,5,2
"1756","2017-03-29",3,5,1,6,8,"No",0,1,2,3
"1757","2017-03-29",3,7,4,11,11,"Yes",3,1,5,2
"1758","2017-03-29",2,4,3,7,7,"Yes",2,1,2,2
"1759","2017-03-29",1,2,6,8,8,"Yes",3,3,1,1
"1760","2017-03-29",1,2,5,7,7,"No",2,3,1,1
"1761","2017-03-29",2,5,3,8,8,"No",2,1,2,3
"1762","2017-03-29",4,8,2,10,10,"No",0,2,4,4
"1763","2017-03-29",1,2,6,8,8,"No",3,3,1,1
"1764","2017-03-29",3,8,2,10,11,"Yes",2,0,3,5
"1765","2017-03-29",5,3,8,11,11,"Yes",3,5,2,1
"1766","2017-03-29",4,8,4,12,12,"Yes",2,2,4,4
"1767","2017-03-29",5,21,3,24,24,"No",1,2,9,12
"1768","2017-03-29",1,2,4,6,6,"Yes",1,3,1,1
"1769","2017-03-29",4,11,6,17,17,"Yes",3,3,4,7
"1770","2017-03-29",1,2,5,7,8,"Yes",3,2,1,1
"1771","2017-03-29",1,2,0,2,2,"No",NA,NA,1,1
"1772","2017-03-29",4,6,2,8,8,"Yes",1,1,4,2
"1773","2017-03-29",3,6,7,13,13,"Yes",3,4,4,2
"1774","2017-03-29",NA,2,3,5,5,"Yes",0,3,1,1
"1775","2017-03-29",2,4,5,9,9,"Yes",3,2,1,3
"1776","2017-03-29",2,5,3,8,6,"No",2,1,3,2
"1777","2017-03-29",7,14,5,19,16,"No",2,3,7,7
"1778","2017-03-29",5,16,6,22,25,"Yes",4,2,8,8
"1779",NA,3,5,4,9,9,"Yes",0,4,2,3
"1780","2017-03-29",2,8,3,11,11,"Yes",2,1,2,6
"1781","2017-03-29",3,6,8,14,14,"No",3,5,4,2
"1782","2017-03-29",6,14,15,29,29,"No",6,9,6,8
"1783","2017-03-29",4,8,3,11,11,"Yes",1,2,4,4
"1784","2017-03-29",2,4,8,12,12,"Yes",6,2,2,2
"1785","2017-03-29",1,2,7,9,9,"Yes",4,3,1,1
"1786","2017-03-29",4,11,20,31,31,"Yes",13,7,5,6
"1787","2017-03-29",2,4,9,13,13,"Yes",5,4,1,3
"1788","2017-04-05",3,5,4,9,9,"Yes",1,3,2,3
"1789","2017-03-29",3,5,3,8,8,"Yes",0,3,2,3
"1790","2017-03-29",3,7,4,11,11,"No",3,1,4,3
"1791","2017-03-29",NA,4,45,49,NA,"No",25,20,3,1
"1792","2017-03-29",11,22,13,35,35,"No",5,8,11,11
"1793","2017-03-29",8,17,7,24,24,"No",5,2,8,9
"1794","2017-03-29",1,2,5,7,7,"Yes",4,1,1,1
"1795","2017-03-29",3,4,4,8,8,"Yes",3,1,2,2
"1796","2017-03-29",3,7,6,13,14,"No",5,1,3,4
"1797","2017-03-29",4,9,8,17,13,"Yes",3,5,5,4
"1798","2017-03-29",5,8,5,13,13,"No",2,3,5,3
"1799","2017-03-29",NA,180,0,180,NA,"No",0,0,150,30
"1800","2017-03-29",1,3,4,7,11,"Yes",4,NA,1,2
"1801","2017-03-29",4,11,2,13,16,"Yes",2,0,5,6
"1802","2017-03-29",2,5,7,12,12,"No",4,3,3,2
"1803","2017-03-29",1,2,2,4,4,"Yes",0,2,0,2
"1804","2017-03-29",2,2,5,7,7,"No",2,3,1,1
"1805","2017-03-29",3,6,8,14,14,"Yes",5,3,3,3
"1806","2017-03-29",5,10,8,18,22,"Yes",2,6,5,5
"1807","2017-03-29",1,3,1,4,4,"Yes",1,0,1,2
"1808","2017-03-29",1,2,3,5,5,"No",2,1,1,1
"1809","2017-03-29",1,7,1,8,8,"Yes",0,1,1,6
"1810","2017-03-29",7,10,12,22,22,"No",4,8,4,6
"1811","2017-03-29",3,7,5,12,13,"No",3,2,4,3
"1812","2017-03-29",4,9,11,20,20,"No",6,5,4,5
"1813","2017-03-29",3,6,5,11,12,"Yes",2,3,3,3
"1814","2017-03-29",2,3,3,6,6,"Yes",2,1,2,1
"1815","2017-03-29",3,6,12,18,18,"Yes",3,9,3,3
"1816","2017-03-29",7,0,0,0,NA,"Yes",NA,NA,NA,NA
"1817","2017-03-29",4,6,5,11,NA,"Yes",3,2,1,5
"1818","2017-03-29",10,17,4,21,21,"Yes",1,3,9,8
"1819","2017-03-29",4,13,4,17,17,"No",1,3,7,6
"1820","2017-03-29",8,18,5,23,17,"Yes",3,2,8,10
"1821","2017-03-29",2,4,7,11,10,"No",4,3,2,2
"1822","2017-03-29",4,5,5,10,11,"Yes",2,3,2,3
"1823","2017-03-29",3,4,3,7,7,"Yes",2,1,2,2
"1824","2017-03-29",4,10,4,14,14,"Yes",3,1,5,5
"1825","2017-03-29",4,10,5,15,15,"Yes",1,4,6,4
"1826","2017-03-29",2,5,4,9,9,"Yes",2,2,2,3
"1827","2017-03-29",7,21,16,37,37,"No",6,10,8,13
"1828","2017-03-29",1,2,2,4,4,"Yes",1,1,1,1
"1829","2017-03-29",1,2,4,6,6,"No",4,NA,1,1
"1830","2017-03-29",5,10,10,20,20,"Yes",5,5,6,4
"1831","2017-03-29",2,4,0,4,4,"Yes",0,0,3,1
"1832","2017-03-29",6,10,6,16,16,"No",3,3,3,7
"1833","2017-03-29",5,12,9,21,20,"No",3,6,5,7
"1834","2017-03-29",1,1,0,1,1,"Yes",0,0,1,0
"1835","2017-03-29",4,0,0,0,NA,"Yes",NA,NA,NA,NA
"1836","2017-03-29",5,10,0,10,10,"No",NA,NA,6,4
"1837","2017-03-29",4,8,16,24,24,"Yes",9,7,4,4
"1838","2017-03-30",5,14,12,26,28,"No",7,5,8,6
"1839","2017-03-29",3,6,2,8,10,"No",1,1,3,3
"1840","2017-03-29",5,4,10,14,14,"Yes",4,6,2,2
"1841","2017-03-29",2,6,1,7,7,"No",1,0,3,3
"1842",NA,2,3,3,6,6,"No",2,1,2,1
"1843","2017-03-29",3,5,1,6,10,"Yes",0,1,2,3
"1844","2017-03-29",4,8,7,15,15,"Yes",1,6,4,4
"1845","2017-03-29",5,6,4,10,10,"Yes",2,2,3,3
"1846","2017-03-29",1,3,2,5,5,"No",1,1,2,1
"1847","2017-03-29",11,25,16,41,54,"Yes",7,9,10,15
"1848","2017-03-29",1,7,0,7,7,"No",NA,NA,4,3
"1849","2017-03-29",4,8,10,18,18,"Yes",4,6,4,4
"1850","2017-03-29",12,28,17,45,44,"No",9,8,11,17
"1851","2017-03-29",3,5,1,6,NA,"Yes",0,1,3,2
"1852","2017-03-29",3,6,10,16,16,"Yes",5,5,3,3
"1853","2017-03-29",5,0,0,0,42,"No",NA,NA,NA,NA
"1854","2017-03-29",3,6,8,14,12,"Yes",5,3,3,3
"1855","2017-03-29",1,4,4,8,8,"Yes",2,2,1,3
"1856","2017-03-29",4,8,5,13,13,"No",2,3,4,4
"1857","2017-03-29",3,6,5,11,11,"Yes",1,4,3,3
"1858","2017-04-05",3,5,5,10,10,"Yes",1,4,3,2
"1859","2017-03-29",4,7,2,9,7,"Yes",2,0,5,2
"1860","2017-03-29",1,4,5,9,9,"No",2,3,3,1
"1861","2017-03-29",4,4,6,10,10,"Yes",1,5,2,2
"1862","2017-03-29",4,7,9,16,16,"Yes",5,4,4,3
"1863","2017-03-29",4,10,10,20,20,"No",4,6,6,4
"1864","2017-03-29",NA,28,12,40,NA,"Yes",3,9,10,18
"1865","2017-03-29",5,13,12,25,26,"Yes",5,7,5,8
"1866","2017-03-29",7,5,10,15,15,"No",4,6,3,2
"1867","2017-03-29",5,10,5,15,15,"Yes",4,1,5,5
"1868","2017-03-29",2,4,3,7,7,"No",2,1,2,2
"1869","2017-03-29",1,3,2,5,5,"No",NA,2,1,2
"1870","2017-03-29",3,10,10,20,20,"Yes",5,5,4,6
"1871","2017-03-29",4,9,8,17,22,"Yes",4,4,4,5
"1872","2017-03-29",12,21,17,38,38,"Yes",8,9,12,9
"1873","2017-03-29",3,9,10,19,19,"No",6,4,3,6
"1874","2017-03-29",4,10,3,13,3,"Yes",1,2,3,7
"1875","2017-03-29",3,11,8,19,24,"Yes",6,2,7,4
"1876","2017-03-29",4,8,12,20,20,"Yes",7,5,4,4
"1877","2017-03-29",5,13,9,22,23,"No",5,4,5,8
"1878","2017-03-29",5,15,11,26,26,"No",6,5,7,8
"1879","2017-03-29",11,35,25,60,60,"Yes",10,15,15,20
"1880","2017-03-29",10,16,84,100,30,NA,84,NA,7,9
"1881","2017-03-29",5,10,5,15,15,"Yes",2,3,4,6
"1882","2017-03-29",7,12,8,20,19,"No",5,3,5,7
"1883","2017-03-29",3,9,5,14,14,"Yes",1,4,4,5
"1884","2017-03-29",8,16,6,22,30,"Yes",3,3,8,8
"1885","2017-03-29",1,4,4,8,7,"No",1,3,2,2
"1886","2017-03-29",3,9,6,15,16,"Yes",4,2,6,3
"1887","2017-03-29",4,12,6,18,18,"No",3,3,6,6
"1888","2017-03-29",2,2,8,10,10,"Yes",6,2,1,1
"1889","2017-03-29",4,7,8,15,15,"Yes",5,3,4,3
"1890","2017-03-29",2,6,3,9,8,"Yes",2,1,3,3
"1891","2017-03-29",3,13,8,21,21,"No",5,3,6,7
"1892","2017-03-29",1,1,0,1,1,"Yes",NA,NA,NA,1
"1893","2017-03-29",7,20,15,35,35,"Yes",10,5,10,10
"1894","2017-03-29",6,12,14,26,26,"No",6,8,6,6
"1895","2017-03-29",6,12,6,18,17,"No",2,4,6,6
"1896","2017-03-29",2,5,2,7,6,"Yes",1,1,3,2
"1897","2017-03-29",3,7,4,11,11,"Yes",2,2,4,3
"1898","2017-03-29",1,4,0,4,4,"Yes",NA,NA,2,2
"1899","2017-03-29",3,7,3,10,11,"Yes",2,1,3,4
"1900","2017-03-29",6,13,8,21,21,"Yes",3,5,7,6
"1901","2017-03-29",2,7,5,12,12,"No",3,2,4,3
"1902","2017-03-29",NA,1150,450,1600,NA,"Yes",200,250,500,650
"1903","2017-03-29",3,6,3,9,9,"Yes",3,NA,3,3
"1904","2017-03-29",2,4,4,8,8,"Yes",2,2,2,2
"1905","2017-03-29",9,12,9,21,21,"Yes",6,3,7,5
"1906","2017-03-29",2,7,5,12,12,"No",2,3,2,5
"1907","2017-03-29",4,14,17,31,31,"Yes",5,12,6,8
"1908","2017-03-29",2,5,1,6,12,"No",1,0,2,3
"1909","2017-03-29",6,16,11,27,27,"Yes",5,6,7,9
"1910","2017-03-29",3,6,14,20,30,"Yes",5,9,3,3
"1911","2017-03-29",4,6,6,12,15,"Yes",4,2,3,3
"1912","2017-03-29",2,6,3,9,8,"No",2,1,2,4
"1913","2017-03-29",3,7,6,13,12,"No",4,2,4,3
"1914","2017-03-29",3,7,7,14,14,"No",4,3,3,4
"1915","2017-03-29",5,16,5,21,NA,"Yes",2,3,9,7
"1916","2017-03-29",2,2,6,8,9,"No",2,4,1,1
"1917","2017-03-29",3,6,8,14,15,"Yes",3,5,3,3
"1918","2017-03-29",1,2,3,5,5,"Yes",2,1,1,1
"1919","2017-03-29",4,8,8,16,16,"Yes",3,5,4,4
"1920","2017-03-29",4,9,3,12,12,"Yes",2,1,4,5
"1921","2017-03-29",2,8,7,15,15,"Yes",4,3,5,3
"1922","2017-03-29",6,0,0,0,5,"Yes",NA,NA,NA,NA
"1923","2017-03-29",4,9,7,16,16,"Yes",4,3,3,6
"1924","2017-03-29",1,4,3,7,7,"Yes",1,2,1,3
"1925","2017-03-29",1,2,4,6,6,"Yes",0,4,1,1
"1926","2017-03-29",2,0,5,5,10,"Yes",3,2,NA,NA
"1927","2017-03-29",1,2,4,6,6,"Yes",2,2,1,1
"1928","2017-03-29",3,10,5,15,15,"Yes",2,3,4,6
"1929","2017-03-29",2,4,1,5,5,"Yes",0,1,2,2
"1930","2017-03-29",3,7,6,13,16,"No",2,4,5,2
"1931","2017-04-05",5,13,3,16,10,"Yes",1,2,7,6
"1932","2017-03-29",3,6,3,9,9,"Yes",2,1,3,3
"1933","2017-03-29",4,8,8,16,16,"No",6,2,4,4
"1934","2017-03-29",4,8,0,8,8,"Yes",0,0,4,4
"1935","2017-03-29",1,4,1,5,4,"Yes",0,1,1,3
"1936","2017-03-29",4,8,8,16,16,"No",5,3,4,4
"1937","2017-03-29",3,7,7,14,13,"No",3,4,3,4
"1938","2017-03-29",3,5,1,6,6,"No",0,1,3,2
"1939","2017-03-29",3,6,0,6,6,"Yes",0,0,4,2
"1940","2017-03-29",5,9,3,12,12,"Yes",3,0,4,5
"1941","2017-03-29",4,13,2,15,15,"Yes",1,1,8,5
"1942","2017-03-29",1,4,0,4,4,"Yes",0,0,0,4
"1943","2017-03-29",3,6,5,11,11,"Yes",2,3,2,4
"1944","2017-03-29",2,6,1,7,10,"Yes",1,NA,2,4
"1945","2017-03-29",7,11,7,18,16,"Yes",3,4,5,6
"1946","2017-03-29",4,8,10,18,18,"Yes",6,4,4,4
"1947","2017-03-29",3,4,3,7,7,"Yes",2,1,2,2
"1948","2017-03-29",3,11,7,18,NA,"No",4,3,6,5
"1949","2017-03-29",NA,7,139,146,NA,"No",53,86,2,5
"1950","2017-03-29",4,7,1,8,8,"No",1,NA,3,4
"1951","2017-03-29",5,9,6,15,16,"Yes",3,3,5,4
"1952","2017-03-29",4,7,5,12,NA,"Yes",3,2,3,4
"1953","2017-03-29",4,8,11,19,19,"No",6,5,4,4
"1954","2017-03-29",10,14,14,28,28,"Yes",8,6,6,8
"1955","2017-03-29",5,0,0,0,14,"No",0,0,0,0
"1956","2017-03-29",5,14,8,22,21,"No",5,3,5,9
"1957","2017-03-29",3,6,3,9,11,NA,2,1,5,1
"1958","2017-03-29",3,5,7,12,12,"Yes",3,4,2,3
"1959","2017-03-29",1,4,2,6,6,"No",1,1,2,2
"1960","2017-03-29",1,1,4,5,5,"Yes",3,1,1,0
"1961","2017-03-29",1,8,3,11,11,"Yes",1,2,2,6
"1962","2017-03-29",4,12,7,19,15,"No",5,2,6,6
"1963","2017-03-29",4,7,7,14,14,"Yes",2,5,5,2
"1964","2017-03-29",2,4,2,6,6,"Yes",2,NA,2,2
"1965","2017-03-29",4,8,10,18,20,"Yes",4,6,4,4
"1966","2017-03-29",3,9,4,13,13,"Yes",3,1,4,5
"1967","2017-03-29",3,6,4,10,10,"Yes",1,3,1,5
"1968","2017-03-29",2,10,6,16,16,"Yes",2,4,4,6
"1969","2017-03-29",5,5,3,8,8,"Yes",3,0,2,3
"1970","2017-03-29",5,16,10,26,27,"Yes",7,3,8,8
"1971","2017-03-29",4,0,5,5,21,"No",5,NA,NA,NA
"1972","2017-04-05",2,3,6,9,9,"Yes",4,2,1,2
"1973","2017-03-29",2,4,5,9,9,"Yes",3,2,1,3
"1974","2017-03-29",NA,75,40,115,NA,"No",20,20,35,40
"1975","2017-03-29",7,13,8,21,NA,"Yes",5,3,8,5
"1976","2017-03-29",5,10,7,17,17,"Yes",3,4,5,5
"1977","2017-03-29",8,11,10,21,21,"Yes",4,6,5,6
"1978","2017-03-29",4,8,12,20,20,"No",5,7,4,4
"1979","2017-03-29",6,20,10,30,25,"Yes",5,5,5,15
"1980","2017-03-29",4,9,16,25,25,"Yes",10,6,4,5
"1981","2017-03-29",1,2,3,5,5,"Yes",1,2,1,1
"1982","2017-03-29",3,6,2,8,8,"No",0,2,3,3
"1983","2017-03-29",9,18,20,38,38,"Yes",13,7,7,11
"1984","2017-03-29",5,13,7,20,20,"No",4,3,5,8
"1985","2017-03-29",4,12,2,14,18,"No",0,2,6,6
"1986","2017-03-29",6,17,7,24,26,"No",4,3,9,8
"1987","2017-03-29",1,2,3,5,5,"Yes",0,3,1,1
"1988","2017-03-29",5,16,14,30,30,"No",6,8,8,8
"1989","2017-03-29",7,15,6,21,19,"No",4,2,9,6
"1990","2017-03-28",7,17,6,23,NA,"Yes",4,2,9,8
"1991","2017-03-29",4,4,9,13,13,"No",3,6,1,3
"1992","2017-03-29",5,11,11,22,22,"Yes",5,6,8,3
"1993","2017-03-29",9,18,8,26,24,"No",6,2,10,8
"1994","2017-03-29",2,9,4,13,13,"Yes",2,2,1,8
"1995","2017-03-29",2,8,7,15,15,"Yes",6,1,4,4
"1996","2017-03-29",3,4,0,4,4,"No",0,0,3,1
"1997","2017-03-29",4,9,4,13,14,"Yes",3,1,3,6
"1998","2017-03-29",9,9,6,15,10,"Yes",4,2,3,6
"1999","2017-03-29",1,7,5,12,12,"Yes",3,2,4,3
"2000","2017-03-29",3,5,4,9,8,"Yes",3,1,3,2
"2001","2017-03-29",7,8,10,18,18,"No",4,6,4,4
"2002","2017-03-29",4,8,0,8,8,"No",NA,NA,4,4
"2003","2017-03-29",3,8,15,23,23,"Yes",7,8,5,3
"2004","2017-03-29",4,6,6,12,12,"No",3,3,3,3
"2005","2017-03-29",4,8,10,18,17,"No",3,7,4,4
"2006","2017-03-29",3,11,0,11,11,"Yes",0,0,3,8
"2007","2017-03-29",8,36,17,53,54,"Yes",9,8,17,19
"2008","2017-03-29",1,1,5,6,6,"Yes",2,3,1,0
"2009","2017-03-29",3,6,3,9,9,"Yes",1,2,3,3
"2010","2017-03-29",4,10,10,20,21,"Yes",5,5,6,4
"2011","2017-03-29",4,5,0,5,5,"Yes",0,0,3,2
"2012","2017-03-29",1,2,4,6,6,"No",2,2,1,1
"2013","2017-03-29",1,3,3,6,6,"Yes",0,3,1,2
"2014","2017-03-29",4,8,4,12,14,"No",3,1,4,4
"2015","2017-03-29",NA,7,0,7,NA,"No",0,0,5,2
"2016","2017-03-29",3,5,4,9,9,"Yes",3,1,2,3
"2017","2017-03-29",1,3,1,4,4,"Yes",1,NA,2,1
"2018","2017-03-29",4,13,13,26,26,"Yes",7,6,5,8
"2019","2017-03-29",5,11,6,17,NA,"Yes",2,4,6,5
"2020","2017-03-29",3,7,7,14,14,"Yes",3,4,4,3
"2021","2017-03-29",4,7,4,11,10,"No",1,3,3,4
"2022","2017-03-29",2,2,0,2,2,"No",0,0,2,0
"2023","2017-03-29",1,5,3,8,8,"Yes",0,3,2,3
"2024","2017-03-29",9,18,6,24,23,"Yes",4,2,10,8
"2025","2017-03-29",3,6,7,13,13,"No",3,4,2,4
"2026","2017-03-29",6,8,2,10,11,"Yes",1,1,7,1
"2027","2017-03-29",NA,0,0,0,NA,"No",0,0,0,0
"2028","2017-03-29",4,14,7,21,21,"Yes",4,3,7,7
"2029","2017-03-29",7,12,10,22,22,"No",5,5,4,8
"2030","2017-03-29",2,7,0,7,7,"No",0,0,3,4
"2031","2017-03-29",3,10,3,13,12,"Yes",3,0,2,8
"2032","2017-03-29",2,4,3,7,7,"No",0,3,2,2
"2033","2017-03-29",2,3,2,5,5,"Yes",1,1,1,2
"2034","2017-03-29",2,7,0,7,7,"Yes",0,0,5,2
"2035","2017-03-29",4,11,7,18,17,"No",3,4,5,6
"2036","2017-03-29",5,10,6,16,20,"Yes",4,2,5,5
"2037","2017-03-29",6,12,18,30,30,"No",8,10,6,6
"2038","2017-03-29",8,18,8,26,25,"No",3,5,7,11
"2039","2017-03-29",3,7,3,10,10,"Yes",2,1,3,4
"2040","2017-03-29",4,11,10,21,21,"Yes",3,7,5,6
"2041","2017-03-29",4,13,7,20,NA,"Yes",5,2,7,6
"2042","2017-03-29",1,8,1,9,9,"Yes",0,1,4,4
"2043","2017-03-29",1,5,5,10,10,"Yes",3,2,1,4
"2044","2017-03-29",3,4,5,9,9,"No",3,2,0,4
"2045","2017-03-29",1,2,5,7,6,"No",2,3,1,1
"2046",NA,5,9,6,15,15,"Yes",2,4,4,5
"2047","2017-03-29",9,18,6,24,26,"Yes",4,2,9,9
"2048","2017-03-29",8,15,10,25,NA,"Yes",6,4,9,6
"2049","2017-03-29",2,7,4,11,11,"Yes",4,0,3,4
"2050","2017-03-29",6,11,5,16,16,"No",4,1,4,7
"2051","2017-03-29",3,6,6,12,12,"Yes",2,4,3,3
"2052","2017-03-29",1,5,1,6,NA,"Yes",1,0,2,3
"2053","2017-03-29",8,27,8,35,35,"Yes",3,5,11,16
"2054","2017-03-29",7,20,20,40,40,"Yes",9,11,10,10
"2055","2017-03-29",4,15,5,20,21,"Yes",3,2,7,8
"2056","2017-03-29",2,6,1,7,7,"Yes",0,1,4,2
"2057","2017-03-29",2,6,7,13,13,"No",3,4,3,3
"2058","2017-03-29",NA,275,110,385,NA,"No",53,57,95,180
"2059","2017-03-29",5,10,10,20,20,"Yes",5,5,3,7
"2060","2017-03-30",3,6,0,6,6,NA,NA,NA,2,4
"2061","2017-03-30",NA,19,11,30,NA,"No",5,6,7,12
"2062","2017-03-30",5,11,12,23,23,"Yes",5,7,5,6
"2063","2017-03-30",2,8,4,12,13,"Yes",1,3,1,7
"2064","2017-03-30",4,7,3,10,10,"Yes",1,2,5,2
"2065","2017-03-30",1,3,1,4,4,"Yes",1,0,1,2
"2066","2017-03-30",1,2,4,6,6,"No",3,1,1,1
"2067","2017-03-30",2,5,1,6,6,"Yes",0,1,2,3
"2068","2017-03-30",8,18,5,23,23,"No",2,3,10,8
"2069","2017-03-30",2,4,4,8,8,"Yes",2,2,2,2
"2070","2017-03-30",1,2,7,9,9,"Yes",2,5,1,1
"2071","2017-03-30",5,11,5,16,16,"Yes",2,3,5,6
"2072","2017-03-30",3,3,4,7,7,"Yes",1,3,1,2
"2073","2017-03-30",5,10,9,19,19,"Yes",3,6,5,5
"2074","2017-03-30",3,7,17,24,25,"Yes",7,10,3,4
"2075","2017-03-30",2,5,4,9,9,"Yes",3,1,1,4
"2076","2017-03-30",1,4,0,4,4,"Yes",0,0,1,3
"2077","2017-03-30",1,4,0,4,5,"Yes",0,0,2,2
"2078","2017-03-30",3,11,3,14,14,"Yes",2,1,5,6
"2079","2017-03-30",4,10,5,15,10,"No",2,3,4,6
"2080","2017-03-30",4,10,10,20,20,"Yes",2,8,4,6
"2081","2017-03-30",3,8,2,10,10,"Yes",0,2,4,4
"2082","2017-03-30",10,25,25,50,50,"No",15,10,10,15
"2083","2017-03-30",10,14,6,20,20,"No",2,4,7,7
"2084","2017-03-30",5,9,7,16,16,"Yes",4,3,5,4
"2085","2017-03-30",3,6,9,15,15,"Yes",4,5,3,3
"2086","2017-03-30",4,9,3,12,12,"No",2,1,4,5
"2087","2017-03-30",2,5,3,8,8,"Yes",2,1,2,3
"2088","2017-03-30",8,13,21,34,34,"No",11,10,6,7
"2089","2017-03-30",2,7,3,10,10,"Yes",1,2,4,3
"2090","2017-03-30",7,21,8,29,NA,"Yes",3,5,9,12
"2091","2017-03-30",9,19,3,22,22,"Yes",0,3,12,7
"2092","2017-03-30",12,22,10,32,30,"Yes",6,4,12,10
"2093","2017-03-30",7,6,5,11,11,"No",2,3,2,4
"2094","2017-03-30",1,4,0,4,4,"Yes",0,0,3,1
"2095","2017-03-30",5,9,2,11,11,"Yes",0,2,4,5
"2096","2017-03-30",2,4,0,4,4,"Yes",NA,NA,1,3
"2097","2017-03-30",6,12,24,36,36,"Yes",10,14,6,6
"2098","2017-03-30",3,6,5,11,11,"No",2,3,3,3
"2099","2017-03-30",1,9,5,14,14,"Yes",2,3,3,6
"2100","2017-04-06",1,3,6,9,8,"Yes",2,4,1,2
"2101","2017-03-30",2,8,4,12,12,NA,2,2,6,2
"2102","2017-03-30",1,2,2,4,4,"No",2,0,1,1
"2103","2017-03-30",5,15,5,20,16,"Yes",1,4,9,6
"2104","2017-03-30",2,4,1,5,5,"Yes",1,0,2,2
"2105","2017-03-30",10,21,21,42,42,"Yes",8,13,10,11
"2106","2017-03-30",2,4,4,8,8,"Yes",2,2,2,2
"2107","2017-03-30",4,8,0,8,8,"Yes",NA,NA,4,4
"2108","2017-03-30",10,25,25,50,52,"Yes",10,15,12,13
"2109","2017-03-30",14,20,40,60,60,"No",10,30,8,12
"2110","2017-03-30",3,13,2,15,NA,"Yes",1,1,5,8
"2111","2017-03-30",2,3,3,6,6,"No",2,1,2,1
"2112","2017-03-30",3,8,3,11,12,"Yes",1,2,2,6
"2113","2017-03-30",5,0,0,0,NA,"Yes",NA,NA,NA,NA
"2114","2017-03-30",1,2,2,4,4,"Yes",NA,2,1,1
"2115","2017-03-30",6,12,5,17,15,"Yes",2,3,6,6
"2116","2017-03-30",8,17,12,29,29,"No",4,8,8,9
"2117","2017-03-30",2,3,0,3,3,"Yes",0,0,2,1
"2118","2017-03-30",2,9,2,11,11,"Yes",2,0,4,5
"2119","2017-03-30",5,6,3,9,9,"Yes",1,2,3,3
"2120","2017-03-30",6,16,9,25,25,"No",5,4,10,6
"2121","2017-03-30",9,31,21,52,56,"No",10,11,16,15
"2122","2017-03-30",3,8,1,9,8,"No",1,0,3,5
"2123","2017-03-30",5,8,8,16,16,"Yes",4,4,4,4
"2124","2017-03-30",2,6,0,6,6,"Yes",0,0,2,4
"2125","2017-03-30",7,14,12,26,22,NA,9,3,7,7
"2126","2017-03-30",4,8,6,14,14,"Yes",1,5,4,4
"2127","2017-03-30",2,3,1,4,4,"Yes",1,NA,3,NA
"2128","2017-03-30",1,4,4,8,8,"Yes",2,2,2,2
"2129","2017-03-30",6,11,7,18,20,"Yes",4,3,6,5
"2130","2017-03-30",NA,76,1,77,NA,"Yes",0,1,56,20
"2131","2017-03-30",3,7,1,8,8,"Yes",0,1,4,3
"2132","2017-03-30",3,4,8,12,11,"Yes",5,3,1,3
"2133","2017-03-30",1,2,1,3,4,"No",0,1,1,1
"2134","2017-03-30",3,5,3,8,8,"Yes",2,1,3,2
"2135","2017-03-30",3,6,4,10,10,"Yes",1,3,3,3
"2136","2017-03-30",1,9,3,12,12,"No",2,1,4,5
"2137","2017-03-30",3,8,5,13,13,"Yes",2,3,5,3
"2138","2017-03-30",6,0,0,0,NA,"Yes",NA,NA,NA,NA
"2139","2017-03-30",4,7,8,15,15,"No",4,4,4,3
"2140","2017-03-30",3,4,5,9,8,"Yes",2,3,1,3
"2141","2017-03-30",1,5,4,9,9,"Yes",1,3,2,3
"2142","2017-03-30",1,4,3,7,7,"No",1,2,1,3
"2143","2017-03-30",9,10,11,21,21,"Yes",6,5,5,5
"2144","2017-03-30",1,8,7,15,15,"Yes",4,3,6,2
"2145","2017-03-30",6,19,7,26,27,"No",1,6,3,16
"2146","2017-03-30",NA,81,55,136,NA,"No",25,30,58,23
"2147","2017-03-30",4,10,5,15,14,"Yes",4,1,3,7
"2148","2017-03-30",6,11,6,17,16,"No",3,3,4,7
"2149","2017-03-30",1,2,5,7,8,"No",2,3,1,1
"2150","2017-03-30",4,9,11,20,20,"Yes",5,6,5,4
"2151","2017-03-30",3,5,5,10,10,"Yes",2,3,3,2
"2152","2017-03-30",2,9,7,16,16,"Yes",3,4,6,3
"2153","2017-03-30",9,34,37,71,45,"Yes",12,25,9,25
"2154","2017-03-30",3,14,7,21,NA,"Yes",5,2,7,7
"2155","2017-03-30",4,8,9,17,17,"No",4,5,4,4
"2156","2017-03-30",4,12,9,21,16,"Yes",3,6,6,6
"2157","2017-03-30",4,8,12,20,20,"Yes",5,7,4,4
"2158","2017-03-30",3,8,8,16,15,"Yes",4,4,4,4
"2159","2017-03-30",7,20,14,34,NA,"Yes",6,8,8,12
"2160","2017-03-30",2,8,4,12,12,"Yes",1,3,3,5
"2161","2017-03-30",1,2,5,7,7,"Yes",4,1,1,1
"2162","2017-03-30",3,10,6,16,17,"Yes",3,3,4,6
"2163","2017-03-30",1,2,4,6,6,"Yes",2,2,1,1
"2164","2017-03-30",4,9,0,9,10,"Yes",0,0,5,4
"2165","2017-03-30",9,11,9,20,20,"Yes",5,4,5,6
"2166","2017-03-30",4,8,14,22,15,"Yes",6,8,3,5
"2167","2017-03-30",3,9,8,17,17,"Yes",4,4,4,5
"2168","2017-03-30",3,8,1,9,9,"Yes",NA,1,5,3
"2169","2017-03-30",2,6,2,8,8,"Yes",0,2,4,2
"2170","2017-03-30",7,14,1,15,NA,"Yes",1,0,6,8
"2171","2017-03-30",2,6,7,13,13,"Yes",4,3,3,3
"2172","2017-04-06",3,6,3,9,9,"No",1,2,2,4
"2173","2017-03-30",3,3,4,7,9,"Yes",0,4,2,1
"2174","2017-03-30",8,18,8,26,26,"No",5,3,2,16
"2175","2017-03-30",2,4,5,9,9,"Yes",1,4,2,2
"2176","2017-03-30",2,5,5,10,8,"Yes",0,5,3,2
"2177","2017-03-30",4,8,6,14,14,"Yes",4,2,4,4
"2178","2017-03-30",14,0,0,0,NA,"Yes",NA,NA,NA,NA
"2179","2017-03-30",2,5,5,10,10,"Yes",2,3,3,2
"2180","2017-03-30",5,12,11,23,1073,"No",8,3,6,6
"2181","2017-03-30",3,6,5,11,11,"No",1,4,3,3
"2182","2017-03-30",4,7,14,21,14,"Yes",8,6,4,3
"2183","2017-03-30",5,11,9,20,20,"Yes",4,5,5,6
"2184","2017-03-30",4,8,8,16,24,"Yes",5,3,4,4
"2185","2017-03-30",4,7,4,11,11,"Yes",1,3,4,3
"2186","2017-03-30",2,3,2,5,5,"Yes",1,1,1,2
"2187","2017-03-30",10,15,8,23,23,"Yes",5,3,5,10
"2188","2017-03-30",1,1,0,1,1,"Yes",0,0,1,0
"2189","2017-03-30",2,4,2,6,6,"Yes",1,1,1,3
"2190","2017-03-30",2,4,4,8,8,"Yes",2,2,2,2
"2191","2017-03-30",4,8,10,18,15,"No",2,8,4,4
"2192","2017-03-30",1,6,1,7,7,"Yes",1,0,2,4
"2193","2017-03-30",4,8,10,18,18,"No",4,6,4,4
"2194","2017-03-30",7,10,5,15,15,"No",1,4,5,5
"2195","2017-03-30",3,6,6,12,12,"Yes",2,4,3,3
"2196","2017-03-30",6,11,6,17,21,"Yes",5,1,3,8
"2197","2017-03-30",4,9,6,15,16,"No",3,3,4,5
"2198","2017-03-30",3,8,3,11,NA,"No",2,1,5,3
"2199","2017-03-30",1,2,2,4,4,"Yes",0,2,1,1
"2200","2017-03-30",6,12,5,17,17,"No",2,3,6,6
"2201","2017-03-30",1,5,5,10,10,"Yes",4,1,2,3
"2202","2017-03-30",6,11,1,12,11,"Yes",0,1,6,5
"2203","2017-03-30",2,9,3,12,11,"No",2,1,3,6
"2204","2017-03-30",4,5,1,6,6,"No",0,1,3,2
"2205","2017-03-30",3,6,3,9,9,"No",2,1,4,2
"2206","2017-03-30",1,5,1,6,6,"No",1,0,1,4
"2207","2017-03-30",7,14,10,24,24,"Yes",6,4,7,7
"2208","2017-03-30",5,0,0,0,NA,"Yes",NA,NA,NA,NA
"2209","2017-03-30",4,7,0,7,10,"Yes",0,0,4,3
"2210","2017-04-06",2,5,4,9,12,"No",3,1,3,2
"2211","2017-03-30",1,2,5,7,7,"Yes",2,3,1,1
"2212","2017-03-30",15,33,21,54,NA,"Yes",12,9,18,15
"2213","2017-03-30",8,17,3,20,20,"No",1,2,11,6
"2214","2017-03-30",4,8,5,13,13,"No",3,2,4,4
"2215","2017-03-30",2,5,3,8,8,"No",1,2,3,2
"2216","2017-03-30",1,9,2,11,11,"Yes",0,2,5,4
"2217","2017-03-30",6,12,10,22,22,"Yes",5,5,6,6
"2218","2017-03-30",2,2,5,7,7,"No",2,3,1,1
"2219","2017-03-30",6,17,5,22,22,"Yes",4,1,13,4
"2220","2017-03-30",NA,14,6,20,NA,"Yes",1,5,8,6
"2221","2017-03-30",1,5,1,6,6,"No",1,0,2,3
"2222","2017-03-30",4,16,4,20,18,"Yes",3,1,10,6
"2223","2017-03-30",6,11,14,25,26,"No",9,5,5,6
"2224","2017-03-30",4,8,18,26,26,"No",7,11,4,4
"2225","2017-03-30",1,4,0,4,4,"Yes",0,0,2,2
"2226","2017-03-30",5,14,11,25,23,"Yes",5,6,5,9
"2227","2017-03-30",7,20,8,28,28,"No",6,2,9,11
"2228","2017-03-30",2,5,4,9,9,"Yes",1,3,2,3
"2229","2017-03-30",7,0,0,0,NA,"Yes",NA,NA,NA,NA
"2230","2017-03-30",3,4,4,8,12,"Yes",1,3,2,2
"2231","2017-03-30",4,12,8,20,20,"Yes",4,4,8,4
"2232","2017-03-30",1,5,2,7,7,"Yes",1,1,2,3
"2233","2017-03-30",3,12,7,19,19,"Yes",4,3,5,7
"2234","2017-03-30",3,9,3,12,10,"Yes",2,1,3,6
"2235","2017-03-30",3,7,5,12,12,NA,2,3,4,3
"2236","2017-03-30",7,12,6,18,18,"Yes",4,2,6,6
"2237","2017-03-30",7,14,16,30,30,"No",7,9,7,7
"2238","2017-03-30",3,5,0,5,5,"Yes",0,0,2,3
"2239","2017-03-30",1,4,4,8,8,"Yes",NA,4,2,2
"2240","2017-03-30",1,3,0,3,3,"Yes",0,0,1,2
"2241","2017-03-30",1,4,3,7,7,"Yes",3,NA,2,2
"2242","2017-03-30",4,6,1,7,7,"Yes",1,0,3,3
"2243","2017-03-30",6,12,2,14,14,"No",1,1,8,4
"2244","2017-03-30",5,10,15,25,25,"Yes",13,2,5,5
"2245","2017-03-30",4,10,5,15,15,"No",4,1,5,5
"2246","2017-03-30",1,3,5,8,8,"Yes",3,2,1,2
"2247",NA,13,30,24,54,54,"No",10,14,10,20
"2248","2017-03-30",NA,0,0,0,NA,"Yes",0,0,NA,NA
"2249","2017-03-30",NA,2,0,2,NA,"Yes",0,0,1,1
"2250","2017-03-30",3,7,6,13,13,"Yes",2,4,4,3
"2251","2017-03-30",1,10,2,12,12,"Yes",0,2,2,8
"2252","2017-03-30",4,13,7,20,NA,"No",4,3,6,7
"2253","2017-03-30",1,4,3,7,7,"Yes",1,2,3,1
"2254","2017-03-30",5,10,17,27,27,"Yes",8,9,5,5
"2255","2017-03-30",2,6,7,13,13,"No",4,3,2,4
"2256","2017-03-30",2,6,2,8,8,"Yes",0,2,4,2
"2257","2017-03-30",3,8,5,13,10,"Yes",2,3,4,4
"2258","2017-03-30",4,7,9,16,16,"Yes",4,5,1,6
"2259","2017-03-30",1,2,4,6,6,"Yes",2,2,1,1
"2260","2017-03-30",1,4,3,7,7,"Yes",1,2,1,3
"2261","2017-03-30",5,0,0,0,NA,"No",NA,NA,NA,NA
"2262","2017-03-30",2,7,2,9,12,"Yes",2,0,3,4
"2263","2017-03-30",1,5,0,5,5,"Yes",0,0,3,2
"2264","2017-03-30",3,6,8,14,14,"No",4,4,3,3
"2265","2017-03-30",4,8,4,12,12,"Yes",1,3,4,4
"2266","2017-03-30",4,7,6,13,16,"Yes",3,3,4,3
"2267","2017-03-30",6,20,12,32,NA,"Yes",6,6,8,12
"2268","2017-03-30",3,10,10,20,20,"Yes",5,5,6,4
"2269","2017-03-30",5,12,6,18,18,"Yes",3,3,6,6
"2270","2017-03-30",5,13,8,21,21,"Yes",5,3,7,6
"2271","2017-03-30",5,9,3,12,12,"Yes",2,1,4,5
"2272","2017-03-30",5,10,10,20,20,"Yes",4,6,5,5
"2273","2017-03-30",8,25,15,40,40,"Yes",5,10,10,15
"2274","2017-03-30",2,2,2,4,3,"No",2,0,1,1
"2275","2017-03-30",3,9,5,14,14,"Yes",4,1,4,5
"2276","2017-03-30",NA,375,0,375,NA,NA,NA,NA,300,75
"2277","2017-03-30",3,20,3,23,12,"Yes",2,1,12,8
"2278","2017-03-30",4,6,8,14,23,"No",2,6,3,3
"2279","2017-03-30",2,4,1,5,5,"Yes",1,0,2,2
"2280","2017-03-30",6,0,0,0,NA,"Yes",NA,NA,NA,NA
"2281","2017-03-30",2,4,0,4,4,"Yes",NA,NA,2,2
"2282","2017-03-30",4,8,10,18,15,"Yes",4,6,5,3
"2283","2017-03-30",3,19,6,25,25,"No",2,4,10,9
"2284","2017-03-30",4,8,19,27,27,"No",8,11,4,4
"2285","2017-03-30",1,5,7,12,NA,"Yes",2,5,2,3
"2286","2017-03-30",4,8,16,24,24,"Yes",7,9,4,4
"2287","2017-03-30",4,6,4,10,11,"No",2,2,4,2
"2288","2017-03-30",3,5,2,7,8,"No",0,2,2,3
"2289","2017-03-30",6,9,9,18,20,"Yes",3,6,4,5
"2290","2017-03-30",5,5,5,10,10,"Yes",2,3,4,1
"2291","2017-03-30",2,4,9,13,13,"No",3,6,2,2
"2292","2017-03-30",5,13,6,19,NA,"Yes",4,2,7,6
"2293","2017-03-30",6,12,6,18,18,"Yes",4,2,7,5
"2294","2017-03-23",4,6,2,8,8,"No",1,1,3,3
"2295","2017-03-30",4,14,10,24,24,"No",5,5,4,10
"2296","2017-03-30",3,6,7,13,28,"No",4,3,3,3
"2297","2017-03-30",2,7,1,8,8,"Yes",0,1,1,6
"2298","2017-03-30",2,5,0,5,5,"Yes",0,0,1,4
"2299","2017-03-29",5,8,5,13,10,"Yes",2,3,5,3
"2300","2017-03-30",4,8,8,16,16,"Yes",5,3,4,4
"2301","2017-03-30",3,6,4,10,9,"Yes",2,2,3,3
"2302","2017-03-30",1,4,5,9,9,"Yes",2,3,3,1
"2303","2017-03-30",1,3,4,7,7,"Yes",1,3,1,2
"2304","2017-03-30",8,18,12,30,30,"Yes",6,6,10,8
"2305","2017-03-30",3,7,4,11,9,"Yes",2,2,3,4
"2306","2017-03-30",2,4,1,5,5,"No",0,1,2,2
"2307","2017-03-30",NA,4,6,10,NA,"Yes",4,2,2,2
"2308","2017-03-30",1,3,4,7,7,"Yes",2,2,1,2
"2309","2017-03-30",3,14,4,18,NA,"No",1,3,6,8
"2310","2017-03-30",3,13,7,20,20,"Yes",3,4,4,9
"2311","2017-03-30",4,6,2,8,9,"Yes",2,NA,4,2
"2312","2017-03-30",1,1,0,1,1,"No",0,0,1,0
"2313","2017-03-30",6,12,12,24,26,"No",7,5,6,6
"2314","2017-03-30",4,7,3,10,10,"Yes",1,2,4,3
"2315","2017-03-30",4,8,2,10,NA,"Yes",2,0,5,3
"2316","2017-03-30",2,12,4,16,16,"Yes",1,3,5,7
"2317","2017-03-30",1,6,1,7,7,"Yes",1,0,3,3
"2318","2017-03-30",6,15,6,21,18,"No",3,3,6,9
"2319","2017-03-30",1,10,8,18,18,NA,3,5,5,5
"2320","2017-03-30",2,4,6,10,10,"Yes",2,4,2,2
"2321","2017-03-30",10,14,4,18,15,"Yes",0,4,8,6
"2322","2017-03-30",10,20,31,51,50,"No",18,13,10,10
"2323","2017-03-30",3,8,8,16,15,"Yes",3,5,5,3
"2324","2017-03-30",4,6,4,10,10,"No",3,1,4,2
"2325","2017-03-30",1,10,2,12,12,"Yes",0,2,6,4
"2326","2017-03-30",12,31,17,48,50,"Yes",9,8,18,13
"2327","2017-03-30",1,4,2,6,6,"Yes",1,1,3,1
"2328","2017-03-30",3,6,6,12,12,"Yes",2,4,3,3
"2329","2017-03-30",3,6,1,7,7,"Yes",1,0,2,4
"2330","2017-03-30",5,10,10,20,20,"Yes",3,7,5,5
"2331","2017-03-30",4,8,4,12,12,"Yes",2,2,5,3
"2332","2017-03-30",3,9,0,9,8,"Yes",NA,NA,6,3
"2333","2017-03-30",3,5,11,16,16,"No",8,3,2,3
"2334","2017-03-30",4,8,8,16,16,"No",3,5,4,4
"2335",NA,1,2,2,4,4,"Yes",0,2,1,1
"2336","2017-03-30",1,5,3,8,8,"No",2,1,3,2
"2337","2017-03-30",7,11,5,16,18,"Yes",5,0,4,7
"2338","2017-03-30",15,24,13,37,43,"No",5,8,8,16
"2339","2017-03-30",6,14,9,23,23,"Yes",4,5,7,7
"2340","2017-03-30",4,8,6,14,14,"Yes",2,4,4,4
"2341","2017-03-30",6,20,6,26,NA,"Yes",3,3,8,12
"2342","2017-03-30",1,4,3,7,8,"No",2,1,2,2
"2343","2017-03-30",4,0,0,0,NA,"Yes",NA,NA,NA,NA
"2344","2017-03-30",3,9,10,19,23,"Yes",5,5,6,3
"2345","2017-03-30",3,7,4,11,11,"No",1,3,2,5
"2346","2017-03-30",2,3,2,5,5,"No",2,0,2,1
"2347","2017-03-30",3,7,4,11,13,"Yes",3,1,3,4
"2348","2017-03-30",1,5,4,9,9,"No",3,1,4,1
"2349","2017-03-30",5,0,0,0,NA,"Yes",NA,NA,NA,NA
"2350","2017-03-30",5,10,10,20,50,"No",4,6,5,5
"2351","2017-03-30",7,21,8,29,NA,"No",5,3,8,13
"2352","2017-03-30",3,8,2,10,11,"Yes",2,0,4,4
"2353","2017-03-30",6,10,5,15,15,"Yes",2,3,5,5
"2354","2017-03-30",1,3,0,3,3,"Yes",0,0,1,2
"2355","2017-03-30",2,4,0,4,4,"Yes",NA,NA,2,2
"2356","2017-03-30",5,8,4,12,12,"Yes",2,2,2,6
"2357","2017-03-30",4,9,7,16,16,"No",2,5,5,4
"2358","2017-03-30",3,11,2,13,6,"Yes",1,1,6,5
"2359","2017-03-30",1,2,2,4,4,"Yes",1,1,NA,2
"2360","2017-03-30",3,5,4,9,12,"Yes",3,1,2,3
"2361","2017-03-30",4,11,11,22,22,"Yes",7,4,4,7
"2362","2017-03-30",4,7,3,10,10,"No",1,2,2,5
"2363","2017-03-30",2,8,19,27,23,"No",10,9,4,4
"2364","2017-03-30",7,19,5,24,23,"Yes",2,3,7,12
"2365","2017-03-30",6,8,17,25,25,"Yes",5,12,4,4
"2366","2017-03-30",3,7,8,15,15,"No",2,6,5,2
"2367","2017-03-30",1,10,6,16,16,"Yes",4,2,5,5
"2368","2017-03-30",5,14,9,23,23,"No",5,4,6,8
"2369","2017-03-31",2,4,0,4,6,"Yes",0,0,2,2
"2370","2017-03-31",6,7,6,13,13,"Yes",4,2,3,4
"2371","2017-03-31",8,13,9,22,30,"Yes",7,2,7,6
"2372","2017-03-31",3,12,10,22,21,"No",3,7,6,6
"2373","2017-03-31",5,10,5,15,16,"Yes",3,2,5,5
"2374","2017-03-31",9,11,6,17,17,"No",3,3,4,7
"2375","2017-03-31",4,8,12,20,20,"No",6,6,4,4
"2376","2017-03-31",3,9,4,13,13,"No",3,1,4,5
"2377","2017-03-31",2,4,0,4,4,"No",0,0,2,2
"2378","2017-03-31",3,3,1,4,4,"Yes",0,1,2,1
"2379","2017-03-31",1,1,3,4,4,"Yes",0,3,0,1
"2380","2017-03-31",5,11,4,15,16,"Yes",1,3,5,6
"2381",NA,2,5,3,8,7,"Yes",1,2,2,3
"2382","2017-03-31",2,4,5,9,9,"No",2,3,1,3
"2383","2017-03-31",5,10,15,25,25,"No",7,8,5,5
"2384","2017-03-31",2,12,1,13,13,"Yes",0,1,7,5
"2385","2017-03-31",3,9,1,10,11,"Yes",0,1,3,6
"2386","2017-03-31",8,14,19,33,33,"No",3,16,6,8
"2387","2017-03-31",5,9,9,18,18,"Yes",3,6,3,6
"2388","2017-03-31",2,10,8,18,18,"No",5,3,5,5
"2389","2017-03-31",5,12,10,22,18,"No",5,5,6,6
"2390","2017-03-31",3,7,2,9,10,"Yes",1,1,4,3
"2391","2017-03-31",2,6,1,7,7,"No",1,0,3,3
"2392","2017-03-31",2,5,3,8,8,"No",1,2,2,3
"2393","2017-03-31",5,10,5,15,15,"No",2,3,6,4
"2394","2017-03-31",2,5,4,9,9,"Yes",2,2,2,3
"2395","2017-03-31",1,7,5,12,12,"Yes",3,2,4,3
"2396","2017-03-31",2,5,4,9,9,"No",1,3,3,2
"2397","2017-03-31",3,4,0,4,4,"Yes",0,0,3,1
"2398","2017-03-31",1,2,3,5,5,"No",2,1,1,1
"2399","2017-03-31",6,12,20,32,36,"No",12,8,6,6
"2400","2017-03-31",1,2,3,5,5,"Yes",2,1,1,1
"2401","2017-03-31",6,11,10,21,21,"Yes",2,8,5,6
"2402","2017-03-31",3,8,10,18,18,"Yes",5,5,4,4
"2403","2017-03-31",2,3,1,4,4,NA,NA,1,1,2
"2404","2017-03-31",4,8,7,15,15,"Yes",2,5,4,4
"2405","2017-03-31",5,11,1,12,19,"Yes",0,1,4,7
"2406","2017-03-31",3,6,9,15,15,"No",4,5,3,3
"2407","2017-03-31",3,5,5,10,9,"Yes",3,2,1,4
"2408","2017-03-31",2,7,2,9,9,"Yes",1,1,3,4
"2409","2017-03-31",2,4,3,7,7,"No",1,2,2,2
"2410","2017-03-31",2,4,6,10,10,"Yes",4,2,3,1
"2411","2017-03-31",8,10,7,17,15,"Yes",2,5,5,5
"2412","2017-03-31",3,16,2,18,18,"Yes",0,2,8,8
"2413","2017-03-31",4,6,8,14,14,"Yes",3,5,2,4
"2414","2017-03-31",7,20,7,27,NA,"Yes",2,5,12,8
"2415","2017-03-31",6,7,10,17,17,"Yes",4,6,1,6
"2416","2017-03-31",1,4,5,9,9,"Yes",1,4,1,3
"2417","2017-03-31",6,10,5,15,15,"Yes",1,4,6,4
"2418","2017-03-31",4,8,8,16,16,"Yes",3,5,4,4
"2419","2017-03-31",11,25,25,50,50,"Yes",10,15,20,5
"2420","2017-03-31",3,6,5,11,11,"Yes",2,3,3,3
"2421","2017-03-31",3,13,5,18,16,"No",3,2,7,6
"2422","2017-03-31",2,5,2,7,10,"No",1,1,2,3
"2423","2017-03-31",5,15,14,29,30,"Yes",6,8,6,9
"2424","2017-03-31",1,2,0,2,1,"No",NA,NA,1,1
"2425","2017-03-31",4,8,12,20,20,"Yes",5,7,4,4
"2426","2017-03-31",2,4,3,7,7,"Yes",0,3,2,2
"2427","2017-03-31",2,4,4,8,8,"Yes",2,2,1,3
"2428","2017-03-31",3,7,1,8,11,"Yes",0,1,3,4
"2429","2017-03-31",3,0,7,7,13,"Yes",5,2,NA,NA
"2430","2017-03-31",1,7,3,10,10,"Yes",1,2,4,3
"2431","2017-03-31",5,17,9,26,23,"Yes",3,6,10,7
"2432","2017-03-31",4,10,10,20,25,"Yes",3,7,6,4
"2433","2017-03-31",4,8,11,19,18,"No",4,7,5,3
"2434","2017-03-31",1,3,3,6,6,"Yes",1,2,2,1
"2435","2017-03-31",4,9,8,17,17,"Yes",3,5,4,5
"2436","2017-03-31",5,13,8,21,20,"No",5,3,6,7
"2437","2017-03-31",5,7,2,9,9,"No",2,0,2,5
"2438","2017-03-31",4,11,7,18,20,"Yes",3,4,7,4
"2439","2017-03-31",1,2,3,5,5,"No",2,1,1,1
"2440","2017-03-31",3,7,5,12,13,"Yes",2,3,2,5
"2441","2017-04-07",3,16,6,22,18,"No",5,1,6,10
"2442","2017-03-31",3,6,11,17,17,"Yes",4,7,3,3
"2443","2017-03-31",3,6,1,7,7,"Yes",1,0,3,3
"2444","2017-03-31",22,55,35,90,100,"No",15,20,30,25
"2445","2017-03-31",3,6,13,19,19,"Yes",3,10,3,3
"2446","2017-03-31",14,75,25,100,100,"No",10,15,30,45
"2447","2017-03-31",1,1,5,6,6,"No",0,5,0,1
"2448","2017-03-31",5,10,5,15,15,"Yes",2,3,5,5
"2449","2017-03-31",4,13,5,18,19,"Yes",2,3,6,7
"2450",NA,1,1,4,5,5,"Yes",3,1,0,1
"2451","2017-03-31",1,2,2,4,4,"Yes",1,1,2,0
"2452","2017-03-31",5,11,3,14,14,"Yes",2,1,8,3
"2453","2017-03-31",3,7,7,14,14,"Yes",3,4,5,2
"2454","2017-03-31",2,5,5,10,10,"No",1,4,2,3
"2455","2017-03-31",3,6,0,6,6,"Yes",0,0,4,2
"2456","2017-03-31",7,12,17,29,32,"Yes",10,7,6,6
"2457","2017-03-31",2,4,4,8,8,"Yes",2,2,2,2
"2458","2017-03-31",1,4,0,4,4,"Yes",0,0,4,0
"2459","2017-04-07",2,3,5,8,8,"Yes",4,1,0,3
"2460","2017-03-31",3,11,5,16,15,"No",1,4,6,5
"2461","2017-03-31",1,4,3,7,7,"Yes",1,2,3,1
"2462","2017-03-31",2,4,4,8,8,"Yes",1,3,2,2
"2463","2017-03-31",4,12,18,30,30,"Yes",10,8,5,7
"2464","2017-03-31",12,21,11,32,32,"Yes",5,6,11,10
"2465","2017-03-31",10,22,8,30,30,"No",4,4,10,12
"2466","2017-03-31",4,7,5,12,12,"No",2,3,4,3
"2467","2017-03-31",2,5,1,6,6,"Yes",0,1,4,1
"2468","2017-03-31",7,17,7,24,NA,"No",1,6,9,8
"2469","2017-03-31",7,15,10,25,25,"Yes",4,6,7,8
"2470","2017-03-31",1,2,3,5,5,"Yes",2,1,1,1
"2471","2017-03-31",6,10,15,25,25,"Yes",5,10,4,6
"2472","2017-03-31",5,12,8,20,20,"Yes",5,3,5,7
"2473","2017-03-31",2,6,6,12,11,"No",2,4,2,4
"2474","2017-03-31",4,6,3,9,12,"Yes",2,1,3,3
"2475","2017-03-31",5,16,3,19,NA,"Yes",3,0,8,8
"2476","2017-03-31",2,8,6,14,14,"Yes",4,2,5,3
"2477","2017-03-31",3,5,2,7,7,"Yes",1,1,2,3
"2478","2017-03-31",1,2,4,6,6,"No",NA,4,1,1
"2479","2017-03-31",1,2,4,6,6,"Yes",4,0,1,1
"2480","2017-03-31",9,25,21,46,35,"Yes",9,12,10,15
"2481","2017-03-31",1,2,3,5,5,NA,3,0,1,1
"2482","2017-03-31",3,11,10,21,21,"No",5,5,5,6
"2483","2017-03-31",2,6,5,11,8,"Yes",3,2,4,2
"2484","2017-03-31",4,9,3,12,15,"No",2,1,6,3
"2485","2017-03-31",9,25,8,33,35,"Yes",4,4,15,10
"2486","2017-03-31",1,2,5,7,7,"No",2,3,1,1
"2487","2017-03-31",5,11,13,24,24,"Yes",9,4,5,6
"2488","2017-03-31",3,4,4,8,8,"Yes",2,2,2,2
"2489","2017-03-31",1,5,2,7,7,"Yes",2,NA,1,4
"2490","2017-03-31",1,1,6,7,7,"Yes",3,3,0,1
"2491","2017-03-31",6,15,8,23,24,"Yes",5,3,6,9
"2492","2017-03-31",1,3,4,7,6,"Yes",3,1,0,3
"2493","2017-03-31",5,4,0,4,7,NA,0,0,1,3
"2494","2017-03-31",5,6,4,10,10,"No",2,2,2,4
"2495","2017-03-31",7,12,10,22,NA,"Yes",8,2,5,7
"2496","2017-03-31",4,9,5,14,14,"Yes",3,2,5,4
"2497","2017-03-31",1,4,2,6,6,"Yes",2,0,1,3
"2498","2017-03-31",1,1,2,3,3,"No",1,1,NA,1
"2499","2017-03-31",2,8,3,11,11,"No",1,2,4,4
"2500","2017-03-31",3,8,4,12,10,"Yes",1,3,5,3
"2501","2017-03-31",2,4,16,20,20,"Yes",12,4,2,2
"2502","2017-03-31",3,21,9,30,20,"No",4,5,10,11
"2503","2017-03-31",5,10,7,17,17,"Yes",2,5,3,7
"2504","2017-03-31",4,14,11,25,25,"Yes",2,9,4,10
"2505","2017-03-31",1,2,4,6,6,"Yes",4,NA,1,1
"2506","2017-03-31",NA,330,88,418,NA,"Yes",58,30,200,130
"2507","2017-03-31",NA,8,0,8,NA,"No",NA,NA,4,4
"2508","2017-03-31",3,12,5,17,17,"No",2,3,7,5
"2509","2017-03-31",4,7,1,8,10,"Yes",1,0,3,4
"2510","2017-03-31",5,11,8,19,19,"Yes",3,5,5,6
"2511","2017-03-31",NA,40,0,40,NA,"Yes",NA,NA,25,15
"2512","2017-03-31",1,3,5,8,8,"Yes",4,1,2,1
"2513","2017-03-31",NA,64,0,64,NA,"No",0,0,25,39
"2514","2017-03-31",1,2,6,8,8,"Yes",6,0,1,1
"2515","2017-03-31",3,7,14,21,21,"No",7,7,3,4
"2516","2017-03-31",7,12,6,18,18,"Yes",4,2,6,6
"2517","2017-03-31",4,10,8,18,14,"No",6,2,6,4
"2518","2017-03-31",7,17,7,24,NA,"No",2,5,10,7
"2519","2017-03-31",NA,35,0,35,NA,NA,0,0,15,20
"2520","2017-03-31",3,6,9,15,14,"No",4,5,3,3
"2521","2017-03-31",2,6,3,9,7,"No",1,2,4,2
"2522","2017-03-31",1,4,0,4,4,"Yes",NA,NA,2,2
"2523","2017-03-31",3,6,5,11,8,"Yes",4,1,3,3
"2524","2017-03-31",5,11,6,17,17,"Yes",2,4,4,7
"2525","2017-03-31",3,8,5,13,13,"Yes",3,2,3,5
"2526","2017-03-31",4,13,3,16,16,"Yes",2,1,1,12
"2527","2017-03-31",11,9,3,12,12,"Yes",1,2,3,6
"2528","2017-03-31",3,6,7,13,10,"Yes",2,5,3,3
"2529","2017-03-31",7,11,1,12,12,"Yes",1,0,4,7
"2530","2017-03-31",2,5,2,7,9,"Yes",2,0,4,1
"2531","2017-03-31",1,2,2,4,4,"No",1,1,1,1
"2532","2017-03-31",2,8,6,14,14,"Yes",5,1,3,5
"2533","2017-03-31",2,6,1,7,7,"No",1,0,2,4
"2534","2017-03-31",1,2,2,4,5,"Yes",2,NA,1,1
"2535","2017-03-31",NA,0,0,0,NA,"No",NA,NA,NA,NA
"2536","2017-03-31",3,6,5,11,11,"No",2,3,4,2
"2537","2017-03-31",3,6,10,16,16,"Yes",4,6,3,3
"2538","2017-03-31",4,11,7,18,24,"Yes",3,4,5,6
"2539","2017-03-31",4,0,0,0,NA,"Yes",NA,NA,NA,NA
"2540","2017-03-31",4,6,4,10,10,"Yes",2,2,4,2
"2541","2017-03-31",2,4,5,9,9,"Yes",1,4,2,2
"2542","2017-03-31",5,10,5,15,15,"No",2,3,5,5
"2543","2017-03-31",2,3,5,8,8,"No",1,4,2,1
"2544","2017-03-31",2,4,9,13,13,"No",4,5,2,2
"2545","2017-03-31",2,9,10,19,12,"Yes",5,5,4,5
"2546","2017-03-31",4,8,2,10,10,"Yes",0,2,4,4
"2547","2017-03-31",2,6,4,10,10,"Yes",2,2,3,3
"2548","2017-03-31",3,8,1,9,9,"Yes",0,1,5,3
"2549","2017-03-31",5,10,8,18,20,"Yes",4,4,5,5
"2550","2017-03-31",10,13,7,20,24,"Yes",3,4,8,5
"2551","2017-03-31",1,7,0,7,5,"Yes",0,0,5,2
"2552","2017-03-31",2,6,3,9,9,"No",2,1,1,5
"2553","2017-03-31",5,10,11,21,21,"No",8,3,5,5
"2554","2017-03-31",6,0,0,0,NA,"Yes",NA,NA,NA,NA
"2555","2017-03-31",5,10,10,20,20,"Yes",6,4,4,6
"2556","2017-03-30",1,7,6,13,14,"Yes",3,3,3,4
"2557","2017-03-31",3,10,3,13,13,"Yes",2,1,4,6
"2558","2017-03-31",1,3,1,4,4,"Yes",1,0,0,3
"2559","2017-03-31",7,14,10,24,24,"Yes",6,4,8,6
"2560","2017-03-31",1,4,1,5,5,"Yes",0,1,1,3
"2561","2017-03-31",1,3,3,6,8,"Yes",2,1,1,2
"2562","2017-03-31",2,8,2,10,10,"Yes",1,1,4,4
"2563","2017-03-31",11,14,11,25,25,"No",6,5,8,6
"2564","2017-03-31",2,4,6,10,10,"Yes",3,3,2,2
"2565","2017-03-31",4,10,2,12,12,"Yes",1,1,5,5
"2566","2017-03-31",1,2,3,5,5,"Yes",1,2,1,1
"2567","2017-03-31",11,15,11,26,30,"Yes",5,6,10,5
"2568","2017-03-31",8,9,7,16,16,"Yes",4,3,5,4
"2569","2017-03-31",3,6,8,14,13,"No",2,6,3,3
"2570","2017-03-31",4,7,2,9,9,"Yes",2,NA,4,3
"2571","2017-03-31",3,7,8,15,15,"Yes",5,3,1,6
"2572","2017-03-31",2,5,3,8,8,"No",1,2,3,2
"2573","2017-03-31",1,1,0,1,1,"Yes",NA,NA,1,NA
"2574","2017-03-31",3,8,5,13,13,"Yes",2,3,3,5
"2575","2017-03-31",NA,18,444,462,NA,"No",196,248,11,7
"2576","2017-03-31",1,2,1,3,3,"No",1,NA,1,1
"2577","2017-03-31",3,10,7,17,17,"Yes",3,4,6,4
"2578","2017-03-31",6,10,22,32,31,"Yes",10,12,5,5
"2579","2017-03-31",3,5,9,14,15,"Yes",4,5,1,4
"2580","2017-03-31",2,7,5,12,14,"Yes",4,1,3,4
"2581","2017-03-31",3,5,4,9,9,"Yes",1,3,1,4
"2582","2017-03-31",6,12,12,24,24,"Yes",5,7,6,6
"2583","2017-03-31",1,4,3,7,6,"Yes",2,1,1,3
"2584","2017-03-31",2,5,5,10,10,"Yes",2,3,3,2
"2585","2017-03-31",2,4,5,9,9,"Yes",2,3,2,2
"2586","2017-03-31",1,3,4,7,7,"Yes",2,2,2,1
"2587","2017-03-31",3,7,9,16,16,"Yes",5,4,4,3
"2588","2017-03-31",6,11,8,19,19,"No",3,5,5,6
"2589","2017-03-31",3,7,3,10,10,"Yes",2,1,2,5
"2590","2017-03-31",1,4,3,7,7,"Yes",3,0,1,3
"2591","2017-03-31",1,2,9,11,11,"Yes",4,5,1,1
"2592","2017-03-31",3,6,7,13,13,"Yes",5,2,3,3
"2593","2017-03-31",1,3,3,6,6,"Yes",1,2,1,2
"2594","2017-03-31",3,7,5,12,13,"Yes",3,2,4,3
"2595","2017-03-31",3,5,9,14,14,"No",3,6,2,3
"2596","2017-03-31",2,2,3,5,5,"Yes",1,2,1,1
"2597","2017-03-31",4,10,4,14,14,"Yes",1,3,7,3
"2598","2017-03-31",1,2,9,11,11,"Yes",6,3,1,1
"2599","2017-03-31",1,3,3,6,6,"Yes",2,1,1,2
"2600","2017-03-31",6,16,7,23,21,"No",3,4,7,9
"2601","2017-03-31",3,10,5,15,15,"Yes",5,0,3,7
"2602","2017-03-31",7,13,11,24,24,"No",1,10,6,7
"2603","2017-03-31",8,15,12,27,27,"No",4,8,7,8
"2604","2017-03-31",5,9,8,17,17,"Yes",5,3,4,5
"2605","2017-03-31",9,22,1,23,29,"Yes",1,0,10,12
"2606","2017-03-31",1,3,6,9,8,"Yes",6,0,1,2
"2607","2017-03-31",6,9,7,16,16,"Yes",3,4,6,3
"2608","2017-03-31",7,11,13,24,24,"Yes",4,9,5,6
"2609","2017-03-31",4,13,8,21,20,"Yes",3,5,4,9
"2610","2017-03-31",5,0,0,0,NA,"Yes",NA,NA,NA,NA
"2611","2017-03-31",1,3,2,5,6,"Yes",0,2,2,1
"2612","2017-03-31",5,9,2,11,11,"Yes",2,NA,6,3
"2613","2017-03-31",NA,0,133,133,NA,"Yes",70,63,NA,NA
"2614","2017-03-31",4,0,0,0,NA,"Yes",NA,NA,NA,NA
"2615","2017-03-31",1,1,2,3,3,"No",0,2,0,1
"2616","2017-03-31",3,6,12,18,18,"No",9,3,3,3
"2617","2017-03-31",1,3,14,17,17,"Yes",8,6,2,1
"2618","2017-03-31",2,13,3,16,9,"No",3,0,7,6
"2619","2017-03-31",1,5,4,9,9,"Yes",2,2,1,4
"2620","2017-03-31",7,15,11,26,29,"No",7,4,7,8
"2621","2017-03-31",6,13,5,18,15,"Yes",2,3,5,8
"2622","2017-03-31",4,10,10,20,20,"Yes",6,4,5,5
"2623","2017-03-31",11,60,70,130,130,"Yes",40,30,30,30
"2624","2017-03-31",3,6,11,17,17,"Yes",6,5,3,3
"2625","2017-03-31",3,6,4,10,9,"Yes",1,3,3,3
"2626","2017-03-31",4,4,5,9,9,"Yes",4,1,2,2
"2627","2017-03-31",2,8,0,8,8,"Yes",0,0,4,4
"2628","2017-03-31",6,12,3,15,15,"No",1,2,6,6
"2629","2017-03-31",NA,306,450,756,NA,"No",200,250,156,150
"2630","2017-03-31",3,10,0,10,16,"Yes",0,0,5,5
"2631","2017-03-31",2,4,4,8,8,"Yes",1,3,2,2
"2632","2017-03-31",1,3,5,8,8,"Yes",2,3,2,1
"2633","2017-03-31",4,10,10,20,20,"Yes",5,5,4,6
"2634","2017-03-31",5,10,6,16,15,"Yes",4,2,5,5
"2635","2017-03-31",5,10,3,13,13,"Yes",2,1,5,5
"2636","2017-04-01",5,10,20,30,30,"Yes",8,12,5,5
"2637","2017-04-01",6,15,6,21,NA,"Yes",3,3,10,5
"2638","2017-04-01",4,12,14,26,26,"Yes",6,8,6,6
"2639","2017-04-01",1,3,2,5,5,"Yes",1,1,0,3
"2640","2017-04-01",3,7,3,10,NA,"Yes",1,2,4,3
"2641","2017-04-01",2,4,8,12,12,"Yes",4,4,2,2
"2642","2017-04-01",6,12,30,42,26,"Yes",11,19,6,6
"2643","2017-04-01",4,12,7,19,NA,"Yes",2,5,4,8
"2644","2017-04-01",1,2,5,7,7,"Yes",3,2,1,1
"2645","2017-04-01",3,12,1,13,13,"No",1,0,4,8
"2646","2017-04-01",6,12,6,18,18,"Yes",2,4,6,6
"2647","2017-04-01",6,10,5,15,15,"Yes",1,4,6,4
"2648","2017-04-01",7,20,1,21,NA,"No",1,0,12,8
"2649","2017-04-01",2,4,8,12,12,"No",2,6,2,2
"2650","2017-04-01",5,10,5,15,15,"No",2,3,5,5
"2651","2017-04-01",8,16,20,36,38,"Yes",9,11,8,8
"2652","2017-04-01",4,5,5,10,10,"Yes",3,2,2,3
"2653","2017-04-01",2,4,3,7,7,"Yes",1,2,2,2
"2654","2017-04-01",NA,246,95,341,NA,"Yes",52,43,96,150
"2655","2017-04-01",4,11,9,20,20,"Yes",6,3,5,6
"2656","2017-04-01",2,11,6,17,17,"No",3,3,6,5
"2657","2017-04-01",1,2,2,4,4,"Yes",1,1,0,2
"2658","2017-04-01",4,9,9,18,19,"No",6,3,4,5
"2659","2017-04-01",2,11,6,17,17,"Yes",4,2,5,6
"2660","2017-04-01",14,15,18,33,33,"Yes",10,8,7,8
"2661","2017-04-01",1,3,3,6,6,"Yes",1,2,2,1
"2662","2017-04-01",3,7,0,7,7,"No",NA,NA,5,2
"2663","2017-04-01",10,15,2,17,16,"Yes",0,2,6,9
"2664","2017-04-01",4,8,13,21,21,"No",8,5,4,4
"2665","2017-04-01",3,6,8,14,14,"Yes",3,5,2,4
"2666","2017-04-01",3,6,8,14,14,"Yes",3,5,3,3
"2667","2017-04-01",8,13,4,17,17,"No",4,NA,7,6
"2668","2017-04-01",2,4,1,5,5,"Yes",1,0,2,2
"2669","2017-04-01",1,4,5,9,9,"Yes",2,3,2,2
"2670","2017-04-01",1,7,2,9,10,"Yes",1,1,4,3
"2671","2017-04-01",2,13,3,16,NA,"No",1,2,7,6
"2672","2017-04-01",1,2,0,2,2,"No",0,0,2,0
"2673","2017-04-01",4,8,4,12,12,"No",1,3,4,4
"2674","2017-04-01",2,12,4,16,16,"No",2,2,2,10
"2675","2017-04-01",2,7,3,10,10,"Yes",2,1,4,3
"2676","2017-04-01",3,7,7,14,14,"Yes",3,4,3,4
"2677","2017-04-01",1,1,1,2,2,"Yes",1,0,1,0
"2678","2017-04-01",1,3,3,6,6,"Yes",0,3,1,2
"2679","2017-04-01",2,7,4,11,13,"Yes",3,1,4,3
"2680","2017-04-01",5,5,3,8,8,"Yes",1,2,2,3
"2681","2017-04-01",6,11,11,22,23,"No",7,4,4,7
"2682","2017-04-01",4,8,2,10,9,"No",2,0,4,4
"2683","2017-04-01",5,8,10,18,18,"No",6,4,4,4
"2684","2017-04-01",2,9,10,19,19,"Yes",5,5,4,5
"2685","2017-04-01",2,4,1,5,5,"No",1,NA,2,2
"2686","2017-04-01",3,6,6,12,12,"Yes",2,4,3,3
"2687","2017-04-01",NA,0,0,0,NA,"Yes",NA,NA,NA,NA
"2688","2017-04-01",4,8,6,14,14,"Yes",0,6,5,3
"2689","2017-04-01",1,7,2,9,8,"Yes",0,2,2,5
"2690","2017-04-01",4,7,14,21,21,"No",7,7,3,4
"2691","2017-04-01",4,12,7,19,19,"No",3,4,8,4
"2692","2017-04-01",7,10,8,18,18,"Yes",3,5,5,5
"2693","2017-04-01",3,16,12,28,28,NA,4,8,8,8
"2694",NA,4,4,2,6,14,"Yes",0,2,2,2
"2695","2017-04-01",3,9,1,10,15,"Yes",NA,1,4,5
"2696","2017-04-01",3,5,8,13,13,"No",2,6,3,2
"2697","2017-04-01",4,12,2,14,16,"Yes",2,0,4,8
"2698","2017-04-01",4,10,11,21,21,"No",6,5,5,5
"2699","2017-04-01",4,10,2,12,12,"No",1,1,6,4
"2700","2017-04-01",6,8,2,10,11,"Yes",0,2,5,3
"2701","2017-04-01",6,12,7,19,25,"No",3,4,6,6
"2702","2017-04-01",1,3,12,15,15,"Yes",5,7,2,1
"2703","2017-04-01",NA,7,315,322,NA,"Yes",135,180,4,3
"2704","2017-04-01",2,4,2,6,6,"Yes",2,0,3,1
"2705","2017-04-01",4,10,16,26,28,"No",8,8,5,5
"2706","2017-04-01",4,7,10,17,17,"Yes",4,6,5,2
"2707","2017-04-01",4,8,7,15,15,"Yes",2,5,3,5
"2708","2017-04-01",5,14,9,23,NA,"Yes",3,6,8,6
"2709","2017-04-01",4,11,3,14,14,"Yes",2,1,5,6
"2710","2017-04-01",3,6,8,14,14,"Yes",4,4,3,3
"2711",NA,6,0,0,0,NA,"No",NA,NA,NA,NA
"2712","2017-04-01",2,8,4,12,12,"No",2,2,4,4
"2713","2017-04-01",6,13,10,23,24,"Yes",4,6,7,6
"2714","2017-04-01",2,11,5,16,16,"Yes",0,5,6,5
"2715","2017-04-01",4,10,7,17,17,"Yes",3,4,6,4
"2716","2017-04-01",6,12,12,24,24,"No",7,5,6,6
"2717","2017-04-01",3,8,10,18,18,"No",4,6,5,3
"2718","2017-04-01",NA,15,0,15,NA,"No",NA,NA,2,13
"2719","2017-04-01",4,8,13,21,21,"Yes",9,4,4,4
"2720","2017-04-01",6,13,7,20,NA,"No",2,5,6,7
"2721","2017-04-01",4,10,3,13,11,"Yes",3,0,5,5
"2722","2017-04-01",6,9,3,12,12,"Yes",2,1,4,5
"2723","2017-04-01",3,8,13,21,21,"Yes",7,6,4,4
"2724","2017-04-01",3,9,4,13,15,"Yes",2,2,5,4
"2725","2017-04-01",4,25,2,27,15,"Yes",1,1,12,13
"2726","2017-04-01",2,4,4,8,8,"Yes",2,2,1,3
"2727","2017-04-01",2,10,10,20,20,"Yes",6,4,5,5
"2728","2017-04-01",2,4,2,6,6,"No",2,0,2,2
"2729","2017-04-01",1,5,2,7,7,"Yes",2,0,2,3
"2730","2017-04-01",6,17,13,30,30,"No",3,10,8,9
"2731","2017-04-01",3,10,6,16,17,"Yes",4,2,4,6
"2732","2017-04-01",3,7,5,12,14,"Yes",2,3,3,4
"2733","2017-04-01",1,2,4,6,6,"Yes",2,2,1,1
"2734","2017-04-01",10,19,14,33,33,"Yes",6,8,9,10
"2735","2017-04-01",3,8,12,20,11,"Yes",8,4,2,6
"2736","2017-04-01",4,11,14,25,25,"No",5,9,5,6
"2737","2017-04-01",3,10,6,16,18,"Yes",5,1,3,7
"2738","2017-04-01",1,4,5,9,9,"Yes",3,2,1,3
"2739","2017-04-01",6,12,6,18,NA,"Yes",4,2,7,5
"2740","2017-04-01",4,7,9,16,16,"No",3,6,2,5
"2741","2017-03-01",2,4,3,7,7,"Yes",1,2,1,3
"2742","2017-04-01",3,6,6,12,12,"No",2,4,3,3
"2743","2017-04-01",9,0,0,0,NA,"Yes",NA,NA,NA,NA
"2744","2017-04-01",12,18,9,27,32,"No",4,5,9,9
"2745","2017-04-01",10,25,25,50,54,"No",10,15,15,10
"2746","2017-04-01",2,7,6,13,13,"Yes",2,4,3,4
"2747","2017-04-01",5,15,5,20,20,"Yes",3,2,10,5
"2748","2017-04-01",7,20,6,26,NA,"Yes",4,2,12,8
"2749","2017-04-01",2,4,16,20,20,"Yes",8,8,0,4
"2750","2017-04-01",1,2,4,6,6,"No",3,1,1,1
"2751","2017-04-01",2,2,0,2,2,"Yes",NA,NA,2,NA
"2752","2017-04-01",2,6,8,14,14,"Yes",4,4,2,4
"2753","2017-04-01",3,9,4,13,13,"Yes",1,3,3,6
"2754","2017-04-01",1,3,3,6,6,"Yes",2,1,2,1
"2755","2017-04-01",4,10,6,16,19,"Yes",4,2,6,4
"2756","2017-04-01",NA,0,0,0,NA,"Yes",NA,NA,NA,NA
"2757","2017-04-01",2,4,2,6,6,"No",2,NA,2,2
"2758","2017-04-01",1,7,0,7,7,"Yes",0,0,6,1
"2759","2017-04-01",2,6,6,12,12,"Yes",5,1,2,4
"2760","2017-04-01",4,8,0,8,8,"No",NA,NA,4,4
"2761","2017-04-01",3,8,8,16,16,"Yes",4,4,6,2
"2762","2017-04-01",4,13,7,20,23,"No",4,3,4,9
"2763","2017-04-01",5,7,7,14,14,"No",3,4,4,3
"2764","2017-04-01",5,0,7,7,NA,"Yes",4,3,NA,NA
"2765","2017-04-01",1,7,6,13,12,"Yes",4,2,4,3
"2766","2017-04-01",2,3,3,6,5,"Yes",3,0,1,2
"2767","2017-04-01",6,11,6,17,17,"Yes",2,4,5,6
"2768","2017-04-01",3,6,2,8,9,"Yes",2,0,3,3
"2769","2017-04-01",5,12,13,25,25,"Yes",7,6,7,5
"2770","2017-04-01",3,9,10,19,18,"No",5,5,5,4
"2771","2017-04-01",4,9,11,20,20,"Yes",5,6,4,5
"2772","2017-04-01",3,6,0,6,6,"No",NA,NA,6,NA
"2773","2017-04-01",1,2,5,7,8,"Yes",3,2,1,1
"2774","2017-04-01",3,11,3,14,13,"Yes",0,3,6,5
"2775","2017-04-01",3,8,10,18,18,"Yes",8,2,5,3
"2776","2017-04-01",1,2,3,5,5,"Yes",1,2,1,1
"2777","2017-04-01",3,6,2,8,6,"Yes",2,0,3,3
"2778","2017-04-01",5,9,11,20,20,"Yes",5,6,4,5
"2779","2017-04-01",6,10,3,13,13,"No",2,1,4,6
"2780","2017-04-01",5,13,5,18,NA,"Yes",2,3,8,5
"2781","2017-04-01",1,3,4,7,7,"Yes",2,2,1,2
"2782","2017-04-01",10,12,6,18,18,"Yes",2,4,6,6
"2783","2017-04-01",7,22,8,30,30,"No",4,4,10,12
"2784","2017-04-01",10,15,9,24,16,"No",5,4,9,6
"2785","2017-04-01",4,8,5,13,13,"No",3,2,4,4
"2786","2017-04-01",1,2,2,4,4,NA,0,2,1,1
"2787","2017-04-01",4,10,6,16,19,"Yes",4,2,4,6
"2788","2017-04-01",2,8,4,12,12,"Yes",2,2,3,5
"2789","2017-04-01",3,6,5,11,11,"Yes",5,0,3,3
"2790","2017-04-01",8,20,15,35,35,"Yes",5,10,10,10
"2791","2017-04-01",2,4,6,10,10,"Yes",3,3,2,2
"2792","2017-04-01",2,4,4,8,8,"Yes",0,4,2,2
"2793","2017-04-01",5,11,9,20,21,"Yes",4,5,5,6
"2794","2017-04-01",4,6,9,15,15,"Yes",4,5,3,3
"2795","2017-04-01",2,3,5,8,9,"Yes",2,3,2,1
"2796","2017-04-01",5,11,7,18,16,"No",2,5,6,5
"2797","2017-04-01",1,3,5,8,8,"Yes",3,2,1,2
"2798","2017-04-01",3,8,5,13,14,"No",3,2,2,6
"2799","2017-04-01",3,10,9,19,19,"Yes",3,6,4,6
"2800","2017-04-01",3,5,11,16,16,"Yes",7,4,2,3
"2801","2017-04-01",2,6,5,11,11,"Yes",4,1,2,4
"2802","2017-04-01",6,12,8,20,18,"Yes",4,4,6,6
"2803","2017-04-01",1,2,2,4,4,"Yes",2,0,1,1
"2804","2017-04-01",4,9,3,12,13,"Yes",2,1,4,5
"2805","2017-04-01",2,4,14,18,15,"No",8,6,2,2
"2806","2017-04-01",2,4,7,11,11,"No",3,4,2,2
"2807","2017-04-01",3,6,6,12,12,"No",4,2,2,4
"2808","2017-04-01",6,10,10,20,25,"Yes",7,3,6,4
"2809","2017-04-01",3,4,9,13,13,"Yes",4,5,3,1
"2810","2017-04-01",2,7,3,10,11,"Yes",2,1,2,5
"2811","2017-04-01",1,2,5,7,7,"Yes",2,3,1,1
"2812","2017-04-01",5,10,0,10,12,"Yes",0,0,4,6
"2813","2017-04-01",4,6,4,10,10,"Yes",1,3,4,2
"2814","2017-04-01",4,9,11,20,26,"No",6,5,4,5
"2815","2017-04-01",1,2,2,4,4,"Yes",1,1,1,1
"2816","2017-04-01",3,6,5,11,11,"Yes",2,3,3,3
"2817","2017-04-01",3,10,5,15,15,"Yes",3,2,6,4
"2818","2017-04-01",2,7,5,12,12,"No",2,3,4,3
"2819","2017-04-01",7,18,7,25,NA,"Yes",4,3,10,8
"2820",NA,3,2,4,6,6,"No",2,2,1,1
"2821","2017-04-01",3,7,9,16,16,"Yes",3,6,4,3
"2822","2017-04-01",6,28,13,41,39,"Yes",5,8,12,16
"2823","2017-04-01",3,10,3,13,11,"Yes",1,2,2,8
"2824","2017-04-01",5,10,7,17,15,"Yes",5,2,3,7
"2825","2017-04-01",4,14,6,20,17,"Yes",3,3,6,8
"2826","2017-04-01",4,8,4,12,12,"Yes",1,3,4,4
"2827","2017-03-31",4,8,8,16,25,"Yes",4,4,4,4
"2828","2017-04-01",2,6,3,9,9,"Yes",2,1,3,3
"2829","2017-04-01",4,20,2,22,NA,"Yes",2,0,12,8
"2830","2017-04-01",4,8,10,18,18,"Yes",4,6,4,4
"2831","2017-04-01",2,4,7,11,10,"No",5,2,2,2
"2832","2017-04-01",NA,8,8,16,16,"No",5,3,4,4
"2833","2017-04-01",7,20,7,27,27,"Yes",4,3,13,7
"2834","2017-04-01",9,16,18,34,35,"No",7,11,5,11
"2835","2017-04-01",1,6,0,6,6,"Yes",NA,NA,2,4
"2836","2017-04-01",1,3,3,6,6,"Yes",2,1,1,2
"2837","2017-04-01",3,7,3,10,10,"No",2,1,1,6
"2838","2017-04-01",6,13,11,24,24,"Yes",4,7,5,8
"2839","2017-04-01",5,10,11,21,22,"Yes",4,7,6,4
"2840","2017-04-01",1,5,0,5,5,"Yes",0,0,2,3
"2841","2017-04-01",11,14,8,22,22,"No",5,3,7,7
"2842","2017-04-01",4,11,10,21,21,"Yes",4,6,4,7
"2843","2017-04-01",1,1,0,1,1,"Yes",0,0,0,1
"2844","2017-04-01",3,4,3,7,7,"Yes",NA,3,2,2
"2845","2017-04-01",4,10,6,16,16,"Yes",4,2,2,8
"2846","2017-04-01",2,4,5,9,9,"No",4,1,2,2
"2847","2017-04-01",3,5,8,13,13,"No",4,4,2,3
"2848","2017-04-01",5,12,9,21,26,"No",5,4,6,6
"2849","2017-04-01",3,10,3,13,13,"Yes",1,2,8,2
"2850","2017-04-01",1,2,5,7,7,"Yes",4,1,1,1
"2851","2017-04-01",3,4,2,6,6,"Yes",2,0,2,2
"2852","2017-04-01",4,0,0,0,NA,"Yes",NA,NA,NA,NA
"2853","2017-04-01",6,7,6,13,17,"Yes",4,2,0,7
"2854","2017-03-31",2,6,6,12,17,"Yes",2,4,1,5
"2855","2017-04-01",2,4,4,8,8,"Yes",2,2,2,2
"2856","2017-04-01",3,6,3,9,9,"Yes",1,2,3,3
"2857","2017-04-01",1,2,4,6,6,"Yes",3,1,1,1
"2858","2017-04-01",7,13,17,30,30,"No",8,9,6,7
"2859","2017-04-01",5,10,13,23,23,"Yes",2,11,5,5
"2860","2017-04-01",1,2,8,10,10,"Yes",4,4,1,1
"2861","2017-04-01",3,5,9,14,14,"Yes",4,5,2,3
"2862","2017-04-01",9,12,5,17,23,"No",2,3,5,7
"2863","2017-04-01",3,6,7,13,13,"Yes",3,4,3,3
"2864","2017-04-01",4,18,12,30,30,"No",8,4,10,8
"2865","2017-04-01",1,2,3,5,5,"Yes",1,2,1,1
"2866","2017-04-01",4,5,5,10,10,"Yes",2,3,3,2
"2867","2017-04-01",4,8,7,15,NA,"No",2,5,4,4
"2868","2017-04-01",3,6,3,9,9,"No",2,1,3,3
"2869","2017-04-01",4,7,6,13,20,"Yes",3,3,4,3
"2870","2017-04-01",1,7,4,11,10,"Yes",3,1,3,4
"2871","2017-04-01",5,10,15,25,25,"Yes",8,7,5,5
"2872","2017-04-01",1,4,3,7,7,"Yes",2,1,2,2
"2873","2017-04-01",2,10,10,20,16,"Yes",3,7,3,7
"2874","2017-04-01",8,17,9,26,26,"No",4,5,9,8
"2875","2017-04-01",2,5,9,14,10,"Yes",4,5,2,3
"2876","2017-04-01",6,11,6,17,16,"Yes",2,4,5,6
"2877","2017-04-01",4,5,3,8,15,"Yes",0,3,2,3
"2878","2017-04-01",3,7,5,12,12,"Yes",3,2,4,3
"2879","2017-04-03",2,6,4,10,10,"Yes",3,1,3,3
"2880","2017-04-03",2,10,5,15,15,NA,2,3,6,4
"2881","2017-04-03",4,9,3,12,12,"Yes",1,2,4,5
"2882","2017-04-03",6,14,7,21,13,"No",4,3,6,8
"2883","2017-04-03",4,8,4,12,11,"Yes",3,1,2,6
"2884","2017-04-03",6,0,0,0,NA,"Yes",NA,NA,NA,NA
"2885","2017-04-03",6,12,9,21,21,"No",5,4,6,6
"2886","2017-04-03",4,10,8,18,18,"No",5,3,4,6
"2887","2017-04-03",7,15,3,18,NA,"No",0,3,7,8
"2888","2017-04-03",8,17,10,27,30,"No",4,6,9,8
"2889","2017-04-03",1,3,2,5,5,"Yes",1,1,1,2
"2890","2017-04-03",3,6,7,13,13,"Yes",3,4,3,3
"2891","2017-04-03",4,8,14,22,22,"No",6,8,4,4
"2892","2017-04-03",3,9,0,9,15,"Yes",NA,NA,5,4
"2893","2017-04-03",4,10,5,15,15,"No",3,2,4,6
"2894","2017-04-03",4,8,1,9,9,"Yes",0,1,4,4
"2895","2017-04-03",4,10,6,16,16,"Yes",2,4,5,5
"2896","2017-04-03",1,2,6,8,8,"No",2,4,1,1
"2897","2017-04-03",3,7,4,11,11,"Yes",1,3,4,3
"2898","2017-04-03",4,8,10,18,18,"Yes",5,5,4,4
"2899","2017-04-03",3,7,4,11,11,"Yes",2,2,3,4
"2900","2017-04-03",1,4,7,11,11,"Yes",4,3,3,1
"2901","2017-04-03",5,10,6,16,16,"Yes",2,4,5,5
"2902","2017-04-10",5,7,3,10,14,NA,1,2,3,4
"2903","2017-04-03",1,7,2,9,9,"Yes",1,1,6,1
"2904","2017-04-03",3,6,0,6,6,"Yes",0,0,3,3
"2905","2017-04-03",1,2,1,3,3,"Yes",1,0,1,1
"2906","2017-04-03",3,6,11,17,17,"Yes",5,6,3,3
"2907","2017-04-03",6,15,20,35,40,"No",10,10,7,8
"2908","2017-04-03",5,0,0,0,NA,"Yes",NA,NA,NA,NA
"2909","2017-04-03",2,4,1,5,5,"Yes",0,1,2,2
"2910","2017-04-03",10,12,5,17,16,"Yes",2,3,6,6
"2911","2017-04-03",5,14,10,24,30,"No",6,4,6,8
"2912","2017-04-03",6,10,5,15,15,"Yes",2,3,5,5
"2913","2017-04-03",4,8,2,10,10,"Yes",1,1,4,4
"2914","2017-04-03",7,25,15,40,42,"No",5,10,7,18
"2915","2017-04-03",1,6,3,9,10,"Yes",3,NA,4,2
"2916","2017-04-03",5,14,9,23,23,"Yes",5,4,8,6
"2917","2017-04-03",7,15,6,21,NA,"Yes",2,4,7,8
"2918","2017-04-03",1,3,4,7,7,"Yes",2,2,1,2
"2919","2017-04-03",5,10,4,14,14,"Yes",4,0,5,5
"2920","2017-04-03",2,9,4,13,13,"Yes",0,4,5,4
"2921","2017-04-03",6,10,8,18,18,"Yes",4,4,4,6
"2922","2017-04-03",3,5,6,11,12,"Yes",5,1,2,3
"2923","2017-04-03",4,8,1,9,9,"Yes",0,1,4,4
"2924","2017-04-03",3,5,8,13,13,"No",3,5,3,2
"2925","2017-04-03",5,13,15,28,28,NA,9,6,5,8
"2926","2017-04-10",3,6,3,9,9,"Yes",1,2,3,3
"2927","2017-04-03",NA,46,17,63,NA,"Yes",8,9,21,25
"2928","2017-04-03",4,6,7,13,NA,"Yes",5,2,6,NA
"2929","2017-04-03",9,19,11,30,30,"No",5,6,9,10
"2930","2017-04-03",NA,12,774,786,NA,"Yes",360,414,4,8
"2931","2017-04-03",4,11,5,16,17,"Yes",1,4,4,7
"2932","2017-04-03",8,8,8,16,16,"No",4,4,4,4
"2933","2017-04-03",3,6,9,15,15,"No",5,4,3,3
"2934","2017-04-03",4,9,4,13,16,"No",1,3,5,4
"2935","2017-04-03",8,16,4,20,20,"Yes",1,3,8,8
"2936","2017-04-03",4,7,4,11,11,"Yes",3,1,3,4
"2937","2017-04-03",4,10,5,15,13,"No",3,2,6,4
"2938","2017-04-03",NA,150,60,210,NA,"Yes",20,40,80,70
"2939","2017-04-03",11,10,11,21,21,"Yes",4,7,4,6
"2940","2017-04-03",5,4,2,6,8,"No",2,0,1,3
"2941","2017-04-03",6,10,8,18,18,"Yes",3,5,2,8
"2942","2017-04-03",6,10,9,19,19,"Yes",4,5,5,5
"2943","2017-04-03",5,8,4,12,14,"Yes",3,1,4,4
"2944","2017-04-03",4,15,13,28,28,"Yes",4,9,7,8
"2945","2017-04-03",1,2,1,3,3,"No",1,0,1,1
"2946","2017-04-03",2,3,4,7,10,"Yes",2,2,1,2
"2947","2017-04-03",3,6,9,15,12,"Yes",3,6,3,3
"2948","2017-04-03",7,14,11,25,NA,"No",2,9,7,7
"2949","2017-04-03",2,8,4,12,12,"Yes",3,1,5,3
"2950","2017-04-03",1,4,1,5,5,"Yes",0,1,1,3
"2951","2017-04-03",11,23,11,34,NA,"Yes",5,6,12,11
"2952",NA,2,4,6,10,10,"Yes",3,3,2,2
"2953","2017-04-03",NA,65,5974,6039,NA,"No",2971,3003,6,59
"2954","2017-04-03",1,5,4,9,8,"Yes",1,3,3,2
"2955","2017-04-03",1,5,3,8,8,"Yes",1,2,1,4
"2956","2017-04-03",1,8,4,12,10,"No",3,1,4,4
"2957","2017-04-03",1,4,0,4,4,"No",0,0,3,1
"2958","2017-04-03",7,14,6,20,20,"No",2,4,7,7
"2959","2017-04-03",1,2,6,8,8,"Yes",4,2,1,1
"2960","2017-04-03",3,6,2,8,9,"Yes",2,0,3,3
"2961","2017-04-03",5,8,9,17,17,"No",3,6,5,3
"2962","2017-04-03",1,9,3,12,12,"Yes",NA,3,5,4
"2963","2017-04-03",3,6,9,15,15,"No",4,5,3,3
"2964","2017-04-03",11,21,9,30,35,"Yes",3,6,10,11
"2965","2017-04-03",4,8,13,21,26,"Yes",9,4,4,4
"2966","2017-04-03",3,6,4,10,10,"Yes",3,1,3,3
"2967","2017-04-03",1,1,0,1,1,"Yes",0,0,0,1
"2968","2017-04-03",3,5,15,20,20,"No",6,9,2,3
"2969","2017-04-03",9,16,2,18,24,"Yes",1,1,8,8
"2970","2017-04-03",5,19,17,36,36,"No",9,8,8,11
"2971","2017-04-03",3,8,7,15,15,"Yes",3,4,4,4
"2972","2017-04-03",4,7,7,14,14,"Yes",5,2,3,4
"2973","2017-04-03",1,5,10,15,15,"Yes",4,6,3,2
"2974","2017-04-03",1,7,2,9,9,"Yes",1,1,4,3
"2975","2017-04-03",3,6,3,9,9,"Yes",1,2,3,3
"2976","2017-04-03",5,10,14,24,24,"Yes",6,8,5,5
"2977","2017-04-03",1,2,2,4,4,"No",1,1,1,1
"2978","2017-04-10",19,9,9,18,2,"No",5,4,4,5
"2979","2017-04-03",5,13,6,19,19,"No",4,2,8,5
"2980","2017-04-03",5,13,12,25,25,"No",5,7,8,5
"2981","2017-04-03",2,4,4,8,7,"No",3,1,2,2
"2982","2017-04-03",1,6,6,12,12,"No",4,2,2,4
"2983","2017-04-03",1,3,4,7,7,"Yes",1,3,2,1
"2984","2017-04-03",7,12,13,25,25,"No",7,6,5,7
"2985","2017-04-03",4,8,8,16,14,"No",4,4,4,4
"2986","2017-04-03",3,6,2,8,8,"No",1,1,3,3
"2987",NA,2,8,2,10,10,"Yes",0,2,4,4
"2988","2017-04-03",1,7,0,7,7,"Yes",0,0,3,4
"2989","2017-04-03",4,8,8,16,14,"Yes",1,7,4,4
"2990","2017-04-03",2,4,5,9,7,"Yes",2,3,2,2
"2991","2017-04-03",3,9,5,14,15,"Yes",2,3,4,5
"2992","2017-04-03",2,3,5,8,8,"Yes",3,2,1,2
"2993","2017-04-03",7,20,19,39,40,"Yes",6,13,9,11
"2994","2017-04-03",3,7,5,12,7,"Yes",0,5,5,2
"2995","2017-04-03",5,10,10,20,20,"Yes",4,6,7,3
"2996","2017-04-03",3,6,7,13,7,"Yes",2,5,3,3
"2997","2017-04-03",2,8,8,16,16,"Yes",5,3,4,4
"2998","2017-04-03",3,4,2,6,7,"No",1,1,3,1
"2999","2017-04-03",9,22,5,27,NA,"Yes",2,3,11,11
"3000","2017-04-03",2,2,3,5,5,"No",1,2,1,1
"3001","2017-04-03",5,0,0,0,NA,NA,NA,NA,NA,NA
"3002","2017-04-03",5,9,6,15,15,"Yes",0,6,4,5
"3003","2017-04-03",1,1,0,1,1,"Yes",0,0,1,0
"3004","2017-04-03",2,6,1,7,7,"No",1,0,3,3
"3005","2017-04-03",6,12,14,26,26,"No",6,8,6,6
"3006","2017-04-03",3,4,7,11,11,"Yes",4,3,1,3
"3007","2017-04-03",1,5,6,11,8,"Yes",2,4,1,4
"3008","2017-04-03",5,4,1,5,25,"No",1,0,2,2
"3009","2017-04-03",4,9,5,14,14,"No",2,3,4,5
"3010","2017-04-03",2,4,5,9,10,"Yes",1,4,2,2
"3011","2017-04-03",1,4,1,5,5,"Yes",1,0,2,2
"3012","2017-04-03",2,4,0,4,12,"Yes",NA,NA,2,2
"3013","2017-04-03",4,10,11,21,21,"No",6,5,5,5
"3014","2017-04-03",5,14,4,18,15,"Yes",1,3,8,6
"3015","2017-04-03",4,8,3,11,11,"Yes",2,1,3,5
"3016","2017-04-03",6,17,19,36,27,"No",8,11,12,5
"3017","2017-04-03",4,8,2,10,9,"No",0,2,5,3
"3018","2017-04-03",1,1,4,5,3,"Yes",2,2,NA,1
"3019","2017-04-03",4,7,8,15,16,"No",5,3,4,3
"3020","2017-04-03",5,10,10,20,20,"No",4,6,4,6
"3021","2017-04-03",1,4,11,15,12,"Yes",7,4,0,4
"3022","2017-04-03",4,10,5,15,15,"Yes",2,3,5,5
"3023","2017-04-03",1,4,3,7,7,NA,1,2,1,3
"3024",NA,3,5,5,10,10,"Yes",3,2,2,3
"3025","2017-04-03",5,11,19,30,30,"Yes",9,10,5,6
"3026","2017-04-03",3,6,9,15,15,"Yes",4,5,3,3
"3027","2017-04-01",2,12,2,14,13,"Yes",2,0,7,5
"3028","2017-04-03",1,5,2,7,7,"Yes",1,1,1,4
"3029","2017-04-03",2,3,0,3,3,"No",0,0,2,1
"3030","2017-04-03",5,14,8,22,21,"No",5,3,5,9
"3031","2017-04-03",1,4,1,5,5,"No",0,1,3,1
"3032","2017-04-03",4,8,7,15,15,"Yes",3,4,4,4
"3033","2017-04-03",1,2,5,7,4,"No",2,3,1,1
"3034","2017-04-03",3,0,0,0,10,"Yes",NA,NA,NA,NA
"3035","2017-04-03",1,3,2,5,5,"No",1,1,1,2
"3036","2017-04-03",5,10,9,19,25,"No",6,3,5,5
"3037","2017-04-03",1,6,4,10,10,"Yes",2,2,3,3
"3038","2017-04-03",7,10,10,20,20,"Yes",3,7,4,6
"3039","2017-04-03",4,9,5,14,16,"Yes",3,2,4,5
"3040","2017-04-03",3,6,4,10,10,"No",4,0,3,3
"3041","2017-04-03",3,7,7,14,14,"Yes",5,2,3,4
"3042","2017-04-03",4,10,3,13,17,"Yes",1,2,4,6
"3043","2017-04-03",1,1,4,5,5,"Yes",3,1,1,NA
"3044","2017-04-03",2,5,4,9,8,"Yes",2,2,4,1
"3045","2017-04-03",1,2,3,5,5,"Yes",2,1,1,1
"3046","2017-04-03",3,4,5,9,9,"Yes",3,2,2,2
"3047","2017-04-03",3,8,13,21,17,"No",11,2,4,4
"3048","2017-04-03",3,4,6,10,10,"Yes",3,3,2,2
"3049","2017-04-03",2,1,4,5,5,"Yes",4,0,1,0
"3050","2017-04-03",1,4,3,7,8,"Yes",1,2,2,2
"3051","2017-04-03",2,7,6,13,11,"No",3,3,4,3
"3052","2017-04-03",2,12,5,17,17,"Yes",2,3,9,3
"3053","2017-04-03",1,2,5,7,7,"Yes",1,4,NA,2
"3054","2017-04-03",5,10,8,18,16,"Yes",3,5,5,5
"3055","2017-04-03",1,2,1,3,3,"No",1,0,1,1
"3056","2017-04-03",4,9,3,12,12,"Yes",1,2,4,5
"3057","2017-04-03",7,12,6,18,23,"Yes",3,3,4,8
"3058","2017-04-03",8,14,6,20,20,"Yes",2,4,8,6
"3059","2017-04-03",1,6,3,9,9,"Yes",NA,3,3,3
"3060","2017-04-03",1,2,5,7,7,"Yes",3,2,1,1
"3061","2017-04-03",2,4,7,11,11,"Yes",5,2,2,2
"3062",NA,3,6,9,15,21,"Yes",4,5,3,3
"3063","2017-04-03",5,11,6,17,15,"Yes",4,2,5,6
"3064","2017-04-03",4,6,4,10,10,"Yes",1,3,3,3
"3065","2017-04-03",8,20,10,30,30,"Yes",6,4,8,12
"3066","2017-04-03",6,11,2,13,13,"Yes",1,1,5,6
"3067","2017-04-03",2,6,16,22,18,"No",9,7,3,3
"3068","2017-04-03",2,4,4,8,7,"No",1,3,2,2
"3069","2017-04-03",1,2,2,4,4,"Yes",1,1,1,1
"3070","2017-04-03",2,5,7,12,12,"No",3,4,4,1
"3071","2017-04-03",6,17,14,31,25,"Yes",7,7,12,5
"3072","2017-04-03",2,12,4,16,16,"Yes",3,1,5,7
"3073","2017-04-03",9,13,5,18,18,"Yes",2,3,6,7
"3074","2017-04-03",13,23,10,33,32,"No",5,5,13,10
"3075","2017-04-03",3,10,4,14,14,"Yes",3,1,8,2
"3076","2017-04-03",5,9,2,11,11,"No",1,1,5,4
"3077","2017-04-03",1,2,0,2,2,"Yes",NA,NA,1,1
"3078","2017-04-03",3,12,8,20,NA,"Yes",5,3,4,8
"3079","2017-04-03",1,352,1,353,6,"Yes",0,1,2,350
"3080","2017-04-03",4,8,3,11,13,"No",3,0,4,4
"3081","2017-04-03",4,11,9,20,20,"No",4,5,7,4
"3082","2017-04-03",2,4,1,5,5,"Yes",1,0,2,2
"3083","2017-04-03",1,4,4,8,8,"Yes",1,3,2,2
"3084","2017-04-03",8,12,3,15,18,"No",0,3,7,5
"3085","2017-04-03",1,2,5,7,7,"Yes",1,4,1,1
"3086","2017-04-03",3,6,4,10,10,"Yes",2,2,3,3
"3087","2017-04-03",2,7,2,9,9,"Yes",0,2,3,4
"3088","2017-04-03",2,6,7,13,13,"Yes",3,4,2,4
"3089","2017-04-03",3,6,11,17,17,"No",4,7,4,2
"3090","2017-04-03",6,7,9,16,16,"No",7,2,2,5
"3091",NA,7,14,10,24,35,"No",3,7,7,7
"3092","2017-04-03",5,8,5,13,14,"Yes",2,3,4,4
"3093","2017-04-03",2,4,1,5,5,"No",NA,1,2,2
"3094","2017-04-03",2,2,5,7,7,"Yes",2,3,1,1
"3095","2017-04-03",2,4,0,4,4,"No",NA,NA,2,2
"3096","2017-04-03",3,6,10,16,16,"Yes",4,6,3,3
"3097","2017-04-03",9,11,5,16,16,"No",3,2,5,6
"3098","2017-04-03",7,16,14,30,30,"Yes",4,10,8,8
"3099","2017-04-03",10,13,2,15,15,"Yes",2,0,10,3
"3100","2017-04-03",1,3,3,6,6,"Yes",2,1,2,1
"3101","2017-04-03",4,20,10,30,32,"No",6,4,6,14
"3102","2017-04-03",NA,16,13,29,NA,"No",6,7,8,8
"3103","2017-04-03",1,2,7,9,9,"Yes",4,3,1,1
"3104","2017-04-03",6,15,13,28,28,"No",5,8,9,6
"3105","2017-04-03",9,16,17,33,33,"Yes",4,13,7,9
"3106","2017-04-03",1,2,4,6,6,"Yes",2,2,1,1
"3107","2017-04-03",4,13,5,18,18,"Yes",2,3,8,5
"3108","2017-04-03",6,10,7,17,17,"Yes",2,5,4,6
"3109","2017-04-03",2,4,6,10,12,"Yes",3,3,2,2
"3110","2017-04-03",1,2,3,5,5,"Yes",1,2,1,1
"3111","2017-04-03",2,4,3,7,7,"No",1,2,2,2
"3112","2017-04-03",4,8,8,16,16,"No",3,5,4,4
"3113","2017-04-03",8,16,6,22,22,"Yes",2,4,8,8
"3114","2017-04-03",5,9,1,10,10,"Yes",1,0,4,5
"3115","2017-04-03",1,5,2,7,7,"No",2,NA,3,2
"3116","2017-04-03",3,10,4,14,NA,"Yes",2,2,3,7
"3117","2017-04-03",2,6,0,6,6,"Yes",0,0,2,4
"3118","2017-04-03",4,0,0,0,NA,"No",NA,NA,NA,NA
"3119","2017-04-03",1,3,4,7,7,"No",3,1,2,1
"3120","2017-04-03",3,6,1,7,7,"Yes",1,NA,2,4
"3121","2017-04-03",2,4,3,7,7,"Yes",2,1,1,3
"3122","2017-04-03",6,21,5,26,31,"Yes",3,2,10,11
"3123","2017-04-03",3,5,9,14,14,"Yes",3,6,3,2
"3124","2017-04-03",7,10,13,23,23,"Yes",4,9,4,6
"3125","2017-04-03",3,6,6,12,12,"No",3,3,3,3
"3126","2017-04-03",9,18,10,28,29,"Yes",3,7,8,10
"3127","2017-04-03",5,10,10,20,21,"No",6,4,5,5
"3128","2017-04-03",3,4,3,7,7,"Yes",2,1,1,3
"3129","2017-04-03",4,8,12,20,20,"No",7,5,4,4
"3130","2017-04-03",3,7,5,12,12,"Yes",2,3,2,5
"3131","2017-04-03",8,11,4,15,15,"Yes",1,3,6,5
"3132","2017-04-03",5,0,0,0,NA,"Yes",NA,NA,NA,NA
"3133","2017-04-03",5,8,2,10,10,"Yes",1,1,5,3
"3134","2017-04-03",2,4,1,5,6,"Yes",1,NA,2,2
"3135","2017-04-03",2,10,3,13,13,"Yes",1,2,4,6
"3136","2017-04-03",5,11,9,20,20,"No",3,6,5,6
"3137","2017-04-03",4,8,6,14,14,"Yes",2,4,4,4
"3138","2017-04-03",1,2,2,4,4,"Yes",1,1,1,1
"3139","2017-04-03",3,6,6,12,12,"Yes",4,2,2,4
"3140","2017-04-03",5,9,6,15,14,"No",3,3,4,5
"3141","2017-04-03",2,10,5,15,15,"Yes",2,3,4,6
"3142","2017-04-03",3,9,1,10,10,"Yes",1,0,6,3
"3143","2017-04-03",2,8,0,8,8,"Yes",NA,NA,6,2
"3144","2017-04-03",4,16,14,30,30,"No",8,6,8,8
"3145","2017-04-03",3,5,9,14,14,"No",3,6,3,2
"3146","2017-04-03",5,8,7,15,16,"Yes",3,4,4,4
"3147","2017-04-03",6,12,9,21,16,"No",5,4,6,6
"3148","2017-04-03",4,8,4,12,15,"No",3,1,4,4
"3149","2017-04-03",1,2,1,3,2,"Yes",0,1,2,0
"3150","2017-04-03",6,8,12,20,20,"No",5,7,3,5
"3151","2017-04-03",4,8,5,13,13,NA,5,0,3,5
"3152","2017-04-03",3,6,6,12,12,"Yes",4,2,3,3
"3153","2017-04-03",1,3,2,5,5,"Yes",2,0,1,2
"3154","2017-04-03",6,7,9,16,16,"No",5,4,2,5
"3155","2017-04-03",4,16,7,23,23,"No",4,3,8,8
"3156","2017-04-03",4,10,13,23,NA,"No",4,9,5,5
"3157","2017-04-03",5,9,11,20,20,"No",6,5,4,5
"3158","2017-04-03",3,6,9,15,15,"No",4,5,3,3
"3159","2017-04-03",4,8,2,10,14,"No",1,1,4,4
"3160","2017-04-03",1,5,0,5,5,"Yes",0,0,3,2
"3161","2017-04-03",4,7,4,11,11,"Yes",2,2,3,4
"3162","2017-04-03",4,8,8,16,18,"Yes",3,5,4,4
"3163",NA,3,5,12,17,17,"Yes",4,8,2,3
"3164","2017-04-03",2,8,1,9,9,"No",1,0,4,4
"3165","2017-04-03",9,18,8,26,NA,"Yes",2,6,9,9
"3166","2017-04-03",3,7,7,14,15,"Yes",5,2,3,4
"3167","2017-04-03",3,6,3,9,13,"Yes",2,1,3,3
"3168","2017-04-03",2,6,11,17,17,"Yes",4,7,3,3
"3169","2017-04-03",3,7,2,9,16,"No",2,0,4,3
"3170","2017-04-03",2,4,8,12,12,"No",4,4,2,2
"3171","2017-04-03",11,22,16,38,38,"Yes",7,9,11,11
"3172","2017-04-03",NA,8,6,14,14,"Yes",2,4,4,4
"3173","2017-04-03",3,4,6,10,14,"No",6,0,2,2
"3174","2017-04-03",4,8,8,16,13,"Yes",6,2,4,4
"3175","2017-04-03",3,6,9,15,15,"Yes",4,5,3,3
"3176","2017-04-03",5,10,13,23,23,"Yes",5,8,5,5
"3177","2017-04-03",7,10,10,20,20,"No",3,7,6,4
"3178","2017-04-03",3,6,6,12,12,"No",3,3,4,2
"3179","2017-04-10",4,7,12,19,23,"Yes",3,9,3,4
"3180","2017-04-03",4,10,6,16,16,"Yes",2,4,4,6
"3181","2017-04-03",2,4,8,12,8,"No",4,4,1,3
"3182","2017-04-03",6,12,8,20,20,"Yes",5,3,6,6
"3183","2017-04-03",4,10,5,15,25,NA,2,3,5,5
"3184","2017-04-03",2,2,1,3,3,"Yes",1,NA,1,1
"3185","2017-04-03",6,16,8,24,24,"Yes",3,5,8,8
"3186","2017-04-03",3,9,4,13,13,"Yes",1,3,6,3
"3187","2017-04-03",5,5,7,12,16,"Yes",2,5,3,2
"3188","2017-04-03",3,9,7,16,16,"Yes",3,4,3,6
"3189","2017-04-03",3,9,3,12,12,"No",1,2,4,5
"3190","2017-04-03",5,10,15,25,25,"No",7,8,5,5
"3191","2017-04-03",7,14,7,21,21,"No",2,5,7,7
"3192","2017-04-03",1,8,3,11,15,NA,1,2,4,4
"3193","2017-04-03",1,5,4,9,9,"Yes",1,3,2,3
"3194","2017-04-04",1,5,3,8,8,"Yes",1,2,2,3
"3195","2017-04-04",5,11,9,20,22,"Yes",4,5,6,5
"3196","2017-04-04",1,2,3,5,5,"Yes",1,2,1,1
"3197","2017-04-04",6,12,13,25,26,"No",6,7,6,6
"3198","2017-04-04",6,18,7,25,25,"No",3,4,8,10
"3199","2017-04-03",9,18,18,36,38,"No",8,10,9,9
"3200","2017-04-04",5,10,5,15,17,"Yes",1,4,5,5
"3201","2017-04-04",1,3,3,6,6,"No",1,2,1,2
"3202","2017-04-04",4,7,7,14,14,"Yes",3,4,5,2
"3203","2017-04-04",5,10,18,28,28,"No",7,11,5,5
"3204","2017-04-04",2,4,1,5,5,"Yes",0,1,2,2
"3205","2017-04-04",2,5,6,11,12,"No",2,4,1,4
"3206","2017-04-04",3,11,7,18,18,"No",4,3,5,6
"3207","2017-04-04",7,13,2,15,15,"Yes",1,1,5,8
"3208","2017-04-04",7,14,11,25,26,"No",5,6,7,7
"3209","2017-04-04",NA,7,43,50,NA,"Yes",28,15,6,1
"3210","2017-04-04",1,7,5,12,12,"No",3,2,4,3
"3211","2017-04-04",2,3,6,9,9,"Yes",3,3,2,1
"3212","2017-04-04",4,11,6,17,17,"Yes",3,3,6,5
"3213","2017-04-04",4,10,10,20,20,"Yes",4,6,7,3
"3214","2017-04-04",1,5,4,9,9,"Yes",4,0,2,3
"3215","2017-04-04",NA,8,9,17,NA,"No",5,4,5,3
"3216","2017-04-04",5,8,8,16,15,"No",5,3,5,3
"3217","2017-04-04",4,8,0,8,7,"No",0,0,4,4
"3218","2017-04-04",3,6,9,15,15,"No",4,5,3,3
"3219","2017-04-04",4,8,8,16,17,"Yes",3,5,4,4
"3220","2017-04-04",3,6,5,11,11,"Yes",4,1,3,3
"3221","2017-04-04",3,6,3,9,9,"No",0,3,3,3
"3222","2017-04-04",6,12,10,22,NA,"No",5,5,6,6
"3223","2017-04-04",3,10,11,21,21,"Yes",6,5,6,4
"3224","2017-04-04",4,10,5,15,15,"Yes",3,2,5,5
"3225","2017-04-04",6,12,13,25,25,"Yes",4,9,6,6
"3226","2017-04-04",1,4,6,10,6,"Yes",2,4,2,2
"3227","2017-04-04",8,16,9,25,28,"Yes",3,6,8,8
"3228","2017-04-04",5,10,3,13,13,"Yes",1,2,4,6
"3229","2017-04-04",5,12,4,16,16,"No",2,2,5,7
"3230","2017-04-04",7,10,5,15,15,"Yes",4,1,3,7
"3231","2017-04-04",3,4,1,5,5,"Yes",1,0,2,2
"3232","2017-04-05",4,11,3,14,19,"No",NA,3,4,7
"3233","2017-04-04",1,3,2,5,5,"Yes",1,1,2,1
"3234","2017-04-04",1,6,9,15,15,"Yes",5,4,1,5
"3235","2017-04-04",4,8,8,16,15,"No",3,5,4,4
"3236","2017-04-04",2,7,3,10,10,"No",1,2,3,4
"3237","2017-04-04",1,3,2,5,5,"Yes",1,1,1,2
"3238","2017-04-04",2,6,0,6,4,"Yes",0,0,2,4
"3239","2017-04-04",6,12,4,16,16,"No",2,2,6,6
"3240","2017-04-04",5,9,6,15,15,"No",3,3,5,4
"3241","2017-04-04",7,20,10,30,30,"Yes",4,6,7,13
"3242","2017-04-04",6,15,7,22,NA,"Yes",5,2,7,8
"3243","2017-04-04",3,6,1,7,10,"Yes",0,1,3,3
"3244","2017-04-04",NA,2,5,7,NA,"No",1,4,1,1
"3245","2017-04-04",2,4,2,6,6,"Yes",1,1,2,2
"3246","2017-04-04",5,10,5,15,22,"No",3,2,5,5
"3247","2017-04-04",1,6,0,6,6,"Yes",0,0,4,2
"3248","2017-04-04",1,2,0,2,2,"Yes",NA,NA,1,1
"3249","2017-04-04",5,9,7,16,12,"Yes",4,3,6,3
"3250","2017-04-04",1,3,3,6,6,"Yes",3,0,1,2
"3251","2017-04-03",1,3,2,5,5,"Yes",1,1,1,2
"3252","2017-04-04",5,12,10,22,22,"Yes",5,5,7,5
"3253","2017-04-04",4,8,5,13,13,"Yes",3,2,4,4
"3254","2017-04-04",1,5,3,8,8,"Yes",1,2,3,2
"3255","2017-04-04",7,18,7,25,25,"No",4,3,11,7
"3256","2017-04-04",1,1,2,3,4,"Yes",1,1,1,NA
"3257","2017-04-04",3,6,1,7,5,"Yes",1,0,3,3
"3258","2017-04-04",4,12,13,25,25,"Yes",6,7,5,7
"3259","2017-04-04",4,7,10,17,17,"Yes",5,5,5,2
"3260","2017-04-04",11,22,8,30,30,"Yes",2,6,11,11
"3261","2017-04-11",3,6,6,12,12,"No",4,2,3,3
"3262","2017-04-04",3,7,3,10,10,"Yes",2,1,3,4
"3263","2017-04-04",1,6,9,15,15,"No",3,6,2,4
"3264","2017-04-04",1,4,0,4,4,"Yes",0,0,2,2
"3265","2017-04-04",2,3,2,5,9,"Yes",1,1,1,2
"3266","2017-04-11",7,14,7,21,21,"No",2,5,7,7
"3267","2017-04-04",7,12,6,18,18,NA,1,5,5,7
"3268","2017-04-04",1,4,2,6,7,"No",2,0,2,2
"3269","2017-04-04",5,10,7,17,17,"Yes",3,4,5,5
"3270","2017-04-11",5,9,3,12,15,"Yes",2,1,4,5
"3271","2017-04-04",7,14,25,39,29,"No",13,12,7,7
"3272","2017-04-04",1,1,3,4,4,"Yes",2,1,NA,1
"3273","2017-04-05",1,2,5,7,7,"Yes",1,4,1,1
"3274","2017-04-04",3,16,10,26,25,"Yes",5,5,6,10
"3275","2017-04-04",4,5,6,11,12,"Yes",0,6,3,2
"3276","2017-04-04",1,2,2,4,4,"Yes",1,1,1,1
"3277","2017-04-04",5,6,14,20,20,"Yes",6,8,1,5
"3278","2017-04-04",3,0,0,0,NA,"Yes",NA,NA,NA,NA
"3279","2017-04-04",1,2,5,7,7,"Yes",2,3,1,1
"3280","2017-04-04",3,9,8,17,17,"Yes",5,3,4,5
"3281","2017-04-04",6,11,4,15,15,"Yes",2,2,6,5
"3282","2017-04-04",1,3,0,3,3,"Yes",0,0,1,2
"3283","2017-04-04",2,3,2,5,5,"No",2,0,1,2
"3284","2017-04-04",4,8,6,14,14,"No",5,1,4,4
"3285","2017-04-04",6,8,6,14,14,"No",2,4,5,3
"3286","2017-04-04",5,14,8,22,18,"Yes",5,3,9,5
"3287","2017-04-04",5,0,0,0,NA,"Yes",NA,NA,NA,NA
"3288","2017-04-04",1,5,1,6,6,"Yes",0,1,4,1
"3289","2017-04-04",3,6,6,12,12,"No",2,4,3,3
"3290","2017-04-04",1,2,2,4,4,"Yes",0,2,1,1
"3291","2017-04-04",2,2,0,2,2,"No",0,0,1,1
"3292","2017-04-04",1,3,4,7,7,"Yes",NA,4,NA,3
"3293","2017-04-04",1,5,0,5,5,"Yes",0,0,3,2
"3294","2017-04-04",1,6,0,6,6,"Yes",0,0,2,4
"3295","2017-04-04",9,15,20,35,35,"Yes",10,10,5,10
"3296","2017-04-04",2,10,5,15,15,"Yes",2,3,4,6
"3297","2017-04-04",3,7,13,20,19,"Yes",5,8,3,4
"3298","2017-04-04",2,5,4,9,10,"Yes",1,3,2,3
"3299","2017-04-04",3,5,2,7,7,"Yes",1,1,3,2
"3300","2017-04-04",3,6,1,7,8,"No",1,0,3,3
"3301","2017-04-04",1,2,4,6,6,"Yes",3,1,1,1
"3302","2017-04-04",4,7,5,12,12,"No",2,3,4,3
"3303","2017-04-04",1,4,4,8,8,"Yes",1,3,3,1
"3304","2017-04-04",4,6,8,14,14,"Yes",3,5,1,5
"3305","2017-04-04",4,7,3,10,10,"No",2,1,4,3
"3306","2017-04-04",7,0,0,0,7,"Yes",0,0,NA,NA
"3307","2017-04-04",5,0,0,0,30,NA,NA,NA,NA,NA
"3308","2017-04-04",2,7,0,7,7,"Yes",0,0,4,3
"3309","2017-04-04",2,3,3,6,6,"Yes",1,2,2,1
"3310","2017-04-04",2,4,4,8,NA,"No",1,3,2,2
"3311","2017-04-04",3,11,3,14,15,"No",2,1,6,5
"3312","2017-04-04",NA,70,35,105,NA,"Yes",15,20,30,40
"3313","2017-04-04",4,9,12,21,21,"Yes",5,7,4,5
"3314","2017-04-04",81,15,8,23,6,"No",5,3,8,7
"3315","2017-04-04",6,11,0,11,11,"Yes",0,0,5,6
"3316","2017-04-04",1,4,2,6,7,"Yes",2,0,2,2
"3317","2017-04-04",3,6,8,14,14,"Yes",5,3,3,3
"3318","2017-04-04",1,4,2,6,6,"Yes",1,1,1,3
"3319","2017-04-04",4,11,15,26,26,"Yes",7,8,5,6
"3320","2017-04-04",3,7,5,12,12,"Yes",4,1,3,4
"3321","2017-04-04",6,9,4,13,13,"Yes",2,2,6,3
"3322",NA,9,0,0,0,NA,"Yes",NA,NA,NA,NA
"3323","2017-04-04",1,2,4,6,6,"Yes",2,2,1,1
"3324","2017-04-04",8,15,8,23,23,"No",2,6,7,8
"3325","2017-04-04",7,18,10,28,28,"No",4,6,10,8
"3326","2017-04-04",1,2,3,5,5,"Yes",2,1,1,1
"3327","2017-04-04",5,4,5,9,8,"No",2,3,2,2
"3328","2017-04-04",7,21,7,28,NA,"Yes",5,2,8,13
"3329","2017-04-04",2,6,1,7,8,"Yes",1,0,2,4
"3330","2017-04-04",1,2,3,5,5,"No",1,2,1,1
"3331","2017-04-04",3,6,5,11,11,"Yes",4,1,3,3
"3332","2017-04-04",5,10,10,20,25,"No",4,6,5,5
"3333","2017-04-04",5,11,15,26,26,"Yes",6,9,6,5
"3334","2017-04-04",6,12,12,24,24,"No",5,7,6,6
"3335","2017-04-04",1,1,0,1,1,"Yes",0,0,1,0
"3336","2017-04-04",4,5,7,12,NA,"No",3,4,3,2
"3337","2017-04-04",3,7,2,9,9,"No",1,1,3,4
"3338","2017-04-04",1,9,0,9,9,"Yes",0,0,1,8
"3339","2017-04-04",1,13,6,19,19,"No",4,2,5,8
"3340","2017-04-04",NA,7,114,121,NA,"No",40,74,3,4
"3341","2017-04-04",2,4,2,6,6,"Yes",0,2,2,2
"3342","2017-04-04",2,8,2,10,10,"Yes",0,2,5,3
"3343","2017-04-04",3,8,5,13,13,"Yes",4,1,2,6
"3344","2017-04-04",5,10,5,15,20,"No",3,2,5,5
"3345","2017-04-04",1,2,1,3,3,"Yes",1,0,1,1
"3346","2017-04-04",2,3,8,11,12,"No",3,5,1,2
"3347","2017-04-04",3,6,2,8,8,"Yes",0,2,3,3
"3348","2017-04-04",2,7,6,13,19,"Yes",6,0,2,5
"3349","2017-04-04",NA,2,5,7,NA,"Yes",4,1,1,1
"3350","2017-04-04",5,17,5,22,NA,"Yes",4,1,10,7
"3351",NA,2,4,3,7,9,"Yes",2,1,2,2
"3352","2017-04-04",NA,2,5,7,NA,"No",4,1,1,1
"3353","2017-04-04",1,2,3,5,4,"Yes",1,2,1,1
"3354","2017-04-04",3,5,10,15,15,"Yes",3,7,2,3
"3355","2017-04-04",3,12,1,13,13,"No",0,1,4,8
"3356","2017-04-04",1,3,3,6,6,"Yes",2,1,2,1
"3357","2017-04-04",3,7,5,12,11,"No",2,3,4,3
"3358","2017-04-04",2,7,3,10,11,"No",2,1,5,2
"3359","2017-04-04",7,22,29,51,25,"Yes",15,14,10,12
"3360","2017-04-03",3,6,7,13,13,"No",4,3,2,4
"3361","2017-04-04",1,1,0,1,1,"Yes",NA,NA,1,NA
"3362","2017-04-11",4,8,4,12,12,"No",3,1,4,4
"3363","2017-04-04",2,4,7,11,11,"Yes",1,6,2,2
"3364","2017-04-04",5,20,15,35,35,"Yes",8,7,10,10
"3365","2017-04-04",2,4,3,7,7,"No",1,2,1,3
"3366","2017-04-04",1,2,3,5,5,"Yes",1,2,1,1
"3367","2017-04-04",2,6,3,9,9,"Yes",2,1,4,2
"3368","2017-04-04",2,5,3,8,8,"No",1,2,1,4
"3369","2017-04-04",3,7,3,10,10,"Yes",1,2,5,2
"3370","2017-04-04",4,10,4,14,16,"No",2,2,5,5
"3371","2017-04-04",1,6,6,12,12,"Yes",2,4,2,4
"3372","2017-04-04",2,6,9,15,15,"Yes",7,2,4,2
"3373","2017-04-04",1,7,6,13,13,"Yes",1,5,5,2
"3374","2017-04-04",2,7,5,12,11,"Yes",2,3,4,3
"3375","2017-04-04",7,16,13,29,29,"Yes",7,6,8,8
"3376","2017-04-04",6,11,7,18,19,"Yes",3,4,6,5
"3377","2017-04-04",5,10,15,25,25,"Yes",7,8,5,5
"3378","2017-04-04",3,5,4,9,9,"Yes",1,3,2,3
"3379","2017-04-04",1,6,8,14,14,"Yes",2,6,2,4
"3380","2017-04-04",4,14,10,24,24,"Yes",4,6,7,7
"3381","2017-04-04",2,3,4,7,7,"Yes",2,2,2,1
"3382","2017-04-04",1,2,4,6,6,NA,1,3,1,1
"3383","2017-04-04",4,8,13,21,20,"Yes",5,8,4,4
"3384","2017-04-04",12,24,21,45,45,"Yes",10,11,12,12
"3385","2017-04-04",4,11,5,16,16,"Yes",2,3,5,6
"3386","2017-04-04",3,0,0,0,NA,"Yes",NA,NA,NA,NA
"3387","2017-04-04",7,20,12,32,31,"No",3,9,14,6
"3388","2017-04-04",1,2,4,6,6,"No",2,2,1,1
"3389","2017-04-04",NA,145,49,194,NA,"No",23,26,56,89
"3390","2017-04-04",6,14,10,24,24,"Yes",5,5,9,5
"3391","2017-04-04",5,0,0,0,NA,"Yes",NA,NA,NA,NA
"3392","2017-04-04",NA,400,0,400,NA,"Yes",0,0,300,100
"3393","2017-04-04",4,8,2,10,10,"Yes",1,1,6,2
"3394","2017-04-04",3,7,4,11,11,"No",2,2,4,3
"3395","2017-04-04",3,11,10,21,21,"Yes",6,4,6,5
"3396","2017-04-04",6,6,3,9,9,"Yes",1,2,3,3
"3397","2017-04-07",2,8,10,18,18,"Yes",4,6,4,4
"3398",NA,1,2,5,7,7,"Yes",1,4,1,1
"3399","2017-04-11",2,5,4,9,9,"Yes",1,3,3,2
"3400","2017-04-04",1,7,5,12,12,"Yes",2,3,3,4
"3401","2017-04-04",7,18,2,20,20,"Yes",1,1,10,8
"3402","2017-04-04",4,8,3,11,11,"Yes",1,2,4,4
"3403","2017-04-04",2,4,4,8,8,"Yes",2,2,3,1
"3404","2017-04-04",2,7,1,8,7,"Yes",NA,1,5,2
"3405","2017-04-04",7,24,4,28,22,"Yes",1,3,11,13
"3406","2017-04-04",2,18,3,21,21,"No",NA,3,6,12
"3407","2017-04-04",1,6,6,12,12,"Yes",5,1,3,3
"3408","2017-04-04",6,11,10,21,21,"No",3,7,5,6
"3409","2017-04-04",7,15,15,30,30,"Yes",6,9,8,7
"3410","2017-04-04",5,10,10,20,20,"Yes",4,6,5,5
"3411","2017-04-04",3,4,14,18,18,"Yes",8,6,2,2
"3412","2017-04-04",1,3,4,7,7,"Yes",2,2,2,1
"3413","2017-04-04",5,10,5,15,16,"Yes",3,2,5,5
"3414","2017-04-04",7,21,9,30,30,"Yes",6,3,11,10
"3415","2017-04-04",1,11,4,15,15,"Yes",2,2,5,6
"3416","2017-04-04",3,7,10,17,16,"No",5,5,3,4
"3417","2017-04-04",4,8,7,15,15,"Yes",1,6,3,5
"3418","2017-04-04",1,2,4,6,6,"Yes",2,2,1,1
"3419","2017-04-04",7,15,11,26,26,"Yes",5,6,7,8
"3420","2017-04-04",5,9,3,12,13,"Yes",1,2,4,5
"3421","2017-04-04",2,6,3,9,8,"Yes",2,1,3,3
"3422","2017-04-04",3,6,12,18,18,"Yes",5,7,2,4
"3423","2017-04-04",2,5,2,7,7,"No",0,2,3,2
"3424","2017-04-04",6,10,12,22,22,"Yes",2,10,5,5
"3425","2017-04-04",5,10,0,10,13,"Yes",NA,NA,5,5
"3426","2017-04-04",7,8,7,15,15,"No",2,5,4,4
"3427","2017-04-04",2,8,6,14,14,"No",3,3,3,5
"3428","2017-04-04",4,10,11,21,21,"No",8,3,4,6
"3429","2017-04-04",2,5,5,10,9,"No",3,2,2,3
"3430","2017-04-04",1,5,0,5,5,"Yes",NA,NA,2,3
"3431","2017-04-04",8,13,2,15,15,"Yes",1,1,5,8
"3432","2017-04-04",6,12,13,25,22,"Yes",5,8,6,6
"3433","2017-04-04",4,6,11,17,17,"Yes",7,4,3,3
"3434","2017-04-04",1,4,4,8,8,"Yes",2,2,1,3
"3435","2017-04-04",7,16,14,30,25,"Yes",6,8,7,9
"3436","2017-04-04",2,4,7,11,11,"Yes",3,4,2,2
"3437","2017-04-04",1,4,3,7,9,"Yes",1,2,1,3
"3438","2017-04-04",2,4,4,8,8,"Yes",3,1,3,1
"3439","2017-04-04",3,8,5,13,13,"Yes",4,1,3,5
"3440","2017-04-04",4,8,11,19,15,"Yes",5,6,4,4
"3441","2017-04-04",3,10,10,20,20,"No",5,5,7,3
"3442","2017-04-04",1,5,5,10,13,"Yes",3,2,2,3
"3443","2017-04-04",2,5,3,8,8,"Yes",1,2,2,3
"3444","2017-04-04",1,3,0,3,3,"Yes",0,0,0,3
"3445","2017-04-04",7,17,13,30,30,"No",5,8,8,9
"3446","2017-04-04",2,1,4,5,5,"Yes",3,1,NA,1
"3447","2017-04-04",1,2,6,8,8,"Yes",4,2,1,1
"3448","2017-04-04",1,4,3,7,7,"Yes",1,2,2,2
"3449","2017-04-04",9,14,21,35,35,"No",11,10,10,4
"3450","2017-04-04",3,6,1,7,7,"Yes",1,0,3,3
"3451","2017-04-04",2,12,2,14,16,"Yes",2,0,4,8
"3452","2017-04-04",3,13,7,20,15,"Yes",5,2,6,7
"3453","2017-04-04",3,12,4,16,16,"Yes",3,1,6,6
"3454","2017-04-04",4,8,3,11,15,"No",2,1,2,6
"3455","2017-04-04",3,6,8,14,14,"Yes",2,6,3,3
"3456","2017-04-04",1,3,5,8,8,"Yes",2,3,1,2
"3457","2017-04-04",3,4,4,8,8,"Yes",2,2,3,1
"3458","2017-04-04",2,6,9,15,15,"Yes",6,3,3,3
"3459","2017-04-04",2,5,2,7,7,"Yes",1,1,2,3
"3460","2017-04-04",2,8,7,15,15,"Yes",5,2,4,4
"3461","2017-04-04",3,7,7,14,15,"No",4,3,4,3
"3462","2017-04-04",1,5,1,6,6,"Yes",1,0,3,2
"3463","2017-04-11",1,2,6,8,8,"Yes",1,5,1,1
"3464","2017-04-04",9,16,9,25,29,"No",4,5,8,8
"3465","2017-04-04",3,7,8,15,15,"Yes",4,4,3,4
"3466","2017-04-04",2,10,16,26,23,"Yes",8,8,4,6
"3467","2017-04-04",3,5,7,12,12,"Yes",2,5,3,2
"3468","2017-04-04",6,11,5,16,14,"No",2,3,6,5
"3469","2017-04-04",5,11,8,19,19,"Yes",5,3,4,7
"3470","2017-04-04",5,11,0,11,13,"Yes",NA,NA,5,6
"3471","2017-04-04",2,8,5,13,13,"No",1,4,2,6
"3472","2017-04-04",1,8,4,12,8,"Yes",2,2,4,4
"3473","2017-04-04",5,9,13,22,22,"Yes",6,7,4,5
"3474","2017-04-04",7,14,2,16,16,"No",0,2,7,7
"3475","2017-04-04",1,10,0,10,10,"Yes",0,0,5,5
"3476","2017-04-04",3,6,14,20,20,"Yes",7,7,2,4
"3477","2017-04-04",5,10,15,25,25,"Yes",7,8,5,5
"3478","2017-04-04",17,35,47,82,80,"Yes",22,25,20,15
"3479","2017-04-04",1,2,3,5,7,"No",3,0,1,1
"3480","2017-04-11",7,12,5,17,17,"Yes",2,3,7,5
"3481","2017-04-04",1,13,16,29,28,"No",10,6,5,8
"3482","2017-04-04",7,11,11,22,22,"Yes",4,7,5,6
"3483","2017-04-04",1,2,4,6,6,"Yes",0,4,1,1
"3484","2017-04-04",1,7,4,11,11,"Yes",2,2,2,5
"3485","2017-04-04",4,6,6,12,12,"Yes",3,3,2,4
"3486","2017-04-04",4,16,2,18,18,"No",2,0,8,8
"3487","2017-04-04",12,24,20,44,60,"No",8,12,12,12
"3488","2017-04-04",3,5,6,11,11,"Yes",2,4,2,3
"3489","2017-04-04",4,8,2,10,25,"Yes",1,1,4,4
"3490","2017-04-04",5,10,8,18,15,"No",4,4,6,4
"3491","2017-04-04",6,10,20,30,30,"Yes",10,10,5,5
"3492","2017-04-04",3,6,3,9,12,"Yes",2,1,2,4
"3493","2017-04-04",4,8,8,16,16,"No",3,5,5,3
"3494","2017-04-11",4,6,4,10,8,"No",2,2,4,2
"3495","2017-04-04",7,17,18,35,30,"Yes",8,10,10,7
"3496","2017-04-04",5,11,10,21,22,"No",5,5,5,6
"3497","2017-04-04",6,12,6,18,18,"Yes",0,6,6,6
"3498","2017-04-04",3,11,5,16,16,"No",2,3,5,6
"3499","2017-04-04",5,7,5,12,12,"Yes",2,3,3,4
"3500","2017-04-04",3,9,3,12,14,"Yes",1,2,4,5
"3501","2017-04-04",1,2,2,4,4,"Yes",1,1,NA,2
"3502","2017-04-04",NA,25,694,719,NA,"Yes",369,325,14,11
"3503","2017-04-04",1,4,3,7,7,"Yes",2,1,3,1
"3504","2017-04-04",3,3,2,5,5,"No",1,1,2,1
"3505","2017-04-04",5,12,8,20,20,"Yes",5,3,6,6
"3506","2017-04-04",5,10,7,17,17,"Yes",3,4,5,5
"3507","2017-04-04",6,14,16,30,30,"No",9,7,6,8
"3508","2017-04-04",6,12,15,27,29,"No",7,8,6,6
"3509","2017-04-04",3,4,5,9,9,"No",3,2,1,3
"3510","2017-04-04",2,4,3,7,7,"No",1,2,2,2
"3511","2017-04-04",2,7,6,13,13,"Yes",3,3,3,4
"3512","2017-04-04",7,12,11,23,30,"No",5,6,6,6
"3513","2017-04-04",3,6,5,11,11,"Yes",4,1,3,3
"3514","2017-04-04",6,11,9,20,20,"Yes",3,6,5,6
"3515","2017-04-04",2,5,4,9,9,"No",4,0,2,3
"3516","2017-04-05",7,16,3,19,NA,"No",2,1,9,7
"3517","2017-04-05",3,6,4,10,10,"No",2,2,2,4
"3518","2017-04-05",1,3,3,6,6,"Yes",2,1,1,2
"3519","2017-04-05",2,5,2,7,7,"Yes",1,1,NA,5
"3520","2017-04-05",7,14,5,19,NA,"Yes",1,4,6,8
"3521","2017-04-05",5,10,5,15,15,"No",2,3,5,5
"3522","2017-04-05",4,19,6,25,25,"Yes",2,4,10,9
"3523","2017-04-05",1,6,6,12,12,"Yes",2,4,3,3
"3524","2017-04-05",3,7,11,18,18,"No",2,9,4,3
"3525","2017-04-05",2,9,4,13,13,"No",1,3,5,4
"3526","2017-04-05",11,26,16,42,40,"No",3,13,12,14
"3527","2017-04-05",4,9,6,15,16,"Yes",2,4,3,6
"3528","2017-04-05",7,10,10,20,20,"No",3,7,5,5
"3529","2017-04-05",1,3,3,6,6,"Yes",2,1,2,1
"3530","2017-04-05",5,12,8,20,28,"Yes",4,4,7,5
"3531","2017-04-05",4,7,6,13,12,"Yes",3,3,4,3
"3532","2017-04-05",5,11,8,19,19,"No",3,5,6,5
"3533","2017-04-05",2,5,9,14,14,"Yes",7,2,2,3
"3534","2017-04-04",10,26,26,52,58,"Yes",11,15,10,16
"3535","2017-04-05",2,7,4,11,9,"Yes",3,1,4,3
"3536","2017-04-05",1,2,0,2,2,"No",0,0,1,1
"3537","2017-04-05",5,13,5,18,18,"Yes",3,2,6,7
"3538","2017-04-05",3,0,0,0,NA,"No",NA,NA,NA,NA
"3539","2017-04-05",3,10,8,18,18,"Yes",3,5,4,6
"3540","2017-04-05",5,10,7,17,17,"No",3,4,5,5
"3541","2017-04-05",2,4,3,7,7,"Yes",1,2,2,2
"3542","2017-04-05",3,7,8,15,12,"No",3,5,3,4
"3543","2017-04-05",4,13,13,26,16,"Yes",6,7,7,6
"3544","2017-04-05",2,6,6,12,12,"Yes",3,3,4,2
"3545","2017-04-05",3,10,9,19,12,"Yes",3,6,3,7
"3546","2017-04-05",2,7,0,7,7,"Yes",0,0,3,4
"3547","2017-04-05",3,4,2,6,6,"Yes",0,2,1,3
"3548","2017-04-05",4,8,6,14,14,"Yes",3,3,4,4
"3549",NA,3,5,4,9,9,"No",2,2,2,3
"3550","2017-04-05",7,15,12,27,25,NA,8,4,8,7
"3551","2017-04-05",6,10,2,12,12,"Yes",0,2,4,6
"3552","2017-04-05",4,13,7,20,NA,"Yes",4,3,6,7
"3553","2017-04-05",1,2,2,4,4,"Yes",0,2,1,1
"3554","2017-04-05",5,10,4,14,14,"Yes",1,3,5,5
"3555","2017-04-05",2,4,5,9,9,"No",2,3,1,3
"3556","2017-04-05",4,8,2,10,10,"Yes",2,0,4,4
"3557","2017-04-05",5,8,3,11,17,"No",2,1,4,4
"3558","2017-04-05",4,5,15,20,20,"Yes",5,10,2,3
"3559","2017-04-05",3,6,12,18,18,NA,5,7,3,3
"3560","2017-04-05",1,4,6,10,10,"Yes",2,4,1,3
"3561","2017-04-05",2,11,9,20,20,"Yes",7,2,5,6
"3562","2017-04-05",5,15,10,25,25,"Yes",4,6,5,10
"3563","2017-04-05",1,5,0,5,5,"Yes",NA,0,3,2
"3564","2017-04-05",2,2,2,4,4,"No",2,0,1,1
"3565","2017-04-05",3,6,3,9,9,"Yes",1,2,4,2
"3566","2017-04-05",5,8,7,15,NA,"No",4,3,4,4
"3567","2017-04-05",7,14,7,21,21,"No",3,4,7,7
"3568","2017-04-05",4,6,10,16,16,"Yes",4,6,4,2
"3569","2017-04-05",1,9,8,17,15,"Yes",3,5,7,2
"3570","2017-04-05",4,7,5,12,12,"No",2,3,4,3
"3571","2017-04-05",3,0,0,0,NA,"Yes",NA,NA,NA,NA
"3572","2017-04-05",2,6,4,10,9,"Yes",0,4,3,3
"3573","2017-04-05",1,2,1,3,3,"No",1,0,1,1
"3574","2017-04-05",3,6,8,14,12,"Yes",1,7,3,3
"3575","2017-04-05",2,7,4,11,11,"Yes",3,1,4,3
"3576","2017-04-05",5,14,6,20,20,"Yes",2,4,4,10
"3577","2017-04-05",3,6,2,8,8,"No",NA,2,3,3
"3578","2017-04-05",3,6,1,7,10,"No",0,1,3,3
"3579","2017-04-05",5,8,7,15,NA,"Yes",5,2,4,4
"3580","2017-04-05",4,11,4,15,15,"No",2,2,5,6
"3581","2017-04-05",2,6,6,12,13,"Yes",2,4,1,5
"3582","2017-04-05",3,5,10,15,15,"No",6,4,2,3
"3583","2017-04-05",3,11,4,15,15,"No",1,3,5,6
"3584","2017-04-05",6,12,7,19,19,"No",4,3,6,6
"3585","2017-04-05",1,3,3,6,5,"Yes",3,0,2,1
"3586","2017-04-05",3,13,14,27,24,"Yes",6,8,5,8
"3587","2017-04-05",1,3,2,5,5,"Yes",1,1,2,1
"3588","2017-04-05",2,4,2,6,6,"No",1,1,2,2
"3589","2017-04-05",2,7,1,8,8,"Yes",0,1,2,5
"3590","2017-04-05",1,4,5,9,9,"Yes",3,2,1,3
"3591","2017-04-05",5,8,4,12,17,"No",1,3,4,4
"3592","2017-04-05",5,10,5,15,12,"Yes",2,3,5,5
"3593","2017-04-05",1,4,5,9,8,"Yes",2,3,2,2
"3594","2017-04-05",2,4,7,11,11,"No",2,5,2,2
"3595","2017-04-12",3,6,9,15,12,"No",5,4,3,3
"3596","2017-04-05",5,7,0,7,7,"Yes",0,0,4,3
"3597","2017-04-05",5,9,6,15,15,"Yes",2,4,5,4
"3598","2017-04-05",9,15,15,30,30,"Yes",10,5,5,10
"3599","2017-04-05",2,4,5,9,9,"Yes",1,4,2,2
"3600","2017-04-05",1,4,10,14,14,"Yes",3,7,2,2
"3601","2017-04-05",6,11,10,21,17,"Yes",4,6,5,6
"3602","2017-04-05",42,27,17,44,9,"Yes",8,9,12,15
"3603","2017-04-05",3,5,3,8,8,"Yes",1,2,2,3
"3604","2017-04-05",3,6,5,11,11,"No",2,3,3,3
"3605","2017-04-05",2,6,4,10,10,"Yes",1,3,1,5
"3606","2017-04-05",4,8,5,13,NA,"No",2,3,4,4
"3607","2017-04-05",1,2,2,4,4,"Yes",2,0,1,1
"3608","2017-04-05",NA,600,280,880,NA,"No",123,157,200,400
"3609","2017-04-05",4,8,6,14,14,"No",3,3,4,4
"3610","2017-04-05",1,3,2,5,5,"No",1,1,2,1
"3611","2017-04-05",3,7,14,21,13,"Yes",6,8,4,3
"3612","2017-04-05",5,10,5,15,NA,"Yes",2,3,5,5
"3613","2017-04-05",1,7,0,7,7,"Yes",0,0,3,4
"3614","2017-04-05",4,10,6,16,20,"Yes",3,3,6,4
"3615","2017-04-05",3,11,4,15,15,"Yes",1,3,6,5
"3616","2017-04-05",5,11,1,12,12,"Yes",1,0,5,6
"3617","2017-04-05",2,8,5,13,13,"Yes",2,3,4,4
"3618","2017-04-05",8,18,12,30,30,"No",7,5,10,8
"3619","2017-04-05",4,10,7,17,17,"No",4,3,6,4
"3620","2017-04-05",1,2,2,4,4,"Yes",0,2,0,2
"3621","2017-04-05",6,14,10,24,24,"Yes",8,2,7,7
"3622","2017-04-05",2,9,3,12,11,"Yes",1,2,5,4
"3623","2017-04-05",1,3,2,5,5,"Yes",NA,2,0,3
"3624","2017-04-05",2,12,6,18,18,"Yes",3,3,9,3
"3625","2017-04-05",4,11,3,14,NA,"Yes",2,1,5,6
"3626","2017-04-05",4,8,9,17,17,"Yes",6,3,4,4
"3627","2017-04-05",NA,115,49,164,NA,"No",25,24,60,55
"3628","2017-04-05",1,6,3,9,9,"Yes",3,0,2,4
"3629","2017-04-05",4,12,8,20,21,"Yes",5,3,5,7
"3630","2017-04-05",2,9,6,15,15,"Yes",5,1,4,5
"3631","2017-04-05",1,1,4,5,5,"No",1,3,NA,1
"3632","2017-04-05",10,21,17,38,48,"No",7,10,10,11
"3633","2017-04-05",4,7,1,8,8,"Yes",NA,1,4,3
"3634","2017-04-05",1,6,0,6,6,"Yes",0,0,3,3
"3635","2017-04-05",5,0,0,0,NA,"No",NA,NA,NA,NA
"3636","2017-04-05",1,4,0,4,4,"Yes",0,0,2,2
"3637","2017-04-05",3,8,3,11,11,"Yes",2,1,3,5
"3638","2017-04-05",4,8,14,22,22,"Yes",8,6,4,4
"3639","2017-04-05",4,10,9,19,19,"Yes",3,6,5,5
"3640","2017-04-05",1,3,3,6,6,"No",3,0,2,1
"3641","2017-04-05",4,10,1,11,11,"Yes",0,1,6,4
"3642","2017-04-05",5,10,10,20,23,"No",3,7,5,5
"3643","2017-04-05",4,8,13,21,20,"No",8,5,4,4
"3644","2017-04-05",1,4,4,8,8,"Yes",0,4,2,2
"3645","2017-04-05",4,8,5,13,13,"No",2,3,4,4
"3646","2017-04-05",5,10,3,13,13,"No",3,0,4,6
"3647","2017-04-05",1,2,4,6,6,"No",2,2,1,1
"3648","2017-04-05",4,8,9,17,17,"Yes",1,8,4,4
"3649","2017-04-05",11,17,22,39,39,"Yes",11,11,8,9
"3650","2017-04-05",1,3,0,3,3,"Yes",0,0,2,1
"3651","2017-04-05",3,7,5,12,15,"No",3,2,4,3
"3652","2017-04-05",9,15,20,35,35,"Yes",10,10,10,5
"3653","2017-04-05",1,3,2,5,5,"No",0,2,1,2
"3654","2017-04-05",NA,6,92,98,NA,"No",44,48,3,3
"3655","2017-04-12",3,10,0,10,10,"Yes",NA,NA,7,3
"3656","2017-04-05",4,12,7,19,20,"Yes",5,2,7,5
"3657","2017-04-05",3,7,1,8,8,"Yes",1,NA,5,2
"3658","2017-04-05",NA,4,5,9,NA,"Yes",2,3,3,1
"3659","2017-04-05",6,15,16,31,30,"Yes",8,8,8,7
"3660","2017-04-05",1,6,0,6,6,"No",0,0,4,2
"3661","2017-04-05",11,3,3,6,6,"No",2,1,1,2
"3662","2017-04-05",7,16,11,27,24,"Yes",6,5,8,8
"3663","2017-04-05",4,10,8,18,17,"Yes",8,0,4,6
"3664","2017-04-05",1,4,1,5,5,"Yes",1,0,2,2
"3665","2017-04-05",5,11,5,16,16,"No",1,4,5,6
"3666","2017-04-05",1,5,3,8,7,"Yes",1,2,1,4
"3667","2017-04-05",4,7,6,13,15,"No",3,3,3,4
"3668","2017-04-05",2,3,3,6,8,"Yes",2,1,1,2
"3669","2017-04-05",5,11,7,18,13,"No",4,3,6,5
"3670","2017-04-05",2,5,3,8,8,"Yes",1,2,2,3
"3671","2017-04-05",4,12,4,16,15,"No",1,3,7,5
"3672","2017-04-05",5,10,12,22,22,"No",4,8,4,6
"3673","2017-04-05",2,9,8,17,16,"No",5,3,4,5
"3674","2017-04-05",6,10,10,20,20,"Yes",5,5,6,4
"3675","2017-04-05",3,8,4,12,12,"No",2,2,4,4
"3676","2017-04-05",NA,2,5,7,NA,"No",2,3,1,1
"3677","2017-04-05",3,5,3,8,8,"No",1,2,3,2
"3678","2017-04-05",3,15,10,25,25,"No",6,4,7,8
"3679","2017-04-05",4,14,2,16,16,"Yes",2,0,8,6
"3680","2017-04-05",2,4,5,9,9,"Yes",1,4,2,2
"3681","2017-04-05",4,11,9,20,20,"No",6,3,4,7
"3682","2017-04-05",1,2,3,5,5,"Yes",2,1,1,1
"3683","2017-04-05",1,3,5,8,8,"Yes",3,2,2,1
"3684","2017-04-05",1,3,4,7,7,"No",1,3,1,2
"3685","2017-04-05",NA,4,42,46,NA,"Yes",20,22,2,2
"3686","2017-04-05",4,15,10,25,25,"Yes",4,6,10,5
"3687","2017-04-05",9,5,15,20,20,"Yes",10,5,1,4
"3688","2017-04-05",3,6,8,14,15,"No",3,5,3,3
"3689","2017-04-05",5,16,14,30,30,"No",8,6,7,9
"3690","2017-04-05",1,2,2,4,4,"No",1,1,1,1
"3691","2017-04-05",4,14,7,21,23,"Yes",2,5,6,8
"3692","2017-04-05",1,1,0,1,1,"Yes",NA,NA,NA,1
"3693","2017-04-05",4,10,8,18,18,"No",3,5,3,7
"3694","2017-04-05",7,9,7,16,16,"Yes",5,2,4,5
"3695","2017-04-05",1,4,2,6,7,"No",1,1,2,2
"3696","2017-04-05",2,5,3,8,7,"Yes",1,2,3,2
"3697","2017-04-05",3,6,7,13,13,"Yes",5,2,3,3
"3698","2017-04-05",4,47,4,51,15,"No",4,NA,4,43
"3699","2017-04-05",5,11,5,16,16,"Yes",2,3,6,5
"3700","2017-04-05",2,4,6,10,10,"Yes",3,3,2,2
"3701","2017-04-05",4,10,10,20,20,"Yes",3,7,4,6
"3702","2017-04-05",2,7,4,11,11,"Yes",2,2,3,4
"3703","2017-04-05",7,14,8,22,22,"Yes",5,3,7,7
"3704","2017-04-05",2,5,5,10,10,"Yes",NA,5,2,3
"3705","2017-04-05",6,12,13,25,25,"Yes",5,8,4,8
"3706","2017-04-05",5,13,12,25,25,"No",5,7,7,6
"3707","2017-04-05",4,8,8,16,16,"No",3,5,4,4
"3708","2017-04-05",2,4,4,8,8,"Yes",1,3,2,2
"3709","2017-04-05",5,10,6,16,24,"No",4,2,4,6
"3710","2017-04-05",4,9,2,11,13,"No",2,0,4,5
"3711","2017-04-05",4,7,5,12,16,"Yes",3,2,4,3
"3712","2017-04-05",8,12,13,25,28,"Yes",6,7,7,5
"3713","2017-04-05",5,10,14,24,26,NA,8,6,5,5
"3714","2017-04-05",1,2,1,3,3,"Yes",1,NA,1,1
"3715","2017-04-05",6,12,6,18,18,"Yes",5,1,6,6
"3716","2017-04-05",2,6,6,12,12,"Yes",4,2,3,3
"3717","2017-04-05",1,2,2,4,4,"Yes",2,0,1,1
"3718","2017-04-05",5,10,10,20,20,"No",6,4,5,5
"3719","2017-04-05",3,6,6,12,12,"No",4,2,3,3
"3720","2017-04-05",5,9,11,20,20,"Yes",5,6,4,5
"3721","2017-04-05",2,4,4,8,8,"No",1,3,2,2
"3722","2017-04-05",2,3,2,5,6,"Yes",1,1,2,1
"3723","2017-04-05",5,16,12,28,28,"Yes",4,8,8,8
"3724","2017-04-05",3,5,4,9,13,"No",1,3,3,2
"3725","2017-04-05",1,3,6,9,9,"Yes",5,1,1,2
"3726","2017-04-05",5,10,11,21,21,"Yes",4,7,5,5
"3727","2017-04-05",1,2,5,7,7,"No",1,4,1,1
"3728","2017-04-05",2,4,0,4,4,"No",0,0,2,2
"3729","2017-04-05",4,8,12,20,21,"Yes",7,5,4,4
"3730","2017-04-05",2,2,4,6,6,"Yes",2,2,1,1
"3731","2017-04-05",5,9,6,15,15,"Yes",3,3,6,3
"3732","2017-04-05",1,2,2,4,4,"Yes",1,1,1,1
"3733","2017-04-05",5,0,0,0,NA,"Yes",NA,NA,NA,NA
"3734","2017-04-05",3,6,10,16,17,"Yes",7,3,3,3
"3735","2017-04-05",2,2,3,5,5,"Yes",2,1,1,1
"3736","2017-04-05",4,10,2,12,12,"Yes",1,1,4,6
"3737","2017-04-05",5,515,8,523,25,"Yes",8,NA,5,510
"3738","2017-04-05",4,8,4,12,14,"No",1,3,4,4
"3739","2017-04-05",NA,4,27,31,NA,"Yes",15,12,2,2
"3740","2017-04-05",5,10,3,13,16,"Yes",2,1,5,5
"3741","2017-04-05",4,9,6,15,14,"Yes",3,3,6,3
"3742","2017-04-05",2,6,11,17,17,"Yes",5,6,3,3
"3743","2017-04-05",2,2,5,7,7,"Yes",4,1,0,2
"3744","2017-04-05",5,15,11,26,28,"No",4,7,7,8
"3745","2017-04-05",1,2,5,7,8,"Yes",3,2,0,2
"3746","2017-04-05",4,8,9,17,17,NA,4,5,4,4
"3747","2017-04-05",7,14,6,20,20,"No",2,4,7,7
"3748","2017-04-05",5,10,5,15,16,"Yes",2,3,3,7
"3749","2017-04-05",4,12,5,17,17,"No",3,2,8,4
"3750","2017-04-05",2,6,3,9,9,"Yes",2,1,3,3
"3751","2017-04-05",1,2,8,10,8,"No",2,6,1,1
"3752","2017-04-05",7,13,4,17,17,"Yes",1,3,6,7
"3753","2017-04-05",3,8,8,16,19,"Yes",6,2,3,5
"3754","2017-04-05",4,11,6,17,17,"Yes",3,3,5,6
"3755","2017-04-05",3,6,5,11,11,"Yes",1,4,2,4
"3756","2017-04-05",3,0,0,0,10,"Yes",NA,NA,NA,NA
"3757","2017-04-05",3,10,3,13,14,"No",0,3,7,3
"3758","2017-04-05",1,2,6,8,8,"Yes",1,5,1,1
"3759","2017-04-05",2,4,3,7,7,"Yes",2,1,2,2
"3760","2017-04-05",5,13,5,18,18,"Yes",2,3,6,7
"3761","2017-04-05",2,3,2,5,5,"Yes",0,2,2,1
"3762","2017-04-05",1,2,7,9,9,"Yes",4,3,1,1
"3763","2017-04-05",1,2,6,8,8,"Yes",2,4,1,1
"3764","2017-04-05",6,19,12,31,31,"No",7,5,8,11
"3765","2017-04-05",2,5,2,7,5,"Yes",2,0,3,2
"3766","2017-04-05",5,10,2,12,12,"No",0,2,5,5
"3767","2017-04-05",2,5,3,8,8,"Yes",2,1,2,3
"3768","2017-04-05",2,4,1,5,5,"Yes",1,NA,2,2
"3769","2017-04-05",4,8,4,12,13,"Yes",0,4,4,4
"3770","2017-04-05",9,16,4,20,NA,"Yes",2,2,8,8
"3771","2017-04-05",3,7,1,8,8,"No",0,1,3,4
"3772","2017-04-05",10,21,9,30,20,"No",4,5,10,11
"3773","2017-04-05",3,4,0,4,4,"Yes",0,0,2,2
"3774","2017-04-05",1,2,2,4,4,"No",1,1,1,1
"3775","2017-04-05",4,8,12,20,22,"Yes",5,7,4,4
"3776","2017-04-05",NA,9,4,13,NA,"Yes",1,3,4,5
"3777","2017-04-05",NA,8,4,12,NA,"No",3,1,4,4
"3778","2017-04-05",1,7,4,11,9,"No",2,2,2,5
"3779","2017-04-05",4,8,2,10,10,"Yes",2,0,4,4
"3780","2017-04-05",4,9,9,18,18,"No",6,3,4,5
"3781","2017-04-05",3,5,5,10,10,"Yes",4,1,2,3
"3782","2017-04-05",1,2,5,7,7,"Yes",3,2,1,1
"3783","2017-04-05",2,5,3,8,8,"Yes",1,2,3,2
"3784","2017-04-05",8,22,12,34,32,NA,8,4,12,10
"3785","2017-04-05",1,8,4,12,12,"No",2,2,4,4
"3786","2017-04-05",8,16,5,21,21,"Yes",3,2,7,9
"3787","2017-04-05",3,6,7,13,13,"No",2,5,3,3
"3788","2017-04-05",3,6,7,13,13,"Yes",5,2,3,3
"3789","2017-04-05",5,13,9,22,22,"Yes",5,4,9,4
"3790","2017-04-05",3,7,5,12,13,"Yes",1,4,3,4
"3791","2017-04-05",1,1,2,3,3,"Yes",0,2,0,1
"3792","2017-04-05",4,8,4,12,13,"Yes",NA,4,4,4
"3793","2017-04-05",4,4,5,9,9,"Yes",3,2,2,2
"3794","2017-04-05",3,6,8,14,14,"Yes",5,3,3,3
"3795","2017-04-05",6,11,8,19,19,"Yes",3,5,5,6
"3796","2017-04-05",3,10,3,13,13,"Yes",1,2,4,6
"3797","2017-04-05",3,10,7,17,17,"Yes",3,4,5,5
"3798","2017-04-05",6,10,5,15,18,"Yes",2,3,5,5
"3799","2017-04-05",1,7,3,10,10,"No",2,1,3,4
"3800","2017-04-05",1,4,1,5,5,"Yes",1,0,3,1
"3801","2017-04-05",1,3,5,8,8,"Yes",3,2,1,2
"3802","2017-04-05",8,17,8,25,25,"Yes",5,3,9,8
"3803","2017-04-05",5,10,11,21,24,"No",6,5,5,5
"3804","2017-04-05",NA,110,20,130,NA,"Yes",10,10,40,70
"3805","2017-04-05",3,6,10,16,16,"Yes",5,5,3,3
"3806","2017-04-05",3,6,3,9,9,"No",2,1,3,3
"3807","2017-04-05",3,9,4,13,13,"Yes",1,3,3,6
"3808","2017-04-05",4,12,1,13,15,"Yes",0,1,4,8
"3809","2017-04-05",3,6,9,15,22,"No",2,7,3,3
"3810","2017-04-05",1,3,7,10,10,"Yes",3,4,1,2
"3811","2017-04-05",1,6,4,10,10,"Yes",2,2,2,4
"3812","2017-04-05",1,4,1,5,5,"No",1,0,1,3
"3813","2017-04-05",6,13,10,23,23,"No",4,6,8,5
"3814","2017-04-05",2,10,8,18,18,NA,3,5,5,5
"3815","2017-04-05",5,10,4,14,14,"Yes",2,2,5,5
"3816","2017-04-05",2,5,3,8,8,"Yes",2,1,2,3
"3817","2017-04-05",7,12,2,14,15,"Yes",0,2,7,5
"3818","2017-04-05",4,9,1,10,11,"No",1,0,4,5
"3819","2017-04-05",30,64,108,172,162,"No",51,57,31,33
"3820","2017-04-05",5,11,2,13,13,"Yes",1,1,5,6
"3821","2017-04-05",4,12,6,18,18,"Yes",3,3,5,7
"3822","2017-04-05",1,2,2,4,4,"No",0,2,1,1
"3823","2017-04-05",4,4,5,9,21,"Yes",1,4,2,2
"3824","2017-04-05",4,9,2,11,11,"Yes",2,0,4,5
"3825","2017-04-05",5,12,14,26,26,"Yes",7,7,6,6
"3826","2017-04-05",4,14,5,19,15,"Yes",2,3,5,9
"3827","2017-04-05",5,10,10,20,20,"No",3,7,6,4
"3828",NA,7,20,10,30,30,"No",6,4,10,10
"3829","2017-04-05",6,12,4,16,18,"Yes",4,0,6,6
"3830","2017-04-05",5,8,9,17,17,"Yes",4,5,4,4
"3831","2017-04-05",4,13,4,17,17,"Yes",1,3,6,7
"3832","2017-04-05",3,5,3,8,8,"No",1,2,1,4
"3833","2017-04-05",1,3,0,3,3,"Yes",0,0,3,0
"3834","2017-04-05",6,12,9,21,21,"Yes",6,3,6,6
"3835","2017-04-05",6,11,9,20,20,"No",5,4,6,5
"3836","2017-04-05",6,12,9,21,14,"Yes",3,6,9,3
"3837","2017-04-05",3,7,5,12,12,"No",2,3,4,3
"3838","2017-04-05",3,6,11,17,17,"Yes",6,5,3,3
"3839","2017-04-05",1,2,8,10,10,"No",6,2,1,1
"3840",NA,2,4,3,7,7,"Yes",1,2,2,2
"3841","2017-04-06",1,5,4,9,9,"Yes",2,2,3,2
"3842","2017-04-06",1,2,5,7,7,"Yes",2,3,1,1
"3843","2017-04-06",1,2,1,3,3,"Yes",0,1,1,1
"3844","2017-04-06",4,13,5,18,18,"Yes",2,3,6,7
"3845","2017-04-06",3,7,8,15,15,"Yes",3,5,4,3
"3846","2017-04-06",2,5,6,11,11,"No",2,4,2,3
"3847","2017-04-06",2,4,6,10,10,"Yes",3,3,2,2
"3848","2017-04-06",1,2,7,9,9,"No",4,3,1,1
"3849","2017-04-06",3,6,4,10,10,"No",3,1,3,3
"3850","2017-04-06",6,12,8,20,20,"No",4,4,6,6
"3851","2017-04-06",4,8,9,17,17,"Yes",4,5,4,4
"3852","2017-04-06",1,2,4,6,6,"Yes",1,3,1,1
"3853","2017-04-06",6,12,8,20,34,"Yes",6,2,6,6
"3854","2017-04-06",4,11,7,18,18,"Yes",3,4,4,7
"3855","2017-04-06",4,8,8,16,16,"Yes",4,4,4,4
"3856","2017-04-06",2,8,7,15,15,"No",2,5,4,4
"3857","2017-04-06",2,8,3,11,11,"Yes",2,1,3,5
"3858","2017-04-06",3,8,5,13,13,"Yes",4,1,3,5
"3859","2017-04-06",3,6,7,13,13,"Yes",5,2,3,3
"3860","2017-04-06",1,4,1,5,5,"Yes",1,NA,3,1
"3861","2017-04-06",1,2,3,5,5,"Yes",1,2,1,1
"3862","2017-04-06",3,10,4,14,14,"Yes",1,3,5,5
"3863","2017-04-06",3,6,6,12,12,"Yes",2,4,3,3
"3864","2017-04-06",6,13,7,20,22,"Yes",4,3,5,8
"3865","2017-04-06",2,3,1,4,4,"Yes",1,NA,2,1
"3866","2017-04-06",1,6,0,6,6,"No",0,0,3,3
"3867","2017-04-06",1,4,0,4,4,"Yes",0,0,1,3
"3868","2017-04-06",5,9,12,21,21,"Yes",5,7,5,4
"3869","2017-04-06",1,3,3,6,6,"No",2,1,1,2
"3870","2017-04-06",2,2,4,6,6,"Yes",2,2,1,1
"3871","2017-04-06",3,6,9,15,15,"Yes",3,6,3,3
"3872","2017-04-06",1,10,1,11,11,"Yes",1,0,5,5
"3873","2017-04-06",2,5,4,9,9,"Yes",3,1,3,2
"3874","2017-04-06",5,7,10,17,17,"No",4,6,3,4
"3875","2017-04-06",14,21,8,29,29,"Yes",6,2,13,8
"3876","2017-04-06",4,8,13,21,21,NA,5,8,4,4
"3877","2017-04-06",NA,50,15,65,NA,"Yes",7,8,20,30
"3878","2017-04-06",2,8,8,16,16,"Yes",2,6,4,4
"3879","2017-04-06",NA,7,12,19,NA,"Yes",4,8,3,4
"3880","2017-04-06",3,7,8,15,15,"No",3,5,2,5
"3881","2017-04-06",2,9,3,12,12,NA,1,2,3,6
"3882","2017-04-06",1,6,5,11,11,"Yes",2,3,2,4
"3883","2017-04-06",4,12,3,15,15,"Yes",2,1,4,8
"3884","2017-04-06",9,17,16,33,32,"Yes",7,9,8,9
"3885","2017-04-06",10,18,10,28,28,"Yes",5,5,10,8
"3886","2017-04-06",10,20,29,49,45,"Yes",13,16,10,10
"3887","2017-04-06",1,2,1,3,4,NA,0,1,1,1
"3888","2017-04-06",3,11,7,18,18,"No",5,2,3,8
"3889","2017-04-06",3,11,7,18,18,"Yes",4,3,6,5
"3890","2017-04-06",1,4,2,6,6,"Yes",0,2,1,3
"3891","2017-04-06",3,7,6,13,15,"Yes",2,4,3,4
"3892","2017-04-06",3,5,10,15,15,"No",4,6,2,3
"3893","2017-04-06",4,9,7,16,13,"Yes",6,1,5,4
"3894","2017-04-06",1,5,3,8,8,"Yes",1,2,1,4
"3895","2017-04-06",6,12,6,18,18,"Yes",3,3,6,6
"3896","2017-04-06",2,2,2,4,4,"Yes",2,0,1,1
"3897","2017-04-06",4,8,6,14,15,"Yes",2,4,4,4
"3898","2017-04-06",1,2,4,6,6,"Yes",2,2,1,1
"3899","2017-04-06",5,14,7,21,23,"Yes",4,3,6,8
"3900","2017-04-06",1,5,1,6,5,NA,NA,1,3,2
"3901","2017-04-06",9,16,9,25,25,"Yes",6,3,8,8
"3902","2017-04-06",1,5,0,5,5,"Yes",0,0,0,5
"3903","2017-04-06",5,11,5,16,16,"Yes",1,4,7,4
"3904","2017-04-06",1,3,3,6,6,"Yes",2,1,1,2
"3905","2017-04-06",3,7,8,15,15,"Yes",4,4,4,3
"3906",NA,2,5,5,10,10,"Yes",3,2,3,2
"3907","2017-04-06",4,7,10,17,17,"No",6,4,4,3
"3908","2017-04-06",2,8,0,8,8,"Yes",0,0,4,4
"3909","2017-04-06",7,13,6,19,19,"Yes",2,4,7,6
"3910","2017-04-06",3,5,13,18,18,"Yes",8,5,3,2
"3911","2017-04-06",1,5,2,7,8,"Yes",1,1,4,1
"3912","2017-04-06",6,12,11,23,23,"No",4,7,6,6
"3913","2017-04-06",NA,280,0,280,NA,"Yes",0,0,200,80
"3914","2017-04-06",2,3,3,6,6,"Yes",1,2,1,2
"3915","2017-04-06",8,13,7,20,24,"No",2,5,5,8
"3916","2017-04-06",4,11,3,14,14,"Yes",2,1,5,6
"3917","2017-04-06",2,10,7,17,17,"Yes",3,4,7,3
"3918","2017-04-06",2,4,6,10,16,"Yes",3,3,2,2
"3919","2017-04-06",3,5,9,14,14,"Yes",3,6,2,3
"3920","2017-04-06",7,14,31,45,45,"No",16,15,7,7
"3921","2017-04-06",1,4,3,7,3,"Yes",2,1,3,1
"3922","2017-04-06",1,21,0,21,21,"No",NA,NA,17,4
"3923","2017-04-06",1,3,3,6,6,"Yes",1,2,2,1
"3924","2017-04-06",11,18,12,30,30,"Yes",8,4,6,12
"3925","2017-04-06",3,3,2,5,5,"No",1,1,1,2
"3926","2017-04-06",7,14,11,25,25,"Yes",5,6,7,7
"3927","2017-04-06",3,7,3,10,10,"Yes",1,2,3,4
"3928","2017-04-06",3,9,6,15,15,"Yes",2,4,4,5
"3929","2017-04-06",3,6,4,10,10,"No",4,0,4,2
"3930","2017-04-06",5,8,1,9,9,"Yes",NA,1,5,3
"3931","2017-04-06",2,5,3,8,8,"Yes",1,2,1,4
"3932","2017-04-06",2,6,3,9,9,"Yes",3,NA,2,4
"3933","2017-04-06",2,9,1,10,10,"Yes",1,0,6,3
"3934","2017-04-06",3,8,5,13,13,"No",2,3,4,4
"3935","2017-04-06",5,12,6,18,23,"No",0,6,5,7
"3936","2017-04-06",3,11,7,18,18,"No",3,4,3,8
"3937","2017-04-06",4,9,10,19,19,"No",5,5,2,7
"3938","2017-04-06",8,16,7,23,26,"Yes",3,4,8,8
"3939","2017-04-13",1,8,4,12,12,"Yes",2,2,3,5
"3940","2017-04-06",2,1,9,10,10,"Yes",2,7,NA,1
"3941","2017-04-06",4,0,0,0,NA,"Yes",NA,NA,NA,NA
"3942","2017-04-06",1,4,3,7,7,"Yes",1,2,3,1
"3943","2017-04-06",6,10,8,18,NA,"Yes",3,5,4,6
"3944","2017-04-06",3,4,10,14,14,"No",3,7,2,2
"3945","2017-04-06",12,21,6,27,27,"Yes",3,3,11,10
"3946","2017-04-06",1,9,3,12,12,"Yes",1,2,3,6
"3947","2017-04-06",6,8,4,12,12,"Yes",1,3,4,4
"3948","2017-04-06",3,9,7,16,16,"No",1,6,3,6
"3949","2017-04-06",1,4,0,4,4,"No",0,0,2,2
"3950","2017-04-06",1,5,2,7,7,"Yes",1,1,3,2
"3951","2017-04-06",2,7,7,14,14,"Yes",5,2,2,5
"3952","2017-04-06",3,10,0,10,7,"Yes",0,0,5,5
"3953","2017-04-06",3,4,2,6,6,"No",1,1,2,2
"3954","2017-04-06",5,9,11,20,20,"Yes",5,6,4,5
"3955","2017-04-06",4,7,3,10,10,"Yes",1,2,2,5
"3956","2017-04-06",6,10,5,15,15,"Yes",2,3,6,4
"3957","2017-04-06",4,9,3,12,12,"No",1,2,4,5
"3958","2017-04-06",1,1,5,6,6,"Yes",4,1,0,1
"3959","2017-04-06",3,7,6,13,14,"Yes",1,5,3,4
"3960","2017-04-06",9,17,7,24,24,"Yes",4,3,8,9
"3961","2017-04-06",1,9,1,10,10,"No",0,1,6,3
"3962","2017-04-06",7,8,0,8,17,"Yes",0,0,5,3
"3963","2017-04-06",3,4,4,8,8,"No",2,2,2,2
"3964","2017-04-06",NA,0,0,0,NA,"Yes",NA,NA,NA,NA
"3965","2017-04-06",4,2,0,2,2,"Yes",NA,NA,1,1
"3966","2017-04-06",6,10,1,11,11,"Yes",0,1,6,4
"3967","2017-04-06",3,6,4,10,10,"No",2,2,3,3
"3968","2017-04-06",2,4,5,9,9,"Yes",1,4,2,2
"3969","2017-04-06",2,4,6,10,9,"Yes",4,2,2,2
"3970","2017-04-06",4,12,7,19,19,"Yes",4,3,4,8
"3971","2017-04-06",1,2,3,5,5,"Yes",3,0,1,1
"3972","2017-04-06",8,17,3,20,28,"Yes",1,2,9,8
"3973","2017-04-13",2,4,0,4,4,"No",0,NA,3,1
"3974","2017-04-06",9,18,17,35,NA,"Yes",10,7,9,9
"3975","2017-04-06",3,5,5,10,10,"Yes",2,3,1,4
"3976","2017-04-06",2,4,7,11,11,"Yes",4,3,1,3
"3977","2017-04-06",5,11,7,18,21,"No",3,4,6,5
"3978","2017-04-06",4,4,8,12,12,"Yes",6,2,1,3
"3979","2017-04-06",7,14,4,18,18,"Yes",0,4,7,7
"3980","2017-04-06",2,6,5,11,11,"Yes",2,3,2,4
"3981","2017-04-06",2,3,6,9,9,"Yes",4,2,1,2
"3982","2017-04-06",4,12,6,18,18,"No",2,4,6,6
"3983","2017-04-06",1,5,0,5,5,"Yes",0,0,2,3
"3984","2017-04-06",2,12,2,14,14,"No",1,1,7,5
"3985","2017-04-06",5,11,5,16,NA,"Yes",1,4,5,6
"3986","2017-04-06",4,9,3,12,12,"No",2,1,4,5
"3987","2017-04-06",3,3,5,8,8,"No",4,1,1,2
"3988","2017-04-06",1,5,1,6,6,"Yes",0,1,2,3
"3989","2017-04-06",6,11,5,16,16,"No",1,4,5,6
"3990","2017-04-06",4,8,5,13,16,"No",2,3,4,4
"3991","2017-04-06",4,8,3,11,11,"Yes",2,1,4,4
"3992","2017-04-06",2,7,3,10,11,"No",1,2,4,3
"3993","2017-04-06",5,0,0,0,NA,"No",NA,NA,NA,NA
"3994","2017-04-06",3,5,5,10,10,"Yes",1,4,1,4
"3995","2017-04-06",4,9,4,13,12,"Yes",1,3,6,3
"3996","2017-04-06",1,4,2,6,6,"Yes",2,0,2,2
"3997","2017-04-06",2,5,10,15,15,"No",3,7,2,3
"3998","2017-04-06",5,5,6,11,12,"Yes",2,4,1,4
"3999","2017-04-06",3,7,4,11,10,"Yes",1,3,4,3
"4000","2017-04-06",1,1,3,4,4,"Yes",0,3,0,1
"4001","2017-04-06",10,20,12,32,32,"Yes",5,7,10,10
"4002","2017-04-06",2,4,8,12,12,"Yes",3,5,2,2
"4003","2017-04-06",3,7,4,11,15,"No",0,4,3,4
"4004","2017-04-06",1,9,4,13,13,"Yes",1,3,6,3
"4005","2017-04-06",1,6,2,8,7,"Yes",1,1,1,5
"4006","2017-04-06",3,6,7,13,13,"No",4,3,3,3
"4007","2017-04-06",5,8,12,20,20,"Yes",7,5,5,3
"4008","2017-04-06",3,7,6,13,13,"Yes",2,4,3,4
"4009","2017-04-06",4,11,6,17,17,"No",3,3,5,6
"4010","2017-04-06",3,8,5,13,13,"Yes",0,5,4,4
"4011","2017-04-06",4,10,7,17,22,"Yes",5,2,6,4
"4012","2017-04-06",4,8,5,13,13,"Yes",2,3,4,4
"4013","2017-04-06",6,12,10,22,22,"Yes",6,4,6,6
"4014","2017-04-06",1,2,1,3,3,"Yes",0,1,1,1
"4015","2017-04-06",8,16,5,21,21,"Yes",5,0,8,8
"4016","2017-04-06",7,10,10,20,24,"Yes",4,6,5,5
"4017","2017-04-06",5,11,6,17,18,"No",1,5,5,6
"4018","2017-04-06",2,5,4,9,9,NA,2,2,3,2
"4019","2017-04-06",2,3,1,4,4,"No",0,1,1,2
"4020","2017-04-06",18,45,17,62,NA,"Yes",10,7,25,20
"4021","2017-04-06",5,9,12,21,21,"Yes",4,8,5,4
"4022","2017-04-06",4,10,6,16,16,"Yes",2,4,5,5
"4023","2017-04-06",7,9,11,20,25,"Yes",3,8,4,5
"4024","2017-04-06",1,3,2,5,5,"No",1,1,1,2
"4025","2017-04-06",1,2,6,8,8,"No",3,3,1,1
"4026","2017-04-06",2,8,2,10,11,"No",2,0,2,6
"4027","2017-04-06",7,10,20,30,30,"No",5,15,6,4
"4028","2017-04-06",2,6,8,14,14,"Yes",1,7,3,3
"4029","2017-04-06",5,6,6,12,16,"Yes",3,3,3,3
"4030","2017-04-06",6,13,15,28,28,"Yes",8,7,6,7
"4031","2017-04-06",2,8,0,8,8,"Yes",0,0,4,4
"4032","2017-04-06",9,18,16,34,24,"No",8,8,7,11
"4033","2017-04-06",2,3,0,3,3,"No",0,0,3,0
"4034","2017-04-06",7,8,3,11,11,"Yes",1,2,5,3
"4035","2017-04-06",4,9,6,15,16,"Yes",5,1,6,3
"4036","2017-04-06",3,6,6,12,12,"Yes",2,4,3,3
"4037","2017-04-06",4,2,7,9,9,"No",2,5,1,1
"4038","2017-04-06",4,0,0,0,24,"No",NA,NA,NA,NA
"4039","2017-04-06",2,3,3,6,6,"Yes",1,2,2,1
"4040","2017-04-06",NA,3,0,3,NA,"No",0,0,1,2
"4041","2017-04-06",1,2,3,5,5,"Yes",2,1,1,1
"4042","2017-04-06",5,14,5,19,18,"No",1,4,9,5
"4043","2017-04-06",2,4,9,13,13,"Yes",7,2,2,2
"4044","2017-04-06",6,7,8,15,16,"Yes",3,5,5,2
"4045","2017-04-06",6,15,7,22,22,"Yes",4,3,8,7
"4046","2017-04-06",1,6,6,12,12,"Yes",3,3,4,2
"4047","2017-04-06",4,8,6,14,15,"Yes",1,5,3,5
"4048","2017-04-06",8,16,34,50,48,"No",16,18,8,8
"4049","2017-04-06",1,4,2,6,6,"Yes",2,0,2,2
"4050","2017-04-06",6,15,5,20,22,"No",1,4,6,9
"4051","2017-04-06",13,33,20,53,53,"No",10,10,13,20
"4052","2017-04-06",7,15,8,23,23,"No",2,6,7,8
"4053","2017-04-06",7,10,4,14,15,"Yes",2,2,4,6
"4054","2017-04-05",7,13,18,31,31,"No",10,8,6,7
"4055","2017-04-06",5,10,2,12,16,"No",2,0,5,5
"4056","2017-04-06",5,0,0,0,NA,"Yes",NA,NA,NA,NA
"4057","2017-04-06",7,14,8,22,22,"Yes",4,4,6,8
"4058","2017-04-06",3,11,3,14,14,"Yes",1,2,6,5
"4059","2017-04-06",4,8,13,21,21,"Yes",6,7,4,4
"4060","2017-04-06",2,3,4,7,7,"Yes",1,3,1,2
"4061","2017-04-06",1,3,0,3,3,"No",0,0,3,0
"4062","2017-04-06",6,13,5,18,NA,"No",1,4,6,7
"4063","2017-04-06",1,6,2,8,6,"Yes",1,1,3,3
"4064","2017-04-06",1,2,3,5,5,"Yes",3,0,1,1
"4065","2017-04-06",4,10,7,17,18,"Yes",3,4,4,6
"4066","2017-04-06",6,15,7,22,21,"Yes",3,4,6,9
"4067","2017-04-06",3,10,5,15,15,"No",3,2,3,7
"4068","2017-04-06",1,6,3,9,9,"Yes",3,0,2,4
"4069","2017-04-06",1,3,2,5,5,"Yes",0,2,1,2
"4070","2017-04-06",5,12,3,15,16,"Yes",1,2,6,6
"4071","2017-04-06",1,6,2,8,8,"Yes",0,2,5,1
"4072","2017-04-06",4,0,0,0,NA,"Yes",NA,NA,NA,NA
"4073","2017-04-06",1,4,3,7,7,"Yes",2,1,1,3
"4074","2017-04-06",4,8,7,15,15,"No",6,1,5,3
"4075","2017-04-06",7,12,1,13,14,"No",1,0,6,6
"4076","2017-04-06",3,9,6,15,15,"No",3,3,6,3
"4077","2017-04-06",5,12,6,18,18,"Yes",3,3,6,6
"4078","2017-04-06",1,7,3,10,10,"Yes",3,0,4,3
"4079",NA,8,16,26,42,42,"No",14,12,8,8
"4080","2017-04-06",3,5,4,9,9,"Yes",1,3,3,2
"4081","2017-04-06",2,5,1,6,6,"Yes",0,1,2,3
"4082","2017-04-06",6,13,7,20,20,"Yes",6,1,7,6
"4083","2017-04-06",2,4,3,7,7,"Yes",0,3,0,4
"4084","2017-04-06",3,6,3,9,9,"No",1,2,3,3
"4085","2017-04-06",2,3,2,5,5,"Yes",NA,2,2,1
"4086","2017-04-06",2,4,10,14,14,"No",6,4,2,2
"4087","2017-04-06",NA,23,528,551,NA,"No",236,292,10,13
"4088","2017-04-06",2,3,5,8,11,"No",4,1,1,2
"4089","2017-04-06",2,4,6,10,10,"No",4,2,2,2
"4090","2017-04-06",2,4,2,6,5,"Yes",NA,2,1,3
"4091","2017-04-06",2,2,7,9,9,"Yes",3,4,1,1
"4092","2017-04-06",3,5,7,12,13,"Yes",5,2,2,3
"4093","2017-04-06",1,16,1,17,17,"Yes",1,0,9,7
"4094","2017-04-06",2,4,9,13,13,"Yes",5,4,1,3
"4095","2017-04-06",2,4,5,9,9,"No",5,0,2,2
"4096","2017-04-06",8,16,2,18,18,"Yes",0,2,8,8
"4097","2017-04-13",6,12,16,28,28,"Yes",7,9,6,6
"4098","2017-04-06",7,4,10,14,14,"Yes",6,4,2,2
"4099","2017-04-06",2,4,4,8,8,"No",3,1,3,1
"4100","2017-04-06",3,8,2,10,10,"Yes",1,1,2,6
"4101","2017-04-06",4,13,9,22,22,"Yes",6,3,4,9
"4102","2017-04-06",2,7,1,8,8,"Yes",1,0,4,3
"4103","2017-04-06",2,2,6,8,7,"Yes",4,2,1,1
"4104","2017-04-06",6,10,7,17,17,"Yes",4,3,6,4
"4105","2017-04-06",3,9,5,14,14,"Yes",3,2,6,3
"4106","2017-04-06",5,6,6,12,12,"Yes",2,4,3,3
"4107","2017-04-06",8,16,19,35,35,"Yes",12,7,8,8
"4108","2017-04-06",2,4,6,10,10,"Yes",5,1,2,2
"4109","2017-04-06",NA,2,1,3,NA,"No",NA,1,1,1
"4110","2017-04-06",6,12,18,30,30,"No",8,10,6,6
"4111","2017-04-06",2,6,0,6,6,"No",0,0,5,1
"4112","2017-04-06",6,12,5,17,17,"No",4,1,6,6
"4113","2017-04-06",7,14,12,26,26,"Yes",5,7,7,7
"4114","2017-03-30",3,6,8,14,15,"Yes",5,3,3,3
"4115","2017-04-06",1,4,3,7,7,"Yes",1,2,1,3
"4116","2017-04-06",1,5,1,6,7,"Yes",0,1,4,1
"4117","2017-04-06",3,4,3,7,7,"Yes",NA,3,1,3
"4118","2017-04-07",4,7,7,14,14,"Yes",2,5,3,4
"4119","2017-04-07",4,0,0,0,NA,"Yes",NA,NA,NA,NA
"4120","2017-04-07",5,8,7,15,15,"Yes",4,3,4,4
"4121","2017-04-07",4,12,5,17,24,"Yes",2,3,5,7
"4122","2017-04-07",1,6,1,7,7,NA,NA,1,4,2
"4123","2017-04-07",5,9,7,16,16,"No",5,2,5,4
"4124","2017-04-07",1,3,0,3,3,"Yes",0,0,3,0
"4125",NA,1,4,3,7,8,NA,2,1,2,2
"4126","2017-04-07",3,7,7,14,14,"Yes",2,5,5,2
"4127","2017-04-07",5,10,7,17,17,NA,3,4,5,5
"4128","2017-04-07",1,5,4,9,9,"Yes",2,2,1,4
"4129","2017-04-07",8,12,2,14,14,"No",0,2,8,4
"4130","2017-04-07",9,18,15,33,33,"No",9,6,9,9
"4131","2017-04-07",1,5,5,10,10,"Yes",4,1,3,2
"4132","2017-04-07",4,6,7,13,11,"Yes",3,4,2,4
"4133","2017-04-07",4,11,4,15,15,"Yes",1,3,5,6
"4134","2017-04-07",7,13,12,25,36,"Yes",5,7,7,6
"4135","2017-04-07",4,8,15,23,24,"No",7,8,4,4
"4136","2017-04-07",1,4,4,8,8,"Yes",0,4,3,1
"4137","2017-04-07",3,6,4,10,10,"Yes",2,2,4,2
"4138","2017-04-07",1,7,1,8,8,"Yes",NA,1,4,3
"4139","2017-04-07",5,10,9,19,19,"No",7,2,5,5
"4140","2017-04-07",1,7,14,21,21,"Yes",3,11,2,5
"4141","2017-04-07",1,1,5,6,6,"Yes",2,3,1,0
"4142","2017-04-07",4,7,6,13,13,"Yes",3,3,4,3
"4143","2017-04-07",2,3,9,12,12,"No",3,6,1,2
"4144","2017-04-07",4,8,9,17,17,"Yes",5,4,4,4
"4145","2017-04-07",1,4,0,4,4,"Yes",0,0,2,2
"4146","2017-04-07",3,5,5,10,10,"Yes",2,3,2,3
"4147","2017-04-07",2,4,3,7,7,"Yes",3,0,2,2
"4148","2017-04-08",5,13,5,18,20,"Yes",1,4,6,7
"4149","2017-04-07",1,2,7,9,9,"Yes",1,6,1,1
"4150","2017-04-07",1,5,5,10,10,"Yes",4,1,2,3
"4151","2017-04-07",2,4,5,9,9,"Yes",2,3,2,2
"4152","2017-04-07",3,5,4,9,9,"Yes",2,2,2,3
"4153","2017-04-14",3,6,6,12,13,"Yes",3,3,3,3
"4154","2017-04-07",3,7,5,12,12,"Yes",3,2,4,3
"4155","2017-05-02",7,13,15,28,28,"No",6,9,7,6
"4156","2017-04-07",8,12,3,15,15,"No",1,2,8,4
"4157","2017-04-07",7,16,11,27,24,"Yes",6,5,7,9
"4158","2017-04-07",2,5,1,6,6,"Yes",1,0,4,1
"4159","2017-04-07",9,26,9,35,35,"No",4,5,9,17
"4160","2017-04-07",1,6,1,7,7,"Yes",1,NA,3,3
"4161","2017-04-07",7,11,13,24,27,"Yes",4,9,5,6
"4162","2017-04-07",1,9,3,12,12,"Yes",1,2,4,5
"4163","2017-04-07",9,18,14,32,32,"No",8,6,9,9
"4164","2017-04-07",8,15,15,30,30,"Yes",5,10,2,13
"4165","2017-04-07",7,12,18,30,30,"Yes",10,8,5,7
"4166","2017-04-07",2,4,8,12,12,"Yes",3,5,2,2
"4167","2017-04-07",4,9,0,9,12,"Yes",0,0,5,4
"4168","2017-04-07",1,3,3,6,6,"Yes",0,3,2,1
"4169","2017-04-07",2,11,5,16,16,"No",4,1,3,8
"4170","2017-04-07",NA,2,17,19,NA,"No",7,10,0,2
"4171","2017-04-07",8,17,15,32,32,"No",6,9,8,9
"4172","2017-04-07",1,7,3,10,10,"No",1,2,4,3
"4173","2017-04-07",6,12,9,21,22,"No",4,5,6,6
"4174","2017-04-07",5,11,8,19,19,"No",3,5,5,6
"4175","2017-04-07",9,19,14,33,45,NA,6,8,9,10
"4176","2017-04-07",5,10,15,25,25,"Yes",8,7,5,5
"4177","2017-04-07",10,21,1,22,NA,"Yes",0,1,11,10
"4178","2017-04-07",5,9,9,18,18,"No",3,6,4,5
"4179","2017-04-07",4,8,14,22,22,"Yes",6,8,4,4
"4180","2017-04-07",3,7,11,18,19,"Yes",5,6,3,4
"4181","2017-04-07",13,28,7,35,35,"No",3,4,13,15
"4182","2017-04-07",1,3,5,8,8,"Yes",2,3,1,2
"4183","2017-04-07",13,25,12,37,37,"No",7,5,13,12
"4184","2017-04-07",2,7,3,10,9,"Yes",1,2,3,4
"4185","2017-04-07",10,20,15,35,42,"Yes",7,8,10,10
"4186","2017-04-07",15,23,10,33,NA,"Yes",4,6,18,5
"4187","2017-04-07",8,16,7,23,23,NA,5,2,8,8
"4188","2017-04-07",6,10,12,22,22,"No",4,8,6,4
"4189","2017-04-07",4,11,7,18,18,"Yes",4,3,5,6
"4190","2017-04-07",7,14,11,25,25,"No",6,5,7,7
"4191","2017-04-07",1,13,15,28,4,"Yes",8,7,7,6
"4192","2017-04-07",4,7,11,18,18,"No",2,9,1,6
"4193","2017-04-07",9,25,5,30,30,"Yes",2,3,10,15
"4194","2017-04-07",4,13,5,18,18,"No",2,3,6,7
"4195","2017-04-07",6,11,19,30,30,"No",8,11,6,5
"4196","2017-04-07",1,4,0,4,4,NA,0,0,4,0
"4197","2017-04-07",7,19,13,32,32,"No",6,7,14,5
"4198","2017-04-07",6,15,7,22,NA,"Yes",2,5,7,8
"4199","2017-04-07",9,15,20,35,35,"No",12,8,5,10
"4200","2017-04-07",5,10,9,19,19,"No",6,3,5,5
"4201",NA,5,14,15,29,29,"Yes",7,8,5,9
"4202","2017-04-07",NA,0,0,0,NA,"No",0,0,0,0
"4203","2017-04-07",7,15,11,26,26,"Yes",7,4,5,10
"4204","2017-04-07",1,3,3,6,10,"Yes",2,1,2,1
"4205","2017-04-07",NA,55,15,70,NA,"No",5,10,10,45
"4206","2017-04-07",1,4,3,7,7,"Yes",0,3,3,1
"4207","2017-04-07",5,10,5,15,23,"No",1,4,5,5
"4208","2017-04-07",4,9,8,17,17,"No",4,4,4,5
"4209","2017-04-07",3,6,9,15,15,"Yes",3,6,3,3
"4210","2017-04-07",2,7,3,10,8,"Yes",2,1,3,4
"4211","2017-04-07",3,7,3,10,10,"Yes",1,2,3,4
"4212","2017-04-07",7,11,9,20,NA,"Yes",4,5,4,7
"4213","2017-04-07",1,2,3,5,5,"No",2,1,1,1
"4214","2017-04-07",6,10,1,11,11,"No",1,0,6,4
"4215","2017-04-07",4,9,5,14,13,"Yes",3,2,5,4
"4216","2017-04-07",4,8,10,18,12,"No",5,5,4,4
"4217","2017-04-07",2,5,7,12,12,"Yes",3,4,2,3
"4218","2017-04-07",1,9,0,9,9,"Yes",NA,NA,3,6
"4219","2017-04-07",2,6,8,14,14,"No",2,6,2,4
"4220","2017-04-07",13,26,32,58,58,"Yes",12,20,13,13
"4221","2017-04-07",8,17,3,20,20,"Yes",1,2,8,9
"4222","2017-04-07",1,2,2,4,4,"Yes",2,0,1,1
"4223","2017-04-07",6,7,0,7,8,"No",0,0,2,5
"4224","2017-04-07",6,12,18,30,30,"Yes",10,8,6,6
"4225","2017-04-07",6,10,8,18,18,"Yes",5,3,6,4
"4226","2017-04-07",4,8,9,17,17,"Yes",4,5,4,4
"4227","2017-04-07",3,11,5,16,16,"Yes",2,3,5,6
"4228","2017-04-07",2,6,5,11,11,"Yes",3,2,3,3
"4229","2017-04-07",4,6,4,10,9,"Yes",1,3,4,2
"4230","2017-04-04",5,10,9,19,19,"No",3,6,5,5
"4231","2017-04-07",8,21,9,30,30,NA,4,5,11,10
"4232","2017-04-07",7,15,11,26,26,"No",6,5,8,7
"4233","2017-04-07",4,8,13,21,21,"No",7,6,4,4
"4234","2017-04-07",13,23,17,40,40,"Yes",9,8,13,10
"4235","2017-04-08",6,12,3,15,14,"No",NA,3,6,6
"4236","2017-04-07",5,11,7,18,22,"Yes",4,3,5,6
"4237",NA,3,6,13,19,18,"Yes",5,8,3,3
"4238","2017-04-07",5,10,6,16,18,"No",3,3,6,4
"4239","2017-04-09",3,4,5,9,9,"No",3,2,2,2
"4240","2017-04-07",3,8,4,12,12,"Yes",2,2,3,5
"4241","2017-04-07",1,3,3,6,6,"Yes",0,3,2,1
"4242","2017-04-07",1,7,0,7,9,"Yes",NA,0,1,6
"4243","2017-04-07",3,5,6,11,11,"Yes",2,4,2,3
"4244","2017-04-07",1,3,4,7,7,"Yes",1,3,2,1
"4245","2017-04-07",4,9,12,21,21,"Yes",5,7,5,4
"4246","2017-04-07",2,4,9,13,13,"Yes",3,6,2,2
"4247","2017-04-07",5,12,2,14,15,"Yes",1,1,6,6
"4248","2017-04-07",2,5,0,5,7,"Yes",0,0,2,3
"4249","2017-04-07",2,10,8,18,18,"No",3,5,5,5
"4250","2017-04-07",3,8,7,15,15,"No",3,4,5,3
"4251","2017-04-07",6,10,7,17,17,"Yes",4,3,5,5
"4252","2017-04-07",6,12,18,30,30,"No",11,7,6,6
"4253","2017-04-07",4,8,2,10,10,"Yes",2,0,4,4
"4254","2017-04-07",NA,3,1,4,NA,"No",0,1,1,2
"4255","2017-04-07",3,8,6,14,14,"Yes",2,4,2,6
"4256","2017-04-07",1,2,1,3,3,"Yes",1,NA,1,1
"4257","2017-04-07",6,11,4,15,13,"Yes",3,1,4,7
"4258","2017-04-14",4,7,6,13,13,"No",2,4,3,4
"4259","2017-04-07",1,4,4,8,8,"Yes",1,3,2,2
"4260","2017-04-07",2,27,3,30,8,"Yes",1,2,15,12
"4261","2017-04-07",9,17,59,76,76,"Yes",33,26,9,8
"4262","2017-04-07",1,2,8,10,8,"Yes",4,4,1,1
"4263","2017-04-07",3,5,0,5,5,"No",0,0,1,4
"4264","2017-04-07",2,9,3,12,12,"Yes",1,2,6,3
"4265","2017-04-07",6,16,16,32,32,"No",8,8,7,9
"4266","2017-04-07",1,2,2,4,4,"No",1,1,1,1
"4267","2017-04-07",1,2,5,7,7,"Yes",2,3,1,1
"4268","2017-04-07",7,10,14,24,24,"Yes",8,6,4,6
"4269","2017-04-07",8,21,15,36,36,"Yes",7,8,10,11
"4270","2017-04-07",10,19,11,30,30,"No",5,6,10,9
"4271","2017-04-07",3,6,5,11,11,"Yes",1,4,3,3
"4272","2017-04-07",3,6,3,9,9,"No",1,2,3,3
"4273","2017-04-07",9,21,11,32,37,"Yes",4,7,11,10
"4274","2017-04-07",5,10,6,16,16,"Yes",2,4,4,6
"4275","2017-04-07",2,4,1,5,5,"Yes",1,NA,2,2
"4276","2017-04-07",4,14,19,33,19,"No",10,9,7,7
"4277","2017-04-07",1,5,1,6,6,"Yes",1,NA,3,2
"4278","2017-04-07",3,16,6,22,24,"Yes",4,2,6,10
"4279","2017-04-07",NA,2,5,7,NA,"No",1,4,1,1
"4280","2017-04-07",1,2,1,3,3,"No",0,1,2,0
"4281","2017-04-11",3,7,3,10,10,"No",2,1,4,3
"4282","2017-04-07",5,8,8,16,13,"Yes",7,1,1,7
"4283","2017-04-07",1,2,5,7,5,NA,3,2,1,1
"4284","2017-04-07",1,5,1,6,7,"Yes",1,0,2,3
"4285","2017-04-07",1,10,9,19,19,"Yes",4,5,6,4
"4286","2017-04-07",2,6,4,10,10,"Yes",1,3,2,4
"4287","2017-04-07",3,8,12,20,20,"Yes",10,2,5,3
"4288","2017-04-07",6,12,11,23,23,"Yes",10,1,6,6
"4289","2017-04-07",2,2,4,6,7,"Yes",2,2,NA,2
"4290","2017-04-07",4,8,2,10,10,"Yes",2,NA,4,4
"4291","2017-04-07",3,6,4,10,10,"No",1,3,4,2
"4292","2017-04-07",6,16,12,28,36,"No",5,7,9,7
"4293","2017-04-07",4,10,5,15,15,"Yes",2,3,4,6
"4294","2017-04-07",5,13,8,21,21,"Yes",3,5,6,7
"4295","2017-04-07",2,7,4,11,11,"Yes",0,4,4,3
"4296","2017-04-07",1,1,0,1,1,"No",0,0,1,0
"4297","2017-04-07",5,10,9,19,19,"Yes",3,6,5,5
"4298","2017-04-07",7,12,7,19,19,"No",2,5,6,6
"4299","2017-04-05",NA,125,0,125,NA,"No",NA,NA,100,25
"4300","2017-04-07",1,2,8,10,10,"Yes",3,5,1,1
"4301","2017-04-07",3,10,4,14,14,"Yes",1,3,4,6
"4302","2017-04-07",7,20,5,25,22,"Yes",1,4,13,7
"4303","2017-04-07",5,13,6,19,19,"Yes",3,3,6,7
"4304","2017-04-07",NA,2,2,4,4,"Yes",1,1,1,1
"4305","2017-04-07",1,5,4,9,9,"Yes",2,2,2,3
"4306","2017-04-07",5,10,10,20,20,"Yes",3,7,5,5
"4307","2017-04-07",2,2,10,12,12,"Yes",9,1,1,1
"4308","2017-04-07",6,14,5,19,19,"No",1,4,5,9
"4309","2017-04-07",4,11,9,20,25,"Yes",6,3,4,7
"4310","2017-04-07",6,11,8,19,19,"Yes",6,2,6,5
"4311","2017-04-07",4,10,6,16,16,"Yes",3,3,4,6
"4312","2017-04-07",6,12,18,30,30,"No",6,12,10,2
"4313","2017-04-07",7,14,9,23,23,"No",2,7,7,7
"4314","2017-04-07",6,12,17,29,29,"Yes",7,10,6,6
"4315","2017-04-07",10,10,5,15,30,"Yes",2,3,5,5
"4316","2017-04-07",5,11,3,14,14,"Yes",1,2,5,6
"4317","2017-04-07",3,9,1,10,10,"Yes",NA,1,4,5
"4318","2017-04-07",9,21,12,33,33,"No",5,7,13,8
"4319","2017-04-07",3,7,9,16,15,"Yes",3,6,4,3
"4320","2017-04-07",1,2,4,6,6,"Yes",4,0,1,1
"4321","2017-04-07",2,4,7,11,11,"Yes",5,2,2,2
"4322","2017-04-07",5,27,7,34,NA,"Yes",5,2,18,9
"4323","2017-04-07",2,4,7,11,11,"Yes",3,4,2,2
"4324","2017-04-07",2,7,4,11,11,"Yes",3,1,4,3
"4325","2017-04-07",3,9,7,16,16,"Yes",3,4,6,3
"4326","2017-04-07",5,10,7,17,20,"Yes",3,4,5,5
"4327","2017-04-07",3,6,6,12,12,"No",4,2,3,3
"4328","2017-04-07",2,7,2,9,9,"Yes",1,1,3,4
"4329","2017-04-07",8,14,16,30,30,"Yes",6,10,8,6
"4330","2017-04-07",3,6,0,6,5,"Yes",0,0,3,3
"4331","2017-04-07",3,6,6,12,12,"Yes",3,3,3,3
"4332","2017-04-07",2,4,8,12,12,"Yes",2,6,2,2
"4333","2017-04-07",3,5,4,9,9,"Yes",3,1,2,3
"4334","2017-04-07",5,17,9,26,29,"No",5,4,7,10
"4335","2017-04-07",4,9,10,19,19,"No",5,5,5,4
"4336","2017-04-07",3,9,6,15,15,"Yes",3,3,5,4
"4337","2017-04-07",5,8,8,16,16,"No",6,2,4,4
"4338","2017-04-07",4,6,6,12,12,"Yes",3,3,2,4
"4339","2017-04-07",1,2,4,6,6,"No",3,1,1,1
"4340","2017-04-07",4,7,5,12,15,"No",3,2,3,4
"4341","2017-04-07",1,6,2,8,6,"Yes",1,1,4,2
"4342","2017-04-07",3,6,5,11,11,"Yes",NA,5,3,3
"4343","2017-04-07",8,14,6,20,20,"No",2,4,8,6
"4344","2017-04-07",7,12,3,15,15,"No",0,3,5,7
"4345","2017-04-07",2,6,6,12,12,"Yes",3,3,2,4
"4346","2017-04-07",4,8,0,8,9,"Yes",0,0,4,4
"4347","2017-04-07",5,8,11,19,19,"No",11,0,5,3
"4348","2017-04-07",1,4,2,6,6,"Yes",1,1,2,2
"4349","2017-04-07",5,13,10,23,23,"No",5,5,6,7
"4350","2017-04-07",5,9,1,10,10,"Yes",1,NA,5,4
"4351","2017-04-07",3,6,3,9,9,"No",1,2,3,3
"4352","2017-04-07",4,10,5,15,22,"Yes",1,4,5,5
"4353","2017-04-07",10,19,11,30,30,"No",3,8,9,10
"4354","2017-04-07",1,4,0,4,4,"Yes",NA,NA,4,NA
"4355","2017-04-07",NA,13,150,163,NA,"Yes",80,70,5,8
"4356","2017-04-07",4,8,5,13,13,"No",2,3,4,4
"4357","2017-04-07",3,6,6,12,12,NA,2,4,3,3
"4358","2017-04-07",2,5,1,6,6,"Yes",NA,1,4,1
"4359","2017-04-07",8,15,9,24,24,"No",3,6,8,7
"4360","2017-04-07",6,12,19,31,29,"Yes",9,10,6,6
"4361","2017-04-07",5,9,7,16,16,"No",5,2,5,4
"4362","2017-04-07",1,2,5,7,8,"Yes",4,1,1,1
"4363","2017-04-07",4,11,7,18,16,"No",3,4,6,5
"4364","2017-04-07",1,6,6,12,12,"Yes",2,4,3,3
"4365","2017-04-07",7,14,6,20,20,"No",1,5,7,7
"4366","2017-04-07",4,8,5,13,13,"No",5,NA,4,4
"4367","2017-04-07",4,8,4,12,15,"Yes",3,1,4,4
"4368","2017-04-07",1,1,5,6,6,"Yes",4,1,1,NA
"4369","2017-04-07",6,13,9,22,22,"No",5,4,6,7
"4370","2017-04-07",4,12,13,25,25,"No",6,7,4,8
"4371","2017-04-07",7,25,18,43,42,"Yes",6,12,10,15
"4372","2017-04-07",2,3,4,7,6,"Yes",3,1,1,2
"4373","2017-04-07",1,3,4,7,7,"No",1,3,2,1
"4374","2017-04-07",4,11,11,22,20,"No",2,9,5,6
"4375","2017-04-07",1,2,7,9,9,"Yes",3,4,1,1
"4376","2017-04-07",1,3,5,8,7,"Yes",2,3,1,2
"4377","2017-04-07",1,2,1,3,2,"Yes",1,0,1,1
"4378","2017-04-07",5,20,16,36,36,"No",7,9,10,10
"4379","2017-04-07",2,4,4,8,8,"No",0,4,1,3
"4380","2017-04-07",2,5,2,7,7,"No",1,1,2,3
"4381","2017-04-07",1,4,4,8,8,"Yes",3,1,2,2
"4382","2017-04-07",2,5,3,8,8,"No",1,2,2,3
"4383","2017-04-07",3,6,9,15,15,"Yes",5,4,3,3
"4384","2017-04-07",1,2,4,6,6,"Yes",NA,4,1,1
"4385","2017-04-07",9,19,11,30,30,"No",6,5,9,10
"4386","2017-04-07",5,20,15,35,25,"Yes",7,8,8,12
"4387","2017-04-07",4,8,11,19,19,"No",2,9,4,4
"4388","2017-04-07",2,7,2,9,9,"No",1,1,4,3
"4389","2017-04-07",6,12,10,22,22,"Yes",3,7,6,6
"4390","2017-04-07",6,11,8,19,NA,"No",5,3,6,5
"4391","2017-04-07",1,11,4,15,15,"Yes",2,2,5,6
"4392","2017-04-07",3,0,0,0,NA,"Yes",NA,NA,NA,NA
"4393","2017-04-07",12,24,9,33,41,"Yes",5,4,12,12
"4394","2017-04-07",1,0,0,0,7,"Yes",NA,NA,NA,NA
"4395","2017-04-07",7,13,7,20,20,"Yes",4,3,7,6
"4396","2017-04-07",6,14,8,22,24,"Yes",5,3,6,8
"4397","2017-04-07",4,28,4,32,32,"Yes",0,4,18,10
"4398","2017-04-07",1,2,4,6,5,"No",1,3,1,1
"4399","2017-04-07",NA,70,40,110,NA,"Yes",20,20,30,40
"4400","2017-04-07",5,8,10,18,14,"Yes",7,3,4,4
"4401","2017-04-07",3,8,5,13,13,"No",2,3,3,5
"4402","2017-04-07",12,24,26,50,50,"Yes",14,12,12,12
"4403","2017-04-07",2,5,5,10,10,"Yes",2,3,3,2
"4404","2017-04-07",1,2,3,5,5,"No",2,1,1,1
"4405","2017-04-07",3,7,9,16,17,"Yes",4,5,4,3
"4406","2017-04-07",6,17,6,23,21,"Yes",4,2,8,9
"4407","2017-04-07",3,7,5,12,12,NA,2,3,4,3
"4408","2017-04-07",14,24,6,30,30,"No",4,2,10,14
"4409","2017-04-07",4,8,8,16,16,"Yes",2,6,4,4
"4410","2017-04-07",1,4,1,5,5,"Yes",NA,1,2,2
"4411","2017-04-07",1,5,4,9,9,"Yes",1,3,3,2
"4412","2017-04-07",1,2,1,3,3,"Yes",1,0,1,1
"4413","2017-04-07",4,13,9,22,24,"Yes",5,4,5,8
"4414","2017-04-07",2,4,3,7,7,"No",1,2,2,2
"4415","2017-04-07",4,11,5,16,18,"Yes",2,3,5,6
"4416","2017-04-07",3,4,5,9,10,"Yes",2,3,4,NA
"4417","2017-04-07",2,4,3,7,7,"Yes",1,2,1,3
"4418","2017-04-07",NA,199,105,304,NA,"Yes",45,60,119,80
"4419","2017-04-07",7,11,3,14,NA,"Yes",2,1,6,5
"4420","2017-04-07",3,6,3,9,9,"Yes",2,1,4,2
"4421","2017-04-14",3,8,3,11,12,"No",2,1,2,6
"4422","2017-04-07",1,3,2,5,5,"Yes",1,1,1,2
"4423","2017-04-07",1,9,3,12,12,"Yes",2,1,4,5
"4424","2017-04-07",6,10,7,17,NA,"Yes",6,1,5,5
"4425","2017-04-07",1,2,1,3,3,"Yes",1,0,1,1
"4426","2017-04-07",3,8,7,15,15,"Yes",3,4,5,3
"4427","2017-04-07",1,2,5,7,7,"No",1,4,1,1
"4428","2017-04-07",1,2,1,3,3,"Yes",1,0,2,0
"4429","2017-04-07",4,8,8,16,16,"Yes",3,5,3,5
"4430","2017-04-07",3,6,7,13,13,"No",4,3,3,3
"4431","2017-04-07",6,14,13,27,27,"Yes",5,8,7,7
"4432","2017-04-07",2,6,4,10,10,"Yes",2,2,3,3
"4433","2017-04-07",12,35,11,46,45,"No",5,6,15,20
"4434","2017-04-07",2,8,4,12,14,"No",0,4,4,4
"4435","2017-04-07",2,5,7,12,11,"Yes",5,2,2,3
"4436","2017-04-07",10,18,7,25,25,"Yes",5,2,8,10
"4437","2017-04-07",5,9,11,20,20,"Yes",5,6,4,5
"4438","2017-04-07",1,3,7,10,10,"Yes",3,4,1,2
"4439","2017-04-07",3,5,6,11,11,"No",3,3,2,3
"4440","2017-04-07",1,3,9,12,12,"Yes",8,1,1,2
"4441","2017-04-07",2,3,6,9,9,"No",3,3,1,2
"4442","2017-04-07",4,15,10,25,25,"Yes",6,4,9,6
"4443","2017-04-08",2,19,5,24,24,"Yes",2,3,9,10
"4444","2017-04-08",3,8,12,20,20,"Yes",3,9,5,3
"4445","2017-04-08",3,5,0,5,5,"Yes",0,0,5,0
"4446","2017-04-08",1,3,2,5,5,"Yes",NA,2,1,2
"4447","2017-04-08",5,11,5,16,16,"Yes",2,3,6,5
"4448","2017-04-08",NA,210,260,470,NA,"Yes",110,150,75,135
"4449","2017-04-08",2,6,7,13,13,"No",4,3,3,3
"4450","2017-04-08",5,30,8,38,38,"No",2,6,12,18
"4451","2017-04-08",2,4,2,6,6,"Yes",1,1,2,2
"4452","2017-04-08",1,4,4,8,6,"Yes",2,2,2,2
"4453","2017-04-08",5,20,7,27,26,"Yes",4,3,8,12
"4454","2017-04-08",3,12,10,22,56,"Yes",4,6,6,6
"4455","2017-04-08",8,20,5,25,25,"Yes",1,4,10,10
"4456","2017-04-08",1,6,6,12,10,"Yes",2,4,2,4
"4457","2017-04-08",2,4,10,14,14,"No",5,5,2,2
"4458","2017-04-08",2,3,10,13,13,"Yes",6,4,1,2
"4459","2017-04-08",2,7,4,11,12,"Yes",2,2,4,3
"4460","2017-04-08",4,11,5,16,16,"No",2,3,5,6
"4461","2017-04-08",3,3,3,6,6,"Yes",1,2,1,2
"4462","2017-04-08",10,21,23,44,44,"No",8,15,9,12
"4463","2017-04-08",5,9,7,16,15,"Yes",5,2,4,5
"4464","2017-04-08",4,8,7,15,15,"No",3,4,4,4
"4465","2017-04-08",3,6,9,15,15,"Yes",4,5,3,3
"4466","2017-04-08",1,3,2,5,5,"Yes",1,1,2,1
"4467","2017-04-08",8,23,7,30,30,"No",3,4,10,13
"4468","2017-04-08",5,10,15,25,25,"No",7,8,5,5
"4469","2017-04-08",3,8,7,15,15,"No",3,4,3,5
"4470","2017-04-08",2,5,6,11,11,"Yes",2,4,2,3
"4471","2017-04-08",3,8,9,17,17,"Yes",5,4,5,3
"4472","2017-04-08",4,5,11,16,16,"Yes",6,5,1,4
"4473","2017-04-08",3,12,5,17,17,"Yes",4,1,6,6
"4474",NA,5,10,13,23,23,"No",7,6,5,5
"4475","2017-04-08",3,4,1,5,5,"Yes",1,NA,2,2
"4476","2017-04-08",10,14,6,20,20,"Yes",4,2,8,6
"4477","2017-04-08",2,5,6,11,11,"No",5,1,2,3
"4478","2017-04-08",4,8,9,17,17,"No",5,4,4,4
"4479","2017-04-08",1,4,6,10,10,"Yes",1,5,1,3
"4480","2017-04-08",4,8,2,10,10,"Yes",0,2,5,3
"4481","2017-04-08",1,2,10,12,12,"Yes",8,2,1,1
"4482","2017-04-08",3,6,2,8,NA,"No",2,0,3,3
"4483","2017-04-08",10,21,37,58,58,"No",28,9,11,10
"4484","2017-04-08",4,13,7,20,20,"Yes",4,3,5,8
"4485","2017-04-08",4,8,10,18,18,"No",4,6,4,4
"4486","2017-04-08",1,3,4,7,6,"Yes",NA,4,2,1
"4487","2017-04-08",5,11,1,12,12,"Yes",1,0,5,6
"4488","2017-04-08",1,2,5,7,7,"Yes",2,3,1,1
"4489","2017-04-08",5,16,2,18,17,"Yes",0,2,14,2
"4490","2017-04-08",1,2,0,2,2,"Yes",NA,NA,1,1
"4491","2017-04-08",9,18,4,22,22,"Yes",1,3,12,6
"4492","2017-04-08",1,4,1,5,5,"No",1,0,1,3
"4493","2017-04-08",1,5,1,6,6,"Yes",0,1,2,3
"4494","2017-04-08",1,5,3,8,8,"Yes",2,1,1,4
"4495","2017-04-08",3,6,7,13,15,"No",4,3,3,3
"4496","2017-04-08",4,8,6,14,14,"Yes",2,4,4,4
"4497","2017-04-08",5,8,4,12,12,"No",2,2,2,6
"4498","2017-04-08",2,4,6,10,10,"No",2,4,2,2
"4499","2017-04-08",6,10,13,23,23,"Yes",5,8,5,5
"4500","2017-04-08",7,0,0,0,22,NA,NA,NA,NA,NA
"4501","2017-04-08",8,15,11,26,36,"Yes",5,6,7,8
"4502","2017-04-08",8,23,2,25,NA,"Yes",1,1,8,15
"4503","2017-04-08",1,6,3,9,9,"No",3,0,4,2
"4504","2017-04-08",1,2,3,5,5,"Yes",1,2,1,1
"4505","2017-04-08",6,16,12,28,28,"Yes",4,8,8,8
"4506","2017-04-08",6,12,3,15,15,"Yes",1,2,6,6
"4507","2017-04-08",3,6,7,13,13,"Yes",4,3,3,3
"4508","2017-04-08",4,8,4,12,16,"Yes",3,1,4,4
"4509","2017-04-08",2,8,1,9,9,"Yes",1,0,5,3
"4510","2017-04-08",1,3,3,6,6,"Yes",2,1,1,2
"4511","2017-04-08",2,5,9,14,14,"No",5,4,2,3
"4512","2017-04-08",6,13,23,36,40,"No",2,21,8,5
"4513","2017-04-08",3,7,7,14,14,"Yes",2,5,3,4
"4514","2017-04-08",4,8,4,12,12,"Yes",4,0,4,4
"4515","2017-04-08",3,14,18,32,22,"Yes",11,7,8,6
"4516","2017-04-08",10,19,16,35,32,"Yes",9,7,11,8
"4517","2017-04-08",NA,55,297,352,NA,"Yes",112,185,25,30
"4518","2017-04-08",3,8,2,10,10,"Yes",1,1,5,3
"4519","2017-04-08",3,7,7,14,14,"Yes",3,4,3,4
"4520","2017-04-08",5,9,9,18,18,"No",3,6,5,4
"4521","2017-04-08",4,9,8,17,17,"No",3,5,3,6
"4522","2017-04-08",6,9,1,10,10,"Yes",0,1,6,3
"4523","2017-04-08",5,10,6,16,16,"Yes",2,4,5,5
"4524","2017-04-08",3,6,4,10,10,"Yes",2,2,3,3
"4525","2017-04-08",1,5,0,5,5,"Yes",NA,NA,2,3
"4526","2017-04-08",6,14,4,18,20,"Yes",1,3,8,6
"4527","2017-04-08",NA,1,0,1,NA,"No",0,0,1,0
"4528","2017-04-08",9,17,13,30,30,"Yes",6,7,9,8
"4529","2017-04-08",3,14,11,25,25,"Yes",5,6,10,4
"4530","2017-04-08",2,5,3,8,8,"No",2,1,3,2
"4531","2017-04-08",2,4,3,7,7,"No",3,0,1,3
"4532","2017-04-08",1,2,3,5,1,"No",1,2,1,1
"4533","2017-04-08",1,1,5,6,6,"Yes",4,1,0,1
"4534","2017-04-08",1,4,0,4,3,"Yes",NA,NA,1,3
"4535","2017-04-08",3,7,7,14,16,"No",2,5,4,3
"4536","2017-04-08",5,9,13,22,22,"No",6,7,5,4
"4537","2017-04-08",3,6,3,9,9,"Yes",1,2,2,4
"4538","2017-04-08",2,5,6,11,11,"Yes",3,3,2,3
"4539","2017-04-08",4,7,2,9,9,"Yes",1,1,3,4
"4540","2017-04-08",5,11,10,21,20,"No",5,5,6,5
"4541","2017-04-08",1,2,2,4,4,"No",1,1,1,1
"4542","2017-04-08",2,4,4,8,8,"No",1,3,2,2
"4543","2017-04-08",3,8,8,16,19,"Yes",6,2,6,2
"4544","2017-04-08",1,2,4,6,6,"Yes",2,2,1,1
"4545","2017-04-08",1,6,0,6,6,"No",NA,NA,3,3
"4546","2017-04-08",8,0,0,0,NA,"Yes",NA,NA,NA,NA
"4547","2017-04-08",4,12,9,21,21,"Yes",4,5,6,6
"4548","2017-04-08",2,12,2,14,14,"Yes",1,1,5,7
"4549","2017-04-08",1,2,3,5,5,"No",1,2,1,1
"4550","2017-04-08",1,2,3,5,6,"Yes",2,1,1,1
"4551","2017-04-08",2,7,4,11,11,"No",4,0,4,3
"4552","2017-04-08",2,6,5,11,13,"Yes",3,2,3,3
"4553","2017-04-08",1,4,5,9,8,"Yes",2,3,3,1
"4554","2017-04-08",NA,11,9,20,20,"No",6,3,5,6
"4555","2017-04-08",2,8,3,11,11,"Yes",2,1,3,5
"4556","2017-04-08",3,6,5,11,13,"Yes",2,3,3,3
"4557","2017-04-08",3,6,6,12,13,"Yes",2,4,1,5
"4558","2017-04-08",3,9,8,17,17,"Yes",4,4,4,5
"4559","2017-04-08",2,3,1,4,4,"No",1,0,2,1
"4560","2017-04-08",5,14,13,27,28,"No",3,10,5,9
"4561","2017-04-08",3,2,10,12,13,"Yes",5,5,1,1
"4562","2017-04-08",3,6,2,8,8,"No",1,1,2,4
"4563","2017-04-08",NA,7,10,17,NA,"No",6,4,4,3
"4564","2017-04-08",5,11,4,15,16,"No",4,0,5,6
"4565","2017-04-08",2,4,4,8,8,"No",3,1,2,2
"4566","2017-04-08",5,12,1,13,13,"Yes",1,0,6,6
"4567","2017-04-08",NA,2,3,5,NA,"Yes",2,1,1,1
"4568","2017-04-08",3,2,5,7,17,"Yes",1,4,NA,2
"4569","2017-04-08",7,12,0,12,16,"Yes",NA,NA,5,7
"4570","2017-04-08",1,5,4,9,8,"Yes",2,2,3,2
"4571","2017-04-08",1,4,6,10,10,"No",3,3,2,2
"4572","2017-04-08",7,12,18,30,30,"Yes",8,10,7,5
"4573","2017-04-08",8,16,32,48,48,"No",12,20,8,8
"4574","2017-04-08",4,8,11,19,19,"Yes",4,7,4,4
"4575","2017-04-08",3,7,8,15,15,"No",5,3,2,5
"4576","2017-04-08",6,0,0,0,NA,"Yes",NA,NA,NA,NA
"4577","2017-04-08",6,12,8,20,20,"Yes",2,6,5,7
"4578","2017-04-08",7,15,10,25,25,"No",5,5,7,8
"4579","2017-04-08",4,8,5,13,13,"Yes",1,4,4,4
"4580","2017-04-08",2,7,3,10,14,"Yes",2,1,3,4
"4581","2017-04-08",5,10,12,22,25,"No",5,7,5,5
"4582","2017-04-08",3,15,7,22,22,"Yes",6,1,8,7
"4583","2017-04-08",7,15,12,27,27,"Yes",7,5,8,7
"4584","2017-04-08",3,5,5,10,10,"No",2,3,2,3
"4585","2017-04-08",1,7,0,7,7,"Yes",NA,NA,4,3
"4586","2017-04-08",12,27,15,42,42,"No",8,7,12,15
"4587","2017-04-08",1,5,0,5,5,"Yes",0,0,3,2
"4588","2017-04-08",2,8,10,18,18,"No",4,6,4,4
"4589","2017-04-08",4,11,7,18,18,"Yes",4,3,4,7
"4590","2017-04-08",5,11,4,15,15,"Yes",2,2,5,6
"4591","2017-04-08",3,6,5,11,11,"No",1,4,5,1
"4592","2017-04-08",2,3,1,4,4,"No",1,0,2,1
"4593","2017-04-08",2,3,4,7,7,"Yes",3,1,2,1
"4594","2017-04-08",3,15,3,18,18,"Yes",2,1,10,5
"4595","2017-04-08",1,4,2,6,6,"Yes",1,1,2,2
"4596","2017-04-08",4,8,10,18,18,"Yes",5,5,4,4
"4597","2017-04-08",3,7,3,10,17,"No",1,2,2,5
"4598","2017-04-08",1,2,3,5,5,"Yes",1,2,1,1
"4599","2017-04-08",5,13,9,22,22,"Yes",3,6,9,4
"4600","2017-04-08",6,14,9,23,NA,"Yes",7,2,8,6
"4601","2017-04-08",3,5,1,6,9,"No",NA,1,3,2
"4602","2017-04-08",6,10,16,26,26,"No",5,11,6,4
"4603","2017-04-08",5,10,10,20,25,"Yes",4,6,5,5
"4604","2017-04-08",5,13,7,20,20,"Yes",4,3,5,8
"4605","2017-04-08",2,3,2,5,5,"Yes",1,1,1,2
"4606","2017-04-08",4,8,2,10,10,"Yes",0,2,5,3
"4607","2017-04-08",1,4,0,4,4,"Yes",NA,NA,3,1
"4608","2017-04-08",11,23,15,38,36,"Yes",9,6,13,10
"4609","2017-04-08",3,8,17,25,28,"No",5,12,4,4
"4610","2017-04-08",1,2,4,6,7,"Yes",2,2,1,1
"4611","2017-04-08",3,11,6,17,14,"Yes",6,0,6,5
"4612","2017-04-08",3,11,6,17,17,"No",1,5,5,6
"4613","2017-04-08",4,8,10,18,18,"No",7,3,4,4
"4614","2017-04-08",4,6,5,11,14,"Yes",1,4,3,3
"4615","2017-04-08",2,5,6,11,11,"Yes",3,3,2,3
"4616","2017-04-08",4,7,9,16,16,"Yes",2,7,2,5
"4617","2017-04-08",27,48,17,65,65,"Yes",10,7,20,28
"4618","2017-04-08",2,6,0,6,6,"No",0,0,3,3
"4619","2017-04-08",1,9,3,12,8,"Yes",2,1,6,3
"4620","2017-04-08",4,9,5,14,14,"Yes",0,5,2,7
"4621","2017-04-08",1,4,4,8,8,"Yes",1,3,2,2
"4622","2017-04-08",6,12,8,20,20,"Yes",3,5,6,6
"4623","2017-04-08",2,3,0,3,3,"Yes",0,0,1,2
"4624","2017-04-08",1,4,3,7,7,"Yes",3,0,2,2
"4625","2017-04-08",2,4,6,10,10,NA,2,4,2,2
"4626","2017-04-08",5,12,1,13,13,"No",1,0,5,7
"4627","2017-04-08",4,7,3,10,14,"Yes",0,3,4,3
"4628","2017-04-08",2,10,3,13,13,"No",1,2,4,6
"4629","2017-04-08",4,8,4,12,18,"Yes",4,0,4,4
"4630","2017-04-08",5,11,3,14,14,"Yes",2,1,5,6
"4631","2017-04-08",2,4,5,9,9,"No",3,2,2,2
"4632","2017-04-08",12,17,14,31,NA,"Yes",7,7,5,12
"4633","2017-04-10",1,2,3,5,5,"Yes",1,2,1,1
"4634","2017-04-10",4,12,3,15,15,"Yes",1,2,3,9
"4635","2017-04-10",2,6,1,7,7,"Yes",0,1,3,3
"4636","2017-04-10",4,12,20,32,20,"No",9,11,5,7
"4637","2017-04-10",3,7,6,13,13,"No",2,4,5,2
"4638","2017-04-10",3,7,3,10,10,"Yes",1,2,4,3
"4639","2017-04-10",6,21,19,40,NA,"No",12,7,9,12
"4640","2017-04-10",3,11,3,14,14,"Yes",1,2,6,5
"4641","2017-04-10",4,11,2,13,14,"Yes",1,1,6,5
"4642","2017-04-10",2,17,10,27,27,"Yes",7,3,7,10
"4643","2017-04-10",5,8,5,13,16,"Yes",1,4,3,5
"4644","2017-04-10",1,10,2,12,12,"No",NA,2,6,4
"4645","2017-04-10",1,5,2,7,7,"Yes",1,1,4,1
"4646","2017-04-10",6,12,7,19,19,"Yes",3,4,7,5
"4647","2017-04-10",2,3,3,6,8,"No",NA,3,2,1
"4648","2017-04-10",6,12,14,26,26,"Yes",6,8,6,6
"4649","2017-04-10",5,11,11,22,22,"Yes",7,4,3,8
"4650","2017-04-10",1,5,1,6,6,"Yes",0,1,1,4
"4651","2017-04-10",2,5,3,8,8,"Yes",NA,3,3,2
"4652","2017-04-10",6,28,10,38,38,"Yes",3,7,12,16
"4653","2017-04-10",2,8,3,11,13,"Yes",2,1,3,5
"4654","2017-04-10",3,10,4,14,11,"Yes",3,1,4,6
"4655","2017-04-10",13,16,9,25,25,"Yes",4,5,6,10
"4656","2017-04-10",1,2,2,4,4,"Yes",2,0,1,1
"4657","2017-04-10",2,4,7,11,11,"No",1,6,2,2
"4658","2017-04-10",3,9,0,9,8,"Yes",NA,NA,7,2
"4659","2017-04-10",4,13,11,24,24,NA,6,5,8,5
"4660","2017-04-10",6,14,8,22,24,"Yes",5,3,6,8
"4661","2017-04-10",4,13,7,20,20,"Yes",3,4,5,8
"4662","2017-04-10",7,18,8,26,NA,"Yes",3,5,10,8
"4663","2017-04-10",4,20,6,26,26,"Yes",5,1,8,12
"4664","2017-04-10",1,3,0,3,3,"No",0,0,2,1
"4665","2017-04-10",4,8,5,13,12,"No",2,3,3,5
"4666","2017-04-30",7,10,2,12,15,"No",1,1,4,6
"4667","2017-04-10",1,4,0,4,4,"Yes",0,0,2,2
"4668","2017-04-10",9,16,10,26,26,"Yes",3,7,10,6
"4669","2017-04-10",3,8,1,9,9,"Yes",0,1,4,4
"4670","2017-04-10",1,1,0,1,1,"Yes",0,0,1,0
"4671","2017-04-10",4,7,7,14,16,"Yes",5,2,3,4
"4672","2017-04-10",1,6,1,7,7,"Yes",1,0,3,3
"4673","2017-04-10",30,20,10,30,7,"Yes",3,7,10,10
"4674","2017-04-10",3,6,6,12,18,"Yes",4,2,3,3
"4675","2017-04-10",4,8,7,15,15,"Yes",2,5,4,4
"4676","2017-04-10",1,1,3,4,3,"No",1,2,0,1
"4677","2017-04-10",1,7,0,7,7,"Yes",0,0,4,3
"4678","2017-04-10",5,16,13,29,28,"Yes",5,8,8,8
"4679","2017-04-10",4,9,4,13,13,"Yes",2,2,5,4
"4680","2017-04-17",4,10,9,19,18,"No",3,6,5,5
"4681","2017-04-10",2,6,9,15,13,"Yes",3,6,4,2
"4682","2017-04-10",NA,7,5,12,NA,"Yes",2,3,4,3
"4683","2017-04-10",6,11,7,18,28,"Yes",2,5,5,6
"4684","2017-04-10",1,2,0,2,3,"No",0,0,1,1
"4685","2017-04-10",1,2,1,3,5,"Yes",NA,1,1,1
"4686","2017-04-10",8,10,0,10,10,"Yes",0,0,5,5
"4687","2017-04-10",1,3,6,9,9,"Yes",NA,6,NA,3
"4688","2017-04-10",3,7,11,18,18,"No",3,8,4,3
"4689","2017-04-10",3,7,10,17,17,"Yes",4,6,4,3
"4690","2017-04-10",1,3,3,6,6,"No",1,2,1,2
"4691","2017-04-10",3,6,12,18,18,"Yes",5,7,3,3
"4692","2017-04-10",2,4,2,6,6,"No",1,1,2,2
"4693","2017-04-10",3,10,10,20,20,"No",5,5,4,6
"4694","2017-04-10",3,5,5,10,10,"Yes",1,4,3,2
"4695","2017-04-10",2,7,9,16,13,"Yes",4,5,6,1
"4696","2017-04-10",7,13,17,30,30,"Yes",6,11,7,6
"4697","2017-04-10",1,4,4,8,8,"Yes",3,1,2,2
"4698","2017-04-10",2,3,5,8,8,"No",2,3,1,2
"4699","2017-04-10",3,9,5,14,14,"No",3,2,5,4
"4700","2017-04-10",2,4,8,12,11,"Yes",1,7,2,2
"4701","2017-04-10",4,8,5,13,13,"No",2,3,5,3
"4702","2017-04-11",1,2,0,2,NA,"Yes",0,0,1,1
"4703","2017-04-10",6,9,7,16,16,"Yes",4,3,5,4
"4704","2017-04-10",2,4,5,9,8,"No",2,3,1,3
"4705","2017-04-10",1,2,3,5,4,"Yes",0,3,1,1
"4706","2017-04-10",2,3,4,7,7,"No",2,2,2,1
"4707","2017-04-10",6,14,6,20,20,"No",4,2,6,8
"4708","2017-04-10",4,11,5,16,16,"Yes",1,4,5,6
"4709",NA,1,9,0,9,9,"Yes",0,0,4,5
"4710","2017-04-10",6,10,10,20,22,"No",4,6,6,4
"4711","2017-04-10",7,12,13,25,26,"No",5,8,7,5
"4712","2017-04-10",2,7,0,7,7,"Yes",0,0,2,5
"4713","2017-04-10",1,4,6,10,10,"Yes",1,5,2,2
"4714","2017-04-10",3,6,11,17,17,"Yes",6,5,3,3
"4715","2017-04-10",4,6,8,14,14,"Yes",4,4,2,4
"4716","2017-04-10",6,10,30,40,40,"No",10,20,4,6
"4717","2017-04-10",2,8,1,9,9,"Yes",0,1,5,3
"4718","2017-04-10",5,13,6,19,22,"Yes",4,2,4,9
"4719","2017-04-10",3,5,4,9,9,"Yes",3,1,3,2
"4720","2017-04-10",5,10,11,21,23,"Yes",6,5,5,5
"4721","2017-04-10",4,10,4,14,14,"No",1,3,5,5
"4722","2017-04-10",4,8,8,16,16,"No",2,6,4,4
"4723","2017-04-10",3,6,5,11,11,"No",5,0,3,3
"4724","2017-04-10",5,12,6,18,18,"No",5,1,8,4
"4725","2017-04-10",7,13,13,26,26,"Yes",8,5,6,7
"4726",NA,5,10,8,18,18,"Yes",3,5,5,5
"4727","2017-04-10",4,6,10,16,16,"Yes",4,6,1,5
"4728","2017-04-10",1,2,0,2,2,"Yes",0,0,1,1
"4729","2017-04-10",3,6,0,6,6,"Yes",NA,NA,3,3
"4730","2017-04-10",2,4,9,13,NA,"No",7,2,2,2
"4731","2017-04-10",4,11,7,18,16,"Yes",1,6,4,7
"4732","2017-04-10",6,12,3,15,15,"Yes",0,3,6,6
"4733","2017-04-10",9,21,12,33,33,"Yes",4,8,9,12
"4734","2017-04-10",4,9,7,16,16,"Yes",3,4,3,6
"4735","2017-04-10",6,11,13,24,24,"No",6,7,6,5
"4736","2017-04-10",5,10,7,17,17,"Yes",4,3,5,5
"4737","2017-04-10",7,21,19,40,39,"Yes",11,8,9,12
"4738","2017-04-10",5,7,11,18,25,"Yes",6,5,4,3
"4739","2017-04-10",10,24,11,35,NA,"Yes",5,6,13,11
"4740","2017-04-10",3,7,0,7,7,"Yes",0,0,4,3
"4741","2017-04-10",25,9,6,15,15,"Yes",1,5,5,4
"4742","2017-04-10",4,11,0,11,11,"Yes",0,0,5,6
"4743","2017-04-10",2,5,7,12,12,"Yes",3,4,2,3
"4744","2017-04-10",2,4,6,10,8,"No",3,3,2,2
"4745","2017-04-10",2,5,2,7,7,"Yes",2,0,3,2
"4746","2017-04-10",4,13,7,20,20,"No",3,4,7,6
"4747","2017-04-10",4,5,2,7,7,"Yes",2,NA,3,2
"4748","2017-04-10",NA,4,0,4,NA,"Yes",NA,NA,1,3
"4749","2017-04-10",3,6,7,13,13,"Yes",7,0,3,3
"4750","2017-04-10",5,12,3,15,15,"Yes",3,0,5,7
"4751","2017-04-10",3,5,7,12,12,"Yes",1,6,2,3
"4752","2017-04-10",2,5,2,7,7,"Yes",2,0,4,1
"4753","2017-04-10",NA,18,110,128,NA,"Yes",50,60,10,8
"4754","2017-04-10",4,8,9,17,17,"Yes",5,4,4,4
"4755","2017-04-10",1,7,11,18,18,"Yes",7,4,3,4
"4756","2017-04-10",5,15,10,25,25,"No",3,7,5,10
"4757","2017-04-10",2,3,2,5,5,"Yes",0,2,2,1
"4758","2017-04-10",4,0,0,0,25,"Yes",NA,NA,NA,NA
"4759","2017-04-10",4,8,5,13,13,"Yes",1,4,4,4
"4760","2017-04-10",3,4,6,10,10,"Yes",1,5,2,2
"4761","2017-04-10",7,26,12,38,48,NA,7,5,14,12
"4762","2017-04-10",2,4,9,13,13,"No",6,3,2,2
"4763","2017-04-10",8,9,7,16,NA,"Yes",1,6,4,5
"4764","2017-04-10",NA,16,490,506,NA,"Yes",190,300,7,9
"4765","2017-04-10",4,8,12,20,24,"Yes",6,6,4,4
"4766","2017-04-10",5,14,5,19,14,"No",3,2,7,7
"4767","2017-04-10",1,4,2,6,6,"Yes",2,0,2,2
"4768","2017-04-10",2,12,3,15,15,"Yes",NA,3,4,8
"4769","2017-04-10",4,7,5,12,12,"No",3,2,3,4
"4770","2017-04-10",6,17,18,35,35,"Yes",8,10,12,5
"4771","2017-04-10",3,9,9,18,18,"Yes",3,6,4,5
"4772","2017-04-10",1,2,10,12,12,"No",4,6,1,1
"4773","2017-04-10",3,10,6,16,16,"Yes",2,4,5,5
"4774","2017-04-10",3,8,3,11,12,"Yes",2,1,3,5
"4775","2017-04-10",2,3,7,10,10,"Yes",3,4,1,2
"4776","2017-04-10",3,8,8,16,19,"Yes",3,5,4,4
"4777","2017-04-10",4,9,8,17,18,"Yes",3,5,4,5
"4778","2017-04-10",4,10,10,20,20,"Yes",4,6,4,6
"4779","2017-04-10",6,12,13,25,27,"Yes",8,5,5,7
"4780","2017-04-10",10,15,5,20,23,"Yes",3,2,5,10
"4781","2017-04-10",1,3,3,6,6,"Yes",1,2,2,1
"4782","2017-04-10",1,9,3,12,12,"Yes",3,0,4,5
"4783","2017-04-10",9,18,16,34,44,"Yes",7,9,9,9
"4784","2017-04-10",4,8,6,14,14,"No",1,5,5,3
"4785","2017-04-10",7,11,5,16,25,NA,0,5,5,6
"4786","2017-04-10",1,3,8,11,11,"Yes",1,7,1,2
"4787","2017-04-10",7,15,17,32,32,"Yes",9,8,7,8
"4788","2017-04-10",3,4,3,7,7,"No",1,2,2,2
"4789","2017-04-10",6,11,6,17,17,"Yes",5,1,5,6
"4790","2017-04-10",5,12,16,28,24,"Yes",11,5,5,7
"4791","2017-04-10",3,6,2,8,8,"Yes",0,2,4,2
"4792","2017-04-10",1,4,5,9,9,"No",2,3,2,2
"4793","2017-04-10",7,16,11,27,27,"Yes",4,7,10,6
"4794","2017-04-10",1,3,8,11,7,"No",4,4,1,2
"4795","2017-04-10",3,6,2,8,7,"Yes",1,1,3,3
"4796","2017-04-10",2,3,3,6,6,"No",2,1,2,1
"4797","2017-04-10",3,6,6,12,12,"Yes",2,4,3,3
"4798","2017-04-10",6,9,4,13,13,"Yes",1,3,6,3
"4799","2017-04-10",3,9,6,15,15,"Yes",6,0,5,4
"4800","2017-04-10",NA,227,113,340,NA,"No",56,57,102,125
"4801","2017-04-10",3,6,5,11,11,"No",3,2,3,3
"4802","2017-04-10",1,3,0,3,3,"Yes",NA,NA,2,1
"4803","2017-04-10",13,27,26,53,65,"Yes",11,15,13,14
"4804","2017-04-10",5,10,3,13,13,"Yes",NA,3,5,5
"4805","2017-04-17",2,6,1,7,7,"Yes",NA,1,3,3
"4806","2017-04-10",6,15,8,23,23,"Yes",3,5,7,8
"4807","2017-04-10",3,9,9,18,18,"Yes",5,4,4,5
"4808","2017-04-10",6,10,8,18,18,"Yes",5,3,6,4
"4809","2017-04-10",2,3,9,12,13,"Yes",5,4,1,2
"4810","2017-04-10",5,15,5,20,20,"Yes",3,2,6,9
"4811","2017-04-10",1,2,8,10,10,"Yes",8,0,0,2
"4812","2017-04-10",1,8,2,10,10,"Yes",1,1,5,3
"4813","2017-04-10",6,16,4,20,20,"Yes",2,2,6,10
"4814","2017-04-10",4,8,6,14,19,"No",3,3,4,4
"4815","2017-04-10",3,6,8,14,14,"No",3,5,3,3
"4816","2017-04-10",7,20,17,37,37,NA,9,8,10,10
"4817","2017-04-10",8,16,14,30,30,"Yes",9,5,8,8
"4818","2017-04-10",1,3,3,6,7,"Yes",2,1,2,1
"4819","2017-04-10",2,4,3,7,9,"Yes",1,2,2,2
"4820","2017-04-10",6,20,10,30,30,"Yes",3,7,8,12
"4821","2017-04-10",1,8,2,10,8,"Yes",1,1,5,3
"4822","2017-04-10",3,6,3,9,12,"No",0,3,3,3
"4823","2017-04-10",4,12,7,19,19,"Yes",1,6,8,4
"4824","2017-04-10",6,12,10,22,25,"Yes",6,4,6,6
"4825","2017-04-10",1,4,1,5,7,"No",0,1,3,1
"4826","2017-04-10",4,7,5,12,12,"Yes",4,1,3,4
"4827","2017-04-10",4,9,9,18,16,"Yes",1,8,5,4
"4828","2017-04-10",5,11,3,14,14,"Yes",2,1,6,5
"4829","2017-04-10",3,6,3,9,9,"Yes",1,2,4,2
"4830","2017-04-10",2,5,2,7,7,"No",2,0,3,2
"4831","2017-04-10",4,10,8,18,18,"Yes",3,5,4,6
"4832","2017-04-10",3,5,3,8,8,"Yes",2,1,2,3
"4833","2017-04-10",1,3,4,7,7,"Yes",2,2,1,2
"4834","2017-04-10",6,17,9,26,32,"Yes",6,3,12,5
"4835","2017-04-17",5,7,2,9,13,"Yes",2,NA,5,2
"4836","2017-04-10",1,2,4,6,6,"Yes",2,2,0,2
"4837","2017-04-10",11,24,40,64,64,"Yes",12,28,13,11
"4838","2017-04-10",1,5,1,6,6,"No",1,0,1,4
"4839","2017-04-10",10,25,25,50,56,"No",12,13,10,15
"4840","2017-04-10",1,3,3,6,7,"No",2,1,0,3
"4841","2017-04-10",2,4,5,9,9,"Yes",2,3,2,2
"4842","2017-04-10",4,8,12,20,20,"No",9,3,4,4
"4843","2017-04-10",5,8,0,8,8,"Yes",0,0,4,4
"4844","2017-04-10",1,2,5,7,8,"No",4,1,1,1
"4845","2017-04-10",4,8,0,8,22,"No",NA,NA,4,4
"4846","2017-04-10",4,8,7,15,15,"Yes",4,3,4,4
"4847","2017-04-10",1,2,5,7,7,"Yes",1,4,1,1
"4848","2017-04-10",1,6,2,8,8,"Yes",0,2,0,6
"4849","2017-04-10",4,9,4,13,13,"No",2,2,6,3
"4850","2017-04-10",4,8,20,28,28,"Yes",12,8,4,4
"4851","2017-04-10",3,5,7,12,12,"Yes",2,5,2,3
"4852","2017-04-10",1,3,5,8,8,"No",4,1,1,2
"4853","2017-04-10",3,6,8,14,15,"Yes",4,4,3,3
"4854","2017-04-10",2,5,3,8,8,"Yes",1,2,3,2
"4855","2017-04-10",3,5,8,13,13,"Yes",3,5,3,2
"4856","2017-04-10",3,4,3,7,7,"No",NA,3,2,2
"4857","2017-04-10",1,5,4,9,9,"No",1,3,2,3
"4858","2017-04-10",1,9,7,16,16,"Yes",2,5,4,5
"4859","2017-04-10",2,8,4,12,12,"No",1,3,4,4
"4860","2017-04-10",3,10,13,23,23,"Yes",10,3,5,5
"4861","2017-04-10",2,3,7,10,10,"Yes",1,6,NA,3
"4862","2017-04-10",1,4,5,9,9,"Yes",0,5,2,2
"4863","2017-04-10",1,4,3,7,7,"Yes",1,2,2,2
"4864","2017-04-10",2,3,4,7,9,"Yes",1,3,2,1
"4865","2017-04-10",2,4,6,10,10,"Yes",5,1,2,2
"4866","2017-04-10",1,3,4,7,7,"No",1,3,1,2
"4867","2017-04-10",3,5,4,9,9,"Yes",0,4,3,2
"4868","2017-04-10",7,13,10,23,23,"Yes",6,4,7,6
"4869",NA,7,8,2,10,10,"No",2,0,5,3
"4870","2017-04-10",3,6,2,8,8,"Yes",2,0,3,3
"4871","2017-04-10",2,9,2,11,11,"Yes",1,1,4,5
"4872","2017-04-10",4,11,3,14,14,"Yes",1,2,5,6
"4873","2017-04-10",10,20,7,27,27,"Yes",3,4,10,10
"4874","2017-04-10",4,11,6,17,18,"Yes",1,5,5,6
"4875","2017-04-10",4,8,6,14,17,"No",4,2,4,4
"4876","2017-04-10",1,3,8,11,11,"Yes",2,6,1,2
"4877","2017-04-10",3,3,3,6,6,"Yes",1,2,2,1
"4878","2017-04-10",2,5,4,9,9,"Yes",1,3,2,3
"4879",NA,2,5,5,10,10,"No",1,4,2,3
"4880","2017-04-23",1,3,3,6,6,"Yes",3,0,2,1
"4881","2017-04-10",2,0,0,0,NA,"Yes",NA,NA,NA,NA
"4882","2017-04-10",1,6,1,7,7,"Yes",0,1,1,5
"4883","2017-04-10",1,5,4,9,9,"Yes",2,2,1,4
"4884","2017-04-10",4,6,4,10,10,"Yes",2,2,4,2
"4885","2017-04-10",5,0,0,0,NA,"Yes",NA,NA,NA,NA
"4886","2017-04-10",2,9,3,12,13,"Yes",1,2,4,5
"4887","2017-04-10",2,6,1,7,7,"Yes",1,0,2,4
"4888","2017-04-10",4,10,8,18,18,"Yes",3,5,4,6
"4889","2017-04-10",2,3,3,6,6,"Yes",2,1,2,1
"4890","2017-04-10",11,21,18,39,39,"No",8,10,11,10
"4891","2017-04-10",3,5,2,7,7,"Yes",1,1,1,4
"4892","2017-04-10",1,1,3,4,4,"Yes",1,2,0,1
"4893","2017-04-10",3,6,4,10,10,"No",1,3,3,3
"4894","2017-04-10",3,6,4,10,13,"Yes",1,3,3,3
"4895","2017-04-10",9,19,14,33,34,"Yes",9,5,7,12
"4896","2017-04-10",3,6,8,14,14,"No",6,2,3,3
"4897","2017-04-10",4,7,3,10,10,"No",1,2,4,3
"4898","2017-04-10",4,8,7,15,13,"Yes",4,3,4,4
"4899","2017-04-08",3,10,8,18,18,"No",4,4,5,5
"4900","2017-04-10",5,13,5,18,18,NA,3,2,6,7
"4901","2017-04-10",4,7,14,21,21,"Yes",8,6,4,3
"4902","2017-04-10",3,6,7,13,12,"Yes",3,4,3,3
"4903","2017-04-10",1,4,0,4,4,"Yes",NA,NA,4,NA
"4904","2017-04-10",1,3,2,5,5,"Yes",2,0,1,2
"4905","2017-04-10",NA,35,3,38,NA,"Yes",0,3,20,15
"4906","2017-04-10",8,15,5,20,20,"Yes",2,3,8,7
"4907","2017-04-10",7,16,15,31,31,"Yes",9,6,7,9
"4908","2017-04-10",1,2,2,4,4,"No",1,1,1,1
"4909","2017-04-10",4,8,11,19,19,"No",4,7,3,5
"4910","2017-04-10",2,5,4,9,9,"Yes",1,3,2,3
"4911","2017-04-10",2,3,6,9,9,"Yes",1,5,2,1
"4912","2017-04-10",5,11,8,19,20,"Yes",3,5,4,7
"4913","2017-04-10",2,7,2,9,9,"Yes",0,2,2,5
"4914","2017-04-10",6,13,12,25,27,"No",7,5,5,8
"4915","2017-04-10",1,4,4,8,9,"Yes",1,3,2,2
"4916","2017-04-11",9,5,5,10,30,"Yes",3,2,4,1
"4917","2017-04-11",5,13,22,35,32,"Yes",9,13,5,8
"4918","2017-04-11",5,7,4,11,11,"Yes",1,3,4,3
"4919","2017-04-11",7,14,24,38,38,"Yes",9,15,7,7
"4920","2017-04-11",2,9,6,15,16,"Yes",5,1,6,3
"4921","2017-04-11",NA,4,2,6,NA,"Yes",1,1,2,2
"4922","2017-04-11",2,3,5,8,7,"No",1,4,2,1
"4923","2017-04-11",1,2,0,2,2,"Yes",0,0,2,0
"4924","2017-04-11",3,8,9,17,17,"Yes",8,1,4,4
"4925","2017-04-11",1,6,0,6,6,"Yes",NA,NA,3,3
"4926","2017-04-11",6,16,7,23,25,"Yes",3,4,6,10
"4927","2017-04-11",5,10,10,20,20,"Yes",6,4,5,5
"4928","2017-04-11",17,34,38,72,64,"No",18,20,17,17
"4929","2017-04-11",11,20,30,50,40,"No",15,15,5,15
"4930","2017-04-11",9,15,10,25,25,"Yes",6,4,9,6
"4931","2017-04-11",1,2,3,5,5,"No",1,2,0,2
"4932","2017-04-11",3,7,10,17,15,"Yes",3,7,3,4
"4933","2017-04-11",2,3,0,3,3,"Yes",NA,NA,1,2
"4934","2017-04-11",5,8,5,13,14,"Yes",3,2,3,5
"4935","2017-04-11",NA,85,67,152,NA,"No",25,42,55,30
"4936","2017-04-11",3,5,10,15,15,"No",4,6,3,2
"4937","2017-04-11",1,5,5,10,10,"Yes",1,4,2,3
"4938","2017-04-11",1,5,0,5,5,"Yes",0,0,2,3
"4939","2017-04-11",1,4,5,9,9,"Yes",2,3,1,3
"4940","2017-04-11",1,3,0,3,3,"Yes",0,0,2,1
"4941","2017-04-11",2,7,11,18,18,"Yes",6,5,4,3
"4942","2017-04-11",11,9,31,40,40,"Yes",15,16,1,8
"4943","2017-04-11",4,8,7,15,25,"Yes",3,4,4,4
"4944","2017-04-11",1,5,4,9,9,"Yes",1,3,3,2
"4945","2017-04-11",1,4,3,7,7,"Yes",1,2,3,1
"4946","2017-04-11",4,11,10,21,21,"Yes",4,6,8,3
"4947","2017-04-11",5,9,9,18,18,"No",3,6,5,4
"4948","2017-04-11",6,14,6,20,30,"Yes",3,3,7,7
"4949","2017-04-11",1,2,5,7,7,"Yes",3,2,1,1
"4950","2017-04-11",3,9,6,15,16,"Yes",3,3,4,5
"4951","2017-04-11",12,10,20,30,30,"Yes",8,12,4,6
"4952","2017-04-11",5,8,9,17,18,"No",3,6,2,6
"4953","2017-04-11",6,13,8,21,24,"Yes",1,7,7,6
"4954","2017-04-11",7,14,20,34,34,"Yes",8,12,7,7
"4955","2017-04-11",7,11,16,27,25,"Yes",9,7,5,6
"4956","2017-04-11",NA,2,2,4,4,"Yes",1,1,1,1
"4957","2017-04-11",2,7,5,12,12,"Yes",3,2,3,4
"4958","2017-04-11",1,2,2,4,4,"Yes",NA,2,1,1
"4959","2017-04-12",6,14,8,22,19,"No",3,5,6,8
"4960","2017-04-11",4,8,8,16,16,"No",3,5,4,4
"4961","2017-04-11",1,1,7,8,8,"Yes",6,1,1,0
"4962","2017-04-11",3,12,8,20,20,"No",3,5,5,7
"4963","2017-04-11",2,3,2,5,6,"Yes",1,1,1,2
"4964","2017-04-11",4,9,9,18,18,"No",4,5,4,5
"4965","2017-04-11",5,10,10,20,20,"No",4,6,6,4
"4966","2017-04-11",7,14,0,14,20,"No",NA,NA,8,6
"4967","2017-04-11",4,11,7,18,18,"No",4,3,6,5
"4968","2017-04-11",1,5,4,9,9,"No",1,3,2,3
"4969","2017-04-11",4,8,7,15,15,"Yes",3,4,4,4
"4970","2017-04-11",2,5,5,10,11,"Yes",2,3,2,3
"4971","2017-04-11",8,14,14,28,28,"Yes",8,6,7,7
"4972","2017-04-11",4,8,9,17,17,"No",4,5,4,4
"4973","2017-04-11",5,12,5,17,18,"No",3,2,5,7
"4974","2017-04-11",10,27,4,31,31,"Yes",2,2,12,15
"4975","2017-04-11",10,5,20,25,25,"Yes",8,12,1,4
"4976","2017-04-11",4,10,8,18,22,"Yes",3,5,5,5
"4977","2017-04-11",2,8,5,13,13,"No",2,3,4,4
"4978","2017-04-11",5,23,14,37,25,"Yes",4,10,5,18
"4979","2017-04-11",8,16,9,25,24,"Yes",6,3,6,10
"4980","2017-04-11",2,6,1,7,7,"Yes",0,1,4,2
"4981","2017-04-11",5,10,6,16,16,"Yes",3,3,5,5
"4982","2017-04-11",3,9,19,28,28,"Yes",8,11,5,4
"4983","2017-04-11",4,12,4,16,16,NA,1,3,4,8
"4984","2017-04-11",1,7,3,10,10,"Yes",1,2,4,3
"4985","2017-04-11",2,4,2,6,6,"Yes",1,1,2,2
"4986","2017-04-11",3,13,9,22,22,"Yes",4,5,7,6
"4987","2017-04-11",1,7,6,13,13,"Yes",4,2,4,3
"4988","2017-04-11",5,11,10,21,21,"Yes",6,4,5,6
"4989","2017-04-11",1,2,5,7,8,"Yes",2,3,1,1
"4990","2017-04-11",2,4,3,7,8,"No",2,1,2,2
"4991","2017-04-11",1,2,3,5,NA,"No",2,1,1,1
"4992","2017-04-11",1,2,6,8,8,"Yes",4,2,1,1
"4993","2017-04-11",1,2,5,7,7,"Yes",0,5,1,1
"4994","2017-04-11",4,12,13,25,25,"Yes",8,5,6,6
"4995","2017-04-11",2,4,10,14,14,"Yes",3,7,2,2
"4996","2017-04-11",1,2,3,5,5,"Yes",3,NA,1,1
"4997","2017-04-11",5,10,8,18,21,"Yes",3,5,5,5
"4998","2017-04-11",2,6,1,7,8,"Yes",1,NA,4,2
"4999","2017-04-11",4,7,9,16,16,"No",5,4,4,3
"5000","2017-04-11",3,3,3,6,7,"Yes",2,1,2,1
"5001","2017-04-11",4,10,5,15,15,"Yes",2,3,4,6
"5002","2017-04-11",3,7,4,11,11,"Yes",1,3,3,4
"5003","2017-04-11",4,8,8,16,NA,"Yes",5,3,4,4
"5004",NA,1,6,1,7,6,"Yes",1,NA,3,3
"5005","2017-04-11",1,9,7,16,16,"No",4,3,5,4
"5006","2017-04-11",3,6,1,7,7,"No",NA,1,3,3
"5007","2017-04-11",4,8,10,18,18,"No",4,6,4,4
"5008","2017-04-11",3,6,4,10,12,"No",3,1,2,4
"5009","2017-04-11",6,14,9,23,23,"Yes",4,5,6,8
"5010","2017-04-11",NA,17,5,22,NA,"Yes",2,3,9,8
"5011","2017-04-11",3,13,11,24,24,"Yes",6,5,4,9
"5012","2017-04-11",5,12,1,13,13,"Yes",0,1,6,6
"5013","2017-04-11",3,11,6,17,17,"Yes",2,4,7,4
"5014","2017-04-11",1,2,4,6,6,"No",4,0,1,1
"5015","2017-04-11",1,6,3,9,9,"No",1,2,3,3
"5016","2017-04-11",10,20,17,37,37,"No",8,9,10,10
"5017","2017-04-11",1,2,4,6,6,"Yes",3,1,1,1
"5018","2017-04-11",11,21,14,35,35,"Yes",6,8,11,10
"5019","2017-04-11",5,9,7,16,16,"Yes",4,3,5,4
"5020","2017-04-11",4,8,6,14,14,"Yes",3,3,4,4
"5021","2017-04-11",7,10,30,40,40,"No",10,20,4,6
"5022","2017-04-11",2,5,6,11,11,"Yes",3,3,2,3
"5023","2017-04-11",1,2,4,6,5,"Yes",1,3,1,1
"5024","2017-04-11",2,4,5,9,9,"Yes",2,3,2,2
"5025","2017-04-11",7,14,11,25,30,"Yes",5,6,7,7
"5026","2017-04-11",1,3,4,7,7,"Yes",2,2,1,2
"5027","2017-04-11",5,9,6,15,15,"No",2,4,5,4
"5028","2017-04-11",1,4,0,4,4,"No",0,0,2,2
"5029","2017-04-11",1,20,370,390,390,"Yes",170,200,10,10
"5030","2017-04-11",1,2,1,3,3,"Yes",1,NA,1,1
"5031","2017-04-11",2,11,9,20,20,"Yes",4,5,5,6
"5032","2017-04-18",0,0,0,0,0,"No",0,0,0,0
"5033","2017-04-18",3,7,4,11,11,"Yes",1,3,4,3
"5034","2017-04-11",2,5,5,10,7,"Yes",NA,5,3,2
"5035","2017-04-11",1,4,2,6,6,"Yes",2,0,2,2
"5036","2017-04-11",5,7,7,14,21,"No",3,4,3,4
"5037","2017-04-11",2,3,5,8,8,"Yes",2,3,2,1
"5038","2017-04-11",14,33,35,68,70,"No",15,20,14,19
"5039","2017-04-11",5,13,17,30,30,"Yes",11,6,5,8
"5040","2017-04-11",9,14,10,24,32,"Yes",6,4,8,6
"5041","2017-04-11",5,10,23,33,33,"Yes",10,13,5,5
"5042","2017-04-11",16,22,13,35,45,"Yes",5,8,10,12
"5043","2017-04-11",5,10,6,16,16,"Yes",2,4,5,5
"5044","2017-04-11",14,28,20,48,40,"No",9,11,14,14
"5045","2017-04-11",2,9,0,9,9,"Yes",NA,NA,4,5
"5046","2017-04-11",5,9,16,25,25,"Yes",7,9,4,5
"5047","2017-04-11",4,6,3,9,9,"No",1,2,3,3
"5048","2017-04-11",4,8,2,10,10,"Yes",1,1,4,4
"5049","2017-04-11",2,5,3,8,12,"Yes",1,2,1,4
"5050","2017-04-11",1,3,2,5,5,"Yes",0,2,1,2
"5051","2017-04-11",9,20,101,121,121,"Yes",43,58,9,11
"5052","2017-04-11",2,5,1,6,7,"Yes",1,0,3,2
"5053","2017-04-11",NA,50,0,50,NA,"No",NA,NA,20,30
"5054","2017-04-11",4,8,14,22,22,"Yes",6,8,4,4
"5055","2017-04-11",2,7,4,11,10,"Yes",1,3,4,3
"5056","2017-04-11",1,2,5,7,7,"Yes",2,3,1,1
"5057","2017-04-11",3,11,2,13,16,"No",0,2,3,8
"5058","2017-04-11",7,15,6,21,21,"Yes",2,4,10,5
"5059","2017-04-11",4,15,11,26,26,"Yes",8,3,9,6
"5060","2017-04-11",3,6,5,11,11,"Yes",4,1,3,3
"5061","2017-04-11",1,4,1,5,5,"Yes",0,1,2,2
"5062",NA,7,20,12,32,32,"No",6,6,11,9
"5063","2017-04-11",3,5,6,11,11,"Yes",3,3,3,2
"5064","2017-04-11",1,8,2,10,10,"Yes",1,1,2,6
"5065","2017-04-11",3,6,10,16,16,"No",7,3,3,3
"5066","2017-04-11",8,10,10,20,22,"Yes",3,7,6,4
"5067","2017-04-11",10,20,11,31,34,"No",6,5,10,10
"5068","2017-04-11",3,9,1,10,10,"No",0,1,5,4
"5069","2017-04-11",5,10,15,25,25,"Yes",8,7,5,5
"5070","2017-04-11",6,10,15,25,25,"Yes",5,10,4,6
"5071","2017-04-11",2,4,2,6,8,"Yes",NA,2,2,2
"5072","2017-04-11",1,1,3,4,4,"Yes",1,2,0,1
"5073","2017-04-11",1,10,5,15,13,"Yes",4,1,4,6
"5074","2017-04-11",3,6,9,15,15,"No",5,4,2,4
"5075","2017-04-11",4,6,1,7,7,"Yes",1,NA,3,3
"5076","2017-04-11",1,2,1,3,3,"No",0,1,1,1
"5077","2017-04-11",4,9,8,17,19,"Yes",3,5,5,4
"5078","2017-04-11",5,10,4,14,16,"Yes",0,4,6,4
"5079","2017-04-11",2,7,7,14,14,"Yes",5,2,4,3
"5080","2017-04-11",4,9,8,17,17,"Yes",6,2,4,5
"5081","2017-04-11",4,8,2,10,10,"No",1,1,4,4
"5082","2017-04-11",2,0,0,0,6,"No",NA,NA,NA,NA
"5083","2017-04-11",1,6,1,7,7,"Yes",1,0,3,3
"5084","2017-04-11",2,6,4,10,10,"No",1,3,2,4
"5085","2017-04-11",2,7,7,14,14,"Yes",4,3,4,3
"5086","2017-04-11",2,5,7,12,13,"No",2,5,2,3
"5087","2017-04-11",6,7,18,25,35,"Yes",10,8,2,5
"5088","2017-04-11",5,9,3,12,12,"Yes",1,2,4,5
"5089","2017-04-11",4,10,5,15,16,"No",0,5,5,5
"5090","2017-04-11",1,3,5,8,11,"Yes",0,5,0,3
"5091","2017-04-11",1,3,1,4,5,"Yes",NA,1,2,1
"5092","2017-04-11",1,6,3,9,9,"Yes",3,NA,3,3
"5093","2017-04-11",1,5,4,9,8,"Yes",2,2,3,2
"5094","2017-04-11",1,2,3,5,5,"No",1,2,0,2
"5095","2017-04-11",1,2,4,6,6,NA,3,1,1,1
"5096","2017-04-11",1,9,6,15,16,"Yes",2,4,5,4
"5097","2017-04-11",6,10,7,17,19,"No",3,4,6,4
"5098","2017-04-11",1,2,4,6,6,"No",1,3,1,1
"5099","2017-04-11",1,6,3,9,9,"No",1,2,3,3
"5100","2017-04-11",1,8,2,10,10,"Yes",1,1,3,5
"5101","2017-04-11",2,0,8,8,10,"Yes",6,2,NA,NA
"5102","2017-04-11",4,6,9,15,15,"No",5,4,2,4
"5103","2017-04-11",2,4,7,11,11,"Yes",4,3,1,3
"5104","2017-04-11",2,5,3,8,8,"Yes",2,1,3,2
"5105","2017-04-12",8,16,4,20,25,"Yes",1,3,8,8
"5106","2017-04-11",4,10,5,15,15,"Yes",2,3,4,6
"5107","2017-04-11",6,17,13,30,19,NA,7,6,8,9
"5108","2017-04-11",4,8,12,20,20,"No",9,3,4,4
"5109","2017-04-11",3,7,4,11,11,"Yes",1,3,4,3
"5110","2017-04-11",1,7,5,12,12,"Yes",4,1,2,5
"5111","2017-04-11",4,8,2,10,16,"Yes",0,2,3,5
"5112","2017-04-11",1,6,5,11,11,"Yes",3,2,1,5
"5113","2017-04-11",2,0,0,0,NA,"Yes",NA,NA,NA,NA
"5114","2017-04-11",2,7,7,14,14,"No",4,3,4,3
"5115","2017-04-11",4,6,3,9,9,"No",1,2,4,2
"5116","2017-04-10",1,4,1,5,5,"Yes",0,1,2,2
"5117",NA,5,8,11,19,19,"No",7,4,4,4
"5118","2017-04-11",10,20,10,30,34,"Yes",6,4,10,10
"5119","2017-04-11",6,10,8,18,24,"No",3,5,5,5
"5120","2017-04-11",5,8,13,21,21,"Yes",2,11,4,4
"5121","2017-04-11",1,3,5,8,8,"Yes",2,3,1,2
"5122","2017-04-10",5,13,3,16,16,"No",1,2,6,7
"5123","2017-04-11",3,6,9,15,15,"Yes",4,5,3,3
"5124","2017-04-11",1,5,4,9,9,"No",1,3,2,3
"5125","2017-04-11",1,5,4,9,8,"Yes",4,0,2,3
"5126","2017-04-11",4,13,3,16,16,"Yes",2,1,6,7
"5127","2017-04-11",2,4,3,7,7,"Yes",1,2,2,2
"5128","2017-04-11",4,12,8,20,NA,"Yes",2,6,7,5
"5129","2017-04-11",3,17,9,26,26,"No",4,5,8,9
"5130","2017-04-10",1,3,3,6,6,"Yes",0,3,1,2
"5131","2017-04-11",1,6,5,11,11,"Yes",3,2,3,3
"5132","2017-04-11",3,6,9,15,15,"Yes",3,6,3,3
"5133","2017-04-11",3,7,3,10,10,"Yes",3,0,4,3
"5134","2017-04-11",2,6,6,12,12,"Yes",2,4,3,3
"5135","2017-04-11",1,5,3,8,8,"Yes",1,2,2,3
"5136","2017-04-11",2,5,4,9,12,"No",2,2,2,3
"5137","2017-04-11",7,22,10,32,32,"Yes",4,6,12,10
"5138","2017-04-11",5,11,1,12,11,"Yes",NA,1,5,6
"5139","2017-04-11",2,6,2,8,8,"Yes",1,1,3,3
"5140","2017-04-11",1,4,0,4,4,"Yes",0,0,1,3
"5141","2017-04-11",4,7,13,20,20,"Yes",7,6,2,5
"5142","2017-04-11",2,11,4,15,16,"Yes",2,2,4,7
"5143","2017-04-11",3,8,8,16,16,"No",6,2,5,3
"5144","2017-04-11",8,15,11,26,32,"Yes",9,2,7,8
"5145","2017-04-11",1,4,5,9,9,"Yes",3,2,1,3
"5146","2017-04-11",1,5,3,8,9,"Yes",0,3,2,3
"5147","2017-04-11",2,4,8,12,13,"No",5,3,2,2
"5148","2017-04-10",8,18,10,28,29,"No",3,7,8,10
"5149","2017-04-11",4,7,8,15,15,"No",1,7,3,4
"5150","2017-04-11",2,5,1,6,6,"Yes",0,1,2,3
"5151","2017-04-11",3,8,5,13,14,"Yes",3,2,3,5
"5152","2017-04-11",1,6,3,9,9,"Yes",3,0,3,3
"5153","2017-04-11",5,10,6,16,19,"No",2,4,5,5
"5154","2017-04-11",2,4,5,9,9,"Yes",3,2,2,2
"5155","2017-04-11",6,12,5,17,17,"Yes",4,1,6,6
"5156","2017-04-10",4,16,7,23,22,"Yes",4,3,8,8
"5157","2017-04-11",3,6,6,12,15,"No",2,4,3,3
"5158","2017-04-11",3,7,7,14,14,"Yes",5,2,3,4
"5159","2017-04-11",1,2,8,10,12,"Yes",3,5,1,1
"5160","2017-04-10",5,10,13,23,23,"Yes",8,5,5,5
"5161","2017-04-11",6,13,11,24,24,"Yes",7,4,7,6
"5162","2017-04-11",2,4,2,6,8,"No",0,2,2,2
"5163","2017-04-11",3,6,5,11,11,"No",2,3,3,3
"5164","2017-04-11",7,17,12,29,32,"Yes",5,7,9,8
"5165","2017-04-11",3,5,9,14,14,"Yes",1,8,3,2
"5166","2017-04-11",2,11,6,17,17,"No",3,3,6,5
"5167","2017-04-11",5,10,12,22,22,"Yes",8,4,5,5
"5168","2017-04-11",5,14,3,17,16,"Yes",3,0,8,6
"5169","2017-04-11",4,15,7,22,26,"Yes",2,5,6,9
"5170","2017-04-11",3,6,6,12,12,"Yes",2,4,3,3
"5171","2017-04-11",2,11,9,20,15,"Yes",5,4,6,5
"5172","2017-04-11",1,3,3,6,6,"No",2,1,0,3
"5173","2017-04-11",6,11,4,15,15,"Yes",1,3,5,6
"5174","2017-04-11",3,5,2,7,8,"No",1,1,3,2
"5175","2017-04-07",1,8,4,12,12,NA,1,3,4,4
"5176","2017-04-11",4,8,6,14,14,"No",3,3,4,4
"5177","2017-04-11",4,8,7,15,17,"No",3,4,3,5
"5178","2017-04-11",2,8,2,10,10,"No",2,0,3,5
"5179","2017-04-11",3,8,1,9,7,"Yes",1,0,4,4
"5180","2017-04-11",3,8,2,10,10,"Yes",1,1,5,3
"5181","2017-04-11",2,7,5,12,12,"No",2,3,4,3
"5182","2017-04-11",4,6,5,11,12,"Yes",2,3,3,3
"5183","2017-04-11",1,2,3,5,5,"Yes",1,2,1,1
"5184","2017-04-11",5,9,5,14,14,"Yes",3,2,4,5
"5185","2017-04-11",2,8,0,8,8,"Yes",0,0,5,3
"5186","2017-04-11",3,10,6,16,17,"Yes",2,4,3,7
"5187","2017-04-11",8,22,5,27,29,"Yes",3,2,10,12
"5188","2017-04-11",4,10,11,21,21,"Yes",7,4,5,5
"5189","2017-04-11",1,2,1,3,3,"Yes",NA,1,1,1
"5190","2017-04-07",3,8,12,20,20,"Yes",8,4,4,4
"5191","2017-04-11",3,6,3,9,11,"No",1,2,3,3
"5192","2017-04-11",8,11,2,13,13,"Yes",1,1,6,5
"5193","2017-04-11",8,22,3,25,25,"Yes",1,2,9,13
"5194","2017-04-11",2,1,5,6,6,"Yes",NA,5,NA,1
"5195","2017-04-11",NA,300,85,385,NA,"No",40,45,130,170
"5196","2017-04-11",NA,0,0,0,NA,"Yes",NA,NA,NA,NA
"5197","2017-04-11",3,9,4,13,17,"No",2,2,3,6
"5198","2017-04-11",1,2,12,14,14,"Yes",4,8,1,1
"5199","2017-04-11",NA,471,87,558,NA,"No",39,48,203,268
"5200","2017-04-11",7,15,35,50,50,"No",15,20,5,10
"5201","2017-04-11",2,3,3,6,6,"Yes",1,2,2,1
"5202","2017-04-11",3,5,6,11,18,"Yes",4,2,3,2
"5203","2017-04-11",3,4,5,9,9,"No",3,2,2,2
"5204","2017-04-11",4,5,10,15,15,"Yes",3,7,2,3
"5205","2017-04-18",11,25,10,35,35,"Yes",4,6,13,12
"5206","2017-04-12",1,2,2,4,7,"No",1,1,1,1
"5207","2017-04-12",1,3,2,5,6,"Yes",2,0,2,1
"5208","2017-04-11",4,11,6,17,17,"Yes",1,5,5,6
"5209","2017-04-11",4,6,9,15,15,"No",6,3,3,3
"5210","2017-04-12",3,7,5,12,13,"Yes",1,4,4,3
"5211","2017-04-10",NA,9,120,129,NA,"No",60,60,5,4
"5212","2017-04-12",1,5,2,7,7,"Yes",1,1,2,3
"5213","2017-04-12",3,16,4,20,21,"No",3,1,10,6
"5214","2017-04-12",3,11,4,15,15,"Yes",1,3,6,5
"5215","2017-04-12",2,4,2,6,7,"Yes",NA,2,2,2
"5216","2017-04-12",1,4,3,7,7,"Yes",1,2,1,3
"5217","2017-04-12",3,6,5,11,11,"Yes",4,1,3,3
"5218","2017-04-12",1,6,6,12,12,"Yes",3,3,4,2
"5219","2017-04-12",8,16,11,27,32,"Yes",5,6,8,8
"5220","2017-04-12",2,7,2,9,9,"Yes",1,1,3,4
"5221","2017-04-12",1,4,0,4,3,"Yes",NA,NA,3,1
"5222","2017-04-12",1,4,4,8,5,"No",3,1,3,1
"5223","2017-04-12",3,8,5,13,13,"No",3,2,5,3
"5224","2017-04-12",3,9,7,16,16,"No",3,4,3,6
"5225","2017-04-12",3,4,3,7,8,"No",2,1,3,1
"5226","2017-04-12",2,4,9,13,13,"Yes",3,6,2,2
"5227","2017-04-12",7,9,11,20,20,"Yes",5,6,4,5
"5228","2017-04-12",4,10,14,24,28,"Yes",7,7,5,5
"5229","2017-04-12",8,20,10,30,34,NA,3,7,8,12
"5230","2017-04-12",1,5,5,10,9,"Yes",3,2,1,4
"5231","2017-04-12",1,1,1,2,2,"Yes",1,NA,NA,1
"5232","2017-04-12",1,2,0,2,2,"Yes",0,0,0,2
"5233","2017-04-12",1,7,3,10,10,"Yes",1,2,3,4
"5234","2017-04-12",3,6,3,9,10,"No",1,2,3,3
"5235","2017-04-12",3,17,5,22,21,"Yes",3,2,3,14
"5236","2017-04-12",4,9,14,23,24,"Yes",8,6,5,4
"5237","2017-04-12",NA,6,69,75,NA,"No",34,35,3,3
"5238","2017-04-12",1,2,2,4,4,"Yes",1,1,1,1
"5239","2017-04-12",5,10,5,15,15,"Yes",2,3,5,5
"5240","2017-04-12",3,5,9,14,14,"Yes",6,3,3,2
"5241","2017-04-12",NA,53,41,94,NA,"No",21,20,15,38
"5242","2017-04-12",2,10,9,19,19,"Yes",6,3,3,7
"5243","2017-04-12",6,13,15,28,28,"Yes",5,10,6,7
"5244","2017-04-12",4,7,6,13,13,"Yes",3,3,3,4
"5245","2017-04-12",4,12,14,26,19,"Yes",8,6,6,6
"5246","2017-04-12",1,4,6,10,12,"Yes",0,6,1,3
"5247","2017-04-12",12,10,18,28,28,"Yes",8,10,4,6
"5248","2017-04-12",3,7,2,9,9,"No",2,0,4,3
"5249","2017-04-12",1,10,1570,1580,1580,"Yes",570,1000,5,5
"5250","2017-04-12",2,6,4,10,12,"Yes",2,2,1,5
"5251","2017-04-12",5,9,10,19,19,"Yes",5,5,5,4
"5252","2017-04-12",4,9,4,13,13,"Yes",1,3,4,5
"5253","2017-04-19",2,3,5,8,8,"No",3,2,2,1
"5254","2017-04-12",7,14,12,26,26,"Yes",7,5,7,7
"5255","2017-04-12",1,2,2,4,4,"Yes",NA,2,1,1
"5256","2017-04-12",4,8,4,12,17,"No",1,3,4,4
"5257","2017-04-12",3,10,8,18,8,"Yes",3,5,4,6
"5258","2017-04-12",6,9,9,18,18,"Yes",6,3,4,5
"5259","2017-04-12",1,2,2,4,4,"Yes",2,NA,1,1
"5260","2017-04-12",1,4,3,7,7,"Yes",2,1,1,3
"5261","2017-04-12",5,14,16,30,30,"Yes",6,10,7,7
"5262","2017-04-12",3,5,8,13,13,"Yes",3,5,2,3
"5263","2017-04-12",4,8,8,16,15,"No",6,2,4,4
"5264","2017-04-12",4,9,8,17,17,"Yes",3,5,6,3
"5265","2017-04-12",2,4,2,6,8,"Yes",1,1,2,2
"5266","2017-04-12",1,3,9,12,9,"Yes",3,6,1,2
"5267","2017-04-12",1,5,2,7,7,"Yes",1,1,2,3
"5268","2017-04-12",1,3,5,8,8,"Yes",3,2,2,1
"5269","2017-04-12",10,20,28,48,68,"Yes",9,19,8,12
"5270","2017-04-12",3,9,5,14,13,"Yes",4,1,6,3
"5271","2017-04-12",1,2,1,3,3,"Yes",1,0,1,1
"5272","2017-04-12",1,2,3,5,5,"Yes",1,2,1,1
"5273","2017-04-12",4,11,11,22,22,"No",4,7,4,7
"5274","2017-04-12",1,5,5,10,10,"No",1,4,2,3
"5275","2017-04-12",5,10,8,18,18,"No",5,3,5,5
"5276","2017-04-12",3,7,7,14,14,"Yes",5,2,4,3
"5277","2017-04-12",6,13,8,21,22,"Yes",5,3,5,8
"5278","2017-04-12",1,3,3,6,6,"No",2,1,1,2
"5279","2017-04-12",3,7,5,12,15,"Yes",3,2,5,2
"5280","2017-04-12",5,6,14,20,20,"Yes",3,11,4,2
"5281","2017-04-12",7,12,2,14,13,"Yes",NA,2,7,5
"5282","2017-04-12",2,4,5,9,9,"Yes",3,2,2,2
"5283","2017-04-12",4,14,4,18,18,"Yes",2,2,9,5
"5284","2017-04-12",6,12,5,17,19,"No",2,3,6,6
"5285","2017-04-12",1,5,2,7,7,"Yes",NA,2,2,3
"5286","2017-04-12",5,11,1,12,23,"Yes",1,NA,7,4
"5287","2017-04-12",8,12,5,17,17,"Yes",1,4,6,6
"5288","2017-04-12",10,20,30,50,50,"No",10,20,9,11
"5289","2017-04-12",2,3,0,3,3,"No",NA,NA,2,1
"5290","2017-04-12",2,4,4,8,8,"No",2,2,1,3
"5291","2017-04-12",5,17,13,30,30,"Yes",6,7,9,8
"5292","2017-04-12",1,2,2,4,4,"Yes",1,1,1,1
"5293","2017-04-12",2,5,2,7,10,"Yes",1,1,2,3
"5294","2017-04-12",1,3,3,6,7,"Yes",1,2,1,2
"5295","2017-04-12",3,5,1,6,6,"No",1,0,2,3
"5296","2017-04-12",3,6,2,8,7,"Yes",NA,2,3,3
"5297","2017-04-12",1,2,4,6,6,"Yes",1,3,1,1
"5298","2017-04-12",2,3,5,8,8,"Yes",3,2,1,2
"5299","2017-04-12",3,6,9,15,16,"Yes",6,3,3,3
"5300","2017-04-12",5,12,7,19,18,"Yes",2,5,6,6
"5301","2017-04-12",5,10,15,25,25,"Yes",6,9,5,5
"5302","2017-04-12",15,30,10,40,42,"Yes",5,5,15,15
"5303","2017-04-12",2,4,2,6,6,"No",1,1,2,2
"5304","2017-04-12",1,2,4,6,6,"Yes",2,2,1,1
"5305","2017-04-12",10,20,2,22,22,"Yes",2,0,10,10
"5306","2017-04-12",4,11,10,21,21,"Yes",8,2,5,6
"5307","2017-04-12",1,7,4,11,11,"Yes",2,2,4,3
"5308","2017-04-12",4,5,15,20,20,"No",5,10,2,3
"5309","2017-04-12",5,10,16,26,26,"Yes",7,9,5,5
"5310","2017-04-12",6,20,15,35,23,"Yes",7,8,10,10
"5311","2017-04-12",1,2,3,5,5,"No",1,2,1,1
"5312","2017-04-12",4,6,4,10,9,"Yes",3,1,3,3
"5313","2017-04-12",3,7,1,8,8,"Yes",1,0,4,3
"5314","2017-04-12",6,8,6,14,14,"Yes",2,4,3,5
"5315","2017-04-12",2,8,5,13,13,"Yes",3,2,4,4
"5316","2017-04-12",10,20,35,55,55,"No",10,25,8,12
"5317","2017-04-12",5,9,18,27,17,"Yes",8,10,5,4
"5318","2017-04-12",1,2,3,5,6,"Yes",2,1,1,1
"5319","2017-04-12",3,7,0,7,7,"No",0,0,7,0
"5320","2017-04-12",11,16,9,25,25,"Yes",3,6,9,7
"5321","2017-04-12",3,6,4,10,10,"No",2,2,3,3
"5322","2017-04-12",1,2,3,5,5,"No",1,2,1,1
"5323","2017-04-12",1,10,5,15,15,"Yes",2,3,4,6
"5324","2017-04-12",6,12,3,15,16,"No",2,1,5,7
"5325","2017-04-12",3,5,0,5,5,"Yes",0,0,2,3
"5326","2017-04-12",3,12,8,20,20,"Yes",3,5,6,6
"5327","2017-04-12",4,8,6,14,16,"Yes",0,6,4,4
"5328","2017-04-12",NA,8,11,19,NA,"Yes",6,5,3,5
"5329","2017-04-12",4,8,5,13,13,"No",1,4,4,4
"5330","2017-04-12",3,5,3,8,10,"Yes",1,2,2,3
"5331","2017-04-12",3,13,7,20,27,"Yes",2,5,3,10
"5332","2017-04-12",5,10,9,19,19,"Yes",5,4,6,4
"5333","2017-04-12",3,6,4,10,13,"Yes",1,3,3,3
"5334","2017-04-12",7,25,5,30,30,"Yes",2,3,12,13
"5335","2017-04-12",3,5,2,7,7,"Yes",0,2,1,4
"5336","2017-04-12",4,6,10,16,16,"Yes",5,5,3,3
"5337","2017-04-12",5,17,8,25,25,"No",3,5,7,10
"5338","2017-04-12",1,3,2,5,5,"Yes",0,2,1,2
"5339","2017-04-12",2,3,3,6,6,"No",2,1,1,2
"5340","2017-04-12",5,7,5,12,12,"No",2,3,5,2
"5341","2017-04-12",7,14,6,20,20,"Yes",2,4,7,7
"5342","2017-04-12",1,3,3,6,6,"Yes",1,2,2,1
"5343","2017-04-12",1,6,0,6,6,"No",0,0,3,3
"5344","2017-04-12",4,9,7,16,16,"Yes",1,6,4,5
"5345","2017-04-12",1,5,9,14,14,"Yes",3,6,2,3
"5346","2017-04-12",2,16,4,20,20,"No",0,4,7,9
"5347","2017-04-12",1,5,5,10,11,"Yes",3,2,2,3
"5348","2017-04-12",4,5,13,18,18,"Yes",4,9,3,2
"5349","2017-04-12",5,9,9,18,18,"Yes",2,7,7,2
"5350","2017-04-12",4,10,6,16,16,"Yes",2,4,5,5
"5351","2017-04-12",5,10,15,25,25,"Yes",5,10,4,6
"5352","2017-04-12",1,2,3,5,5,"No",NA,3,1,1
"5353","2017-04-12",7,10,7,17,29,"Yes",4,3,6,4
"5354","2017-04-12",1,2,4,6,6,"Yes",0,4,1,1
"5355","2017-04-12",NA,62,2,64,NA,"Yes",0,2,25,37
"5356","2017-04-12",3,7,4,11,11,"Yes",1,3,4,3
"5357","2017-04-12",NA,2,2,4,NA,"No",1,1,1,1
"5358","2017-04-12",1,2,2,4,4,"Yes",0,2,1,1
"5359","2017-04-12",2,8,5,13,13,"Yes",2,3,3,5
"5360","2017-04-12",5,10,10,20,25,"No",2,8,5,5
"5361","2017-04-12",2,2,6,8,8,"Yes",2,4,1,1
"5362","2017-04-12",1,2,2,4,3,"Yes",1,1,0,2
"5363","2017-04-12",5,13,4,17,29,"Yes",2,2,7,6
"5364","2017-04-12",2,9,5,14,14,"Yes",5,NA,3,6
"5365","2017-04-12",1,2,3,5,5,"Yes",3,0,1,1
"5366","2017-04-12",7,14,2,16,16,"Yes",1,1,7,7
"5367","2017-04-12",2,4,11,15,15,"Yes",5,6,2,2
"5368","2017-04-12",3,5,7,12,10,"No",3,4,2,3
"5369","2017-04-12",1,4,1,5,5,"Yes",1,0,2,2
"5370","2017-04-12",3,5,14,19,19,"Yes",10,4,2,3
"5371","2017-04-12",5,9,11,20,21,"Yes",5,6,5,4
"5372","2017-04-12",2,6,6,12,12,"No",3,3,3,3
"5373","2017-04-12",6,15,4,19,19,"Yes",3,1,8,7
"5374","2017-04-12",4,8,8,16,20,"Yes",2,6,4,4
"5375","2017-04-12",3,5,6,11,12,"Yes",2,4,2,3
"5376","2017-04-12",12,20,12,32,34,"Yes",7,5,12,8
"5377","2017-04-12",8,16,10,26,25,"No",6,4,8,8
"5378","2017-04-12",5,11,1,12,12,"No",0,1,6,5
"5379","2017-04-12",8,30,12,42,32,"No",6,6,15,15
"5380","2017-04-12",3,9,4,13,11,"No",3,1,6,3
"5381","2017-04-12",3,4,4,8,8,"Yes",2,2,3,1
"5382","2017-04-12",2,5,7,12,10,"Yes",5,2,3,2
"5383","2017-04-12",3,4,5,9,9,"Yes",1,4,3,1
"5384","2017-04-12",7,12,4,16,15,"Yes",1,3,6,6
"5385","2017-04-12",4,8,1,9,9,"Yes",NA,1,4,4
"5386","2017-04-12",3,11,5,16,14,"Yes",0,5,4,7
"5387","2017-04-12",6,10,8,18,18,"No",4,4,4,6
"5388","2017-04-12",5,10,18,28,28,"Yes",13,5,5,5
"5389","2017-04-12",3,10,8,18,19,"Yes",6,2,6,4
"5390","2017-04-12",2,4,0,4,4,"Yes",0,0,2,2
"5391","2017-04-12",1,2,6,8,8,"Yes",3,3,1,1
"5392","2017-04-12",9,19,8,27,0,"No",4,4,9,10
"5393","2017-04-12",4,10,6,16,16,"Yes",2,4,5,5
"5394","2017-04-12",4,12,10,22,22,"Yes",5,5,6,6
"5395","2017-04-12",1,2,0,2,2,"Yes",NA,NA,1,1
"5396","2017-04-12",1,2,6,8,8,"Yes",2,4,1,1
"5397","2017-04-12",9,12,15,27,27,"No",7,8,6,6
"5398","2017-04-12",9,18,6,24,24,"Yes",2,4,9,9
"5399","2017-04-12",1,3,4,7,7,"Yes",1,3,1,2
"5400","2017-04-12",2,4,6,10,10,"No",4,2,2,2
"5401","2017-04-12",3,4,0,4,4,"Yes",0,0,3,1
"5402","2017-04-12",1,5,2,7,7,"Yes",2,NA,1,4
"5403","2017-04-12",3,9,8,17,19,"No",3,5,5,4
"5404","2017-04-12",4,8,8,16,19,"Yes",2,6,4,4
"5405","2017-04-12",1,2,4,6,6,"Yes",3,1,1,1
"5406","2017-04-12",2,4,4,8,8,"No",2,2,2,2
"5407","2017-04-12",3,8,6,14,17,"Yes",5,1,4,4
"5408","2017-04-12",4,8,7,15,15,"No",3,4,4,4
"5409","2017-04-12",26,52,19,71,41,"Yes",8,11,26,26
"5410","2017-04-12",2,5,9,14,14,"No",4,5,3,2
"5411","2017-04-12",1,3,1,4,4,"Yes",1,0,1,2
"5412","2017-04-12",5,12,9,21,21,"Yes",3,6,6,6
"5413","2017-04-12",1,2,5,7,7,"Yes",4,1,1,1
"5414","2017-04-12",6,12,10,22,22,"Yes",4,6,6,6
"5415",NA,2,7,10,17,14,"No",5,5,4,3
"5416","2017-04-12",1,1,1,2,2,"Yes",1,0,0,1
"5417","2017-04-12",2,5,6,11,11,"Yes",3,3,1,4
"5418","2017-04-12",3,9,4,13,13,"Yes",2,2,5,4
"5419","2017-04-12",4,9,9,18,18,"Yes",4,5,5,4
"5420","2017-04-12",3,9,5,14,15,"Yes",2,3,4,5
"5421","2017-04-12",3,6,6,12,12,"Yes",2,4,3,3
"5422","2017-04-12",2,8,5,13,10,"Yes",2,3,6,2
"5423","2017-04-12",2,4,4,8,8,"No",1,3,3,1
"5424","2017-04-12",4,14,10,24,25,"Yes",4,6,7,7
"5425","2017-04-12",4,11,4,15,15,"No",2,2,5,6
"5426","2017-04-12",1,3,2,5,5,"Yes",1,1,1,2
"5427","2017-04-12",5,10,6,16,16,"No",2,4,5,5
"5428","2017-04-12",5,0,0,0,NA,"Yes",NA,NA,NA,NA
"5429","2017-04-12",2,7,6,13,13,"No",3,3,3,4
"5430","2017-04-12",2,6,4,10,10,"Yes",2,2,3,3
"5431","2017-04-12",5,11,16,27,31,"Yes",7,9,5,6
"5432","2017-04-12",11,22,9,31,35,"No",5,4,11,11
"5433","2017-04-12",3,10,7,17,17,"Yes",3,4,4,6
"5434","2017-04-12",2,6,6,12,13,"Yes",3,3,2,4
"5435","2017-04-12",1,7,4,11,11,"Yes",1,3,4,3
"5436","2017-04-12",1,2,1,3,3,"No",1,0,1,1
"5437","2017-04-12",5,10,4,14,14,"Yes",2,2,6,4
"5438","2017-04-06",13,26,13,39,36,"Yes",6,7,13,13
"5439","2017-04-12",3,6,4,10,10,"Yes",2,2,2,4
"5440","2017-04-12",3,5,4,9,11,"Yes",1,3,3,2
"5441","2017-04-12",9,22,1,23,23,"Yes",0,1,10,12
"5442","2017-04-12",4,8,8,16,26,"No",2,6,4,4
"5443","2017-04-12",3,6,4,10,16,"No",1,3,3,3
"5444","2017-04-12",4,7,9,16,16,"Yes",6,3,1,6
"5445","2017-04-12",1,7,2,9,9,"Yes",1,1,6,1
"5446","2017-04-12",8,22,12,34,38,"Yes",4,8,10,12
"5447","2017-04-12",5,10,11,21,21,"Yes",6,5,5,5
"5448","2017-04-12",2,11,9,20,20,"Yes",6,3,3,8
"5449","2017-04-12",2,6,1,7,5,"Yes",NA,1,3,3
"5450","2017-04-12",4,10,9,19,19,"Yes",6,3,3,7
"5451","2017-04-12",3,3,1,4,4,"No",0,1,2,1
"5452","2017-04-12",1,4,4,8,8,"Yes",1,3,1,3
"5453","2017-04-12",1,2,3,5,5,"Yes",1,2,1,1
"5454","2017-04-12",4,9,13,22,22,"No",6,7,5,4
"5455","2017-04-12",3,4,4,8,8,"Yes",1,3,1,3
"5456","2017-04-13",8,16,10,26,30,"Yes",4,6,8,8
"5457","2017-04-12",1,5,1,6,6,"Yes",0,1,0,5
"5458","2017-04-12",3,4,2,6,6,"No",1,1,3,1
"5459","2017-04-12",5,13,13,26,26,"Yes",5,8,7,6
"5460","2017-04-12",5,14,3,17,17,"No",1,2,9,5
"5461","2017-04-12",2,5,7,12,12,"Yes",4,3,3,2
"5462","2017-04-12",5,11,8,19,20,"Yes",3,5,5,6
"5463","2017-04-12",5,18,10,28,28,"Yes",6,4,8,10
"5464","2017-04-12",5,12,6,18,18,"Yes",2,4,7,5
"5465","2017-04-12",NA,125,0,125,NA,"No",0,0,100,25
"5466","2017-04-12",1,6,0,6,6,"Yes",0,0,3,3
"5467","2017-04-12",4,9,8,17,17,"No",5,3,5,4
"5468","2017-04-12",3,6,4,10,10,"Yes",3,1,3,3
"5469","2017-04-12",2,8,5,13,15,"Yes",3,2,3,5
"5470","2017-04-12",2,6,7,13,13,"Yes",4,3,3,3
"5471","2017-04-12",2,7,2,9,9,"Yes",2,0,5,2
"5472","2017-04-12",6,15,13,28,28,"Yes",5,8,6,9
"5473","2017-04-12",5,9,9,18,18,"Yes",2,7,5,4
"5474","2017-04-12",4,7,6,13,13,"Yes",2,4,4,3
"5475","2017-04-12",1,4,8,12,12,"Yes",6,2,1,3
"5476","2017-04-12",5,9,11,20,20,"Yes",6,5,4,5
"5477","2017-04-12",11,26,39,65,55,"No",15,24,11,15
"5478","2017-04-12",7,10,30,40,30,"No",10,20,4,6
"5479","2017-04-12",8,15,15,30,30,"No",6,9,8,7
"5480","2017-04-12",3,4,8,12,18,"Yes",3,5,2,2
"5481","2017-04-12",1,4,5,9,9,"Yes",3,2,2,2
"5482","2017-04-12",3,6,10,16,16,"No",4,6,3,3
"5483","2017-04-14",3,8,3,11,11,"No",2,1,5,3
"5484","2017-04-13",3,11,4,15,15,"Yes",2,2,5,6
"5485","2017-04-14",2,9,5,14,14,"No",3,2,6,3
"5486","2017-04-13",6,12,12,24,24,"Yes",5,7,6,6
"5487","2017-04-14",9,6,6,12,12,"No",3,3,4,2
"5488","2017-04-13",2,5,0,5,5,"Yes",0,0,3,2
"5489","2017-04-13",1,5,5,10,10,"Yes",2,3,2,3
"5490","2017-04-13",8,8,6,14,14,"No",4,2,3,5
"5491","2017-04-13",8,19,9,28,34,"No",6,3,9,10
"5492","2017-04-13",2,5,0,5,5,"Yes",0,0,1,4
"5493","2017-04-13",1,5,0,5,5,"Yes",0,0,2,3
"5494","2017-04-13",4,7,7,14,14,"Yes",2,5,3,4
"5495","2017-04-13",4,6,0,6,6,"Yes",0,0,2,4
"5496","2017-04-13",7,8,5,13,13,"No",1,4,5,3
"5497","2017-04-13",5,13,7,20,20,"Yes",5,2,5,8
"5498","2017-04-13",12,27,9,36,36,"Yes",6,3,12,15
"5499","2017-04-13",6,11,7,18,18,"No",3,4,6,5
"5500","2017-04-13",2,10,2,12,12,"Yes",1,1,4,6
"5501","2017-04-13",2,5,9,14,14,"Yes",6,3,3,2
"5502","2017-04-13",3,6,5,11,11,"No",1,4,4,2
"5503","2017-04-13",1,2,2,4,4,"Yes",1,1,1,1
"5504","2017-04-13",7,14,18,32,32,"No",7,11,7,7
"5505","2017-04-13",6,9,5,14,14,"Yes",2,3,5,4
"5506","2017-04-13",8,9,6,15,15,"Yes",5,1,6,3
"5507","2017-04-13",2,2,2,4,4,"Yes",1,1,1,1
"5508","2017-04-13",4,13,7,20,22,"Yes",2,5,5,8
"5509","2017-04-13",5,10,3,13,13,"Yes",2,1,4,6
"5510","2017-04-13",3,7,7,14,14,"No",3,4,3,4
"5511","2017-04-13",3,8,7,15,15,"Yes",4,3,5,3
"5512","2017-04-13",2,4,5,9,9,"Yes",2,3,2,2
"5513","2017-04-13",2,7,5,12,12,"Yes",2,3,4,3
"5514","2017-04-13",2,4,6,10,8,"No",1,5,2,2
"5515","2017-04-13",2,5,3,8,7,"No",3,0,3,2
"5516","2017-04-13",1,2,2,4,4,"Yes",0,2,1,1
"5517","2017-04-13",2,8,6,14,14,"Yes",3,3,6,2
"5518","2017-04-13",4,9,10,19,19,"Yes",7,3,4,5
"5519","2017-04-13",3,6,6,12,12,"No",2,4,3,3
"5520","2017-04-13",1,7,3,10,10,"Yes",0,3,4,3
"5521","2017-04-13",5,9,4,13,17,"No",1,3,4,5
"5522","2017-04-13",10,20,35,55,54,"No",14,21,11,9
"5523","2017-04-13",8,16,6,22,25,"Yes",4,2,8,8
"5524","2017-04-12",4,8,4,12,10,"No",1,3,4,4
"5525","2017-04-13",2,4,1,5,5,"No",1,0,2,2
"5526","2017-04-13",7,13,17,30,30,"Yes",6,11,7,6
"5527","2017-04-13",5,5,10,15,15,"Yes",5,5,2,3
"5528","2017-04-13",3,3,5,8,12,"Yes",2,3,2,1
"5529","2017-04-13",3,7,3,10,10,"Yes",1,2,3,4
"5530","2017-04-13",1,2,2,4,4,"Yes",0,2,1,1
"5531","2017-04-13",13,29,16,45,45,"Yes",8,8,15,14
"5532","2017-04-13",6,7,5,12,12,"No",2,3,3,4
"5533","2017-04-13",5,12,13,25,25,"Yes",7,6,6,6
"5534","2017-04-13",1,4,3,7,8,"Yes",3,0,2,2
"5535","2017-04-13",3,7,2,9,9,"Yes",1,1,4,3
"5536","2017-04-13",2,5,1,6,7,"Yes",0,1,3,2
"5537","2017-04-13",3,6,9,15,15,"Yes",5,4,3,3
"5538","2017-04-13",5,10,13,23,23,"Yes",5,8,5,5
"5539","2017-04-13",2,4,3,7,7,"Yes",0,3,1,3
"5540","2017-04-13",73,9,7,16,16,"Yes",4,3,5,4
"5541","2017-04-13",8,15,16,31,21,"Yes",7,9,7,8
"5542","2017-04-13",9,13,12,25,NA,"Yes",2,10,5,8
"5543","2017-04-13",4,8,10,18,18,"Yes",6,4,4,4
"5544","2017-04-13",4,10,8,18,18,"Yes",2,6,4,6
"5545","2017-04-13",3,7,5,12,12,"No",3,2,3,4
"5546","2017-04-13",1,3,3,6,6,"Yes",0,3,2,1
"5547","2017-04-13",4,8,7,15,15,"Yes",4,3,4,4
"5548","2017-04-13",4,9,6,15,15,"No",2,4,4,5
"5549","2017-04-13",3,5,9,14,18,"No",2,7,3,2
"5550","2017-04-13",4,12,9,21,21,"No",8,1,4,8
"5551","2017-04-13",3,8,3,11,10,"Yes",3,0,6,2
"5552","2017-04-13",4,7,8,15,15,"Yes",3,5,4,3
"5553","2017-04-13",5,10,15,25,25,"No",5,10,5,5
"5554","2017-04-13",8,16,0,16,16,"Yes",NA,NA,8,8
"5555","2017-04-13",1,3,2,5,5,"Yes",1,1,1,2
"5556","2017-04-13",8,12,9,21,21,"No",5,4,6,6
"5557","2017-04-13",5,12,4,16,20,"Yes",1,3,6,6
"5558","2017-04-13",6,15,5,20,20,"Yes",5,0,8,7
"5559","2017-04-13",3,3,2,5,6,"Yes",0,2,0,3
"5560","2017-04-13",1,2,8,10,8,"Yes",2,6,1,1
"5561","2017-04-13",2,3,4,7,8,"No",NA,4,1,2
"5562","2017-04-13",4,8,4,12,12,NA,3,1,4,4
"5563","2017-04-13",2,3,2,5,5,"Yes",0,2,1,2
"5564","2017-04-13",6,12,3,15,17,"No",1,2,6,6
"5565","2017-04-13",1,2,2,4,4,"Yes",1,1,1,1
"5566","2017-04-13",1,1,4,5,5,"Yes",2,2,0,1
"5567","2017-04-13",7,10,13,23,23,"Yes",7,6,6,4
"5568","2017-04-12",3,8,6,14,14,"Yes",4,2,4,4
"5569",NA,8,17,2,19,19,"Yes",1,1,8,9
"5570","2017-04-13",4,7,12,19,19,"Yes",5,7,4,3
"5571","2017-04-13",NA,60,0,60,NA,"No",NA,NA,54,6
"5572","2017-04-14",2,6,3,9,9,"No",2,1,3,3
"5573","2017-04-13",4,5,20,25,25,"No",5,15,2,3
"5574","2017-04-13",2,9,3,12,11,"Yes",0,3,3,6
"5575","2017-04-13",3,6,4,10,10,"Yes",4,0,3,3
"5576","2017-04-13",2,5,7,12,12,"No",3,4,3,2
"5577","2017-04-13",6,12,14,26,26,"Yes",8,6,6,6
"5578","2017-04-13",1,4,4,8,8,"Yes",2,2,2,2
"5579","2017-04-13",6,14,8,22,22,"No",5,3,6,8
"5580",NA,3,0,0,0,23,"No",NA,NA,NA,NA
"5581","2017-04-13",5,11,9,20,20,"Yes",3,6,6,5
"5582","2017-04-13",4,7,6,13,13,"Yes",5,1,4,3
"5583","2017-04-13",4,8,4,12,12,"No",3,1,4,4
"5584","2017-04-13",10,19,16,35,35,"Yes",9,7,10,9
"5585","2017-04-13",NA,75,33,108,NA,"No",15,18,35,40
"5586","2017-04-13",3,5,10,15,15,"Yes",4,6,2,3
"5587","2017-04-13",4,9,10,19,19,"No",4,6,5,4
"5588","2017-04-13",1,2,4,6,6,"Yes",1,3,1,1
"5589","2017-04-13",7,11,6,17,21,"No",2,4,7,4
"5590","2017-04-13",NA,2,5,7,NA,"No",3,2,1,1
"5591","2017-04-13",1,8,10,18,18,"Yes",4,6,4,4
"5592","2017-04-13",4,11,21,32,32,"Yes",9,12,5,6
"5593","2017-04-13",1,5,2,7,7,"Yes",0,2,3,2
"5594","2017-04-13",1,6,0,6,6,"Yes",NA,NA,2,4
"5595","2017-04-13",2,5,4,9,9,"Yes",2,2,3,2
"5596","2017-04-13",3,10,8,18,18,"No",3,5,4,6
"5597","2017-04-13",1,8,11,19,19,"Yes",5,6,3,5
"5598","2017-04-14",4,10,6,16,16,"No",4,2,5,5
"5599","2017-04-13",2,9,4,13,13,"Yes",1,3,7,2
"5600","2017-04-13",4,10,12,22,NA,"Yes",2,10,4,6
"5601","2017-04-13",1,8,4,12,12,"Yes",1,3,3,5
"5602","2017-04-13",1,2,3,5,6,"Yes",1,2,1,1
"5603","2017-04-13",4,9,9,18,18,"No",5,4,4,5
"5604","2017-04-13",6,8,8,16,16,"No",3,5,5,3
"5605","2017-04-13",1,4,4,8,8,"Yes",2,2,2,2
"5606","2017-04-13",3,6,7,13,15,"Yes",6,1,3,3
"5607","2017-04-13",5,11,6,17,20,"No",3,3,6,5
"5608","2017-04-13",1,4,7,11,11,"Yes",2,5,1,3
"5609","2017-04-13",1,6,3,9,9,"Yes",3,0,4,2
"5610","2017-04-13",6,12,16,28,28,"Yes",6,10,6,6
"5611","2017-04-13",5,8,5,13,13,"Yes",3,2,4,4
"5612","2017-04-13",1,2,8,10,10,"Yes",5,3,1,1
"5613","2017-04-13",2,2,8,10,11,"Yes",4,4,1,1
"5614","2017-04-13",2,5,2,7,7,"Yes",1,1,2,3
"5615","2017-04-13",1,3,3,6,6,"Yes",2,1,1,2
"5616","2017-04-13",6,14,8,22,21,"No",5,3,5,9
"5617","2017-04-13",6,12,6,18,16,"Yes",2,4,6,6
"5618","2017-04-13",2,8,4,12,12,"Yes",2,2,3,5
"5619","2017-04-13",2,2,21,23,23,"Yes",3,18,1,1
"5620","2017-04-13",NA,11,300,311,NA,"No",130,170,6,5
"5621","2017-04-13",4,8,8,16,16,"Yes",5,3,3,5
"5622","2017-04-13",6,12,7,19,19,NA,3,4,6,6
"5623","2017-04-13",3,6,0,6,6,"Yes",0,0,3,3
"5624","2017-04-13",2,3,5,8,9,"Yes",0,5,1,2
"5625","2017-04-13",3,6,6,12,12,"Yes",3,3,2,4
"5626","2017-04-13",1,5,2,7,7,"Yes",2,0,2,3
"5627","2017-04-13",NA,6,3,9,9,"No",2,1,3,3
"5628","2017-04-13",2,6,7,13,13,"No",4,3,3,3
"5629","2017-04-13",1,5,4,9,9,"No",2,2,2,3
"5630","2017-04-13",6,20,4,24,25,"No",3,1,10,10
"5631","2017-04-13",5,10,5,15,17,"No",2,3,5,5
"5632","2017-04-13",2,10,10,20,20,"No",5,5,4,6
"5633","2017-04-13",3,6,4,10,10,"Yes",3,1,2,4
"5634","2017-04-13",1,2,3,5,5,"No",2,1,1,1
"5635","2017-04-13",3,8,6,14,14,"No",3,3,3,5
"5636","2017-04-13",7,9,5,14,14,"Yes",2,3,5,4
"5637","2017-04-13",6,14,7,21,20,"Yes",5,2,7,7
"5638","2017-04-13",2,4,6,10,11,"Yes",2,4,2,2
"5639","2017-04-13",5,11,15,26,26,NA,5,10,6,5
"5640","2017-04-13",4,9,2,11,11,"Yes",0,2,6,3
"5641","2017-04-13",5,13,3,16,18,"Yes",2,1,7,6
"5642","2017-04-13",1,6,3,9,9,"Yes",2,1,3,3
"5643","2017-04-13",3,6,5,11,10,"Yes",1,4,3,3
"5644","2017-04-13",1,5,3,8,8,"Yes",2,1,2,3
"5645","2017-04-13",6,13,5,18,18,"Yes",2,3,7,6
"5646","2017-04-13",3,4,6,10,10,"No",3,3,2,2
"5647","2017-04-13",1,2,5,7,7,"No",4,1,1,1
"5648","2017-04-13",1,2,4,6,6,"Yes",2,2,1,1
"5649","2017-04-13",3,7,8,15,16,"No",3,5,3,4
"5650","2017-04-13",7,16,7,23,23,"No",2,5,9,7
"5651","2017-04-13",4,14,2,16,16,"Yes",1,1,6,8
"5652","2017-04-13",7,12,5,17,16,"No",3,2,5,7
"5653","2017-04-13",1,7,1,8,8,"Yes",1,0,2,5
"5654","2017-04-13",6,11,10,21,21,"Yes",6,4,5,6
"5655","2017-04-13",5,10,3,13,14,"Yes",1,2,5,5
"5656","2017-04-13",1,5,0,5,5,"No",0,0,2,3
"5657","2017-04-13",2,5,5,10,10,"No",3,2,2,3
"5658","2017-04-13",3,13,6,19,19,"Yes",2,4,6,7
"5659","2017-04-13",5,11,0,11,10,"No",0,0,6,5
"5660","2017-04-13",3,5,4,9,9,"No",4,NA,2,3
"5661","2017-04-13",1,4,1,5,5,"Yes",1,NA,3,1
"5662","2017-04-13",6,12,24,36,36,"Yes",10,14,6,6
"5663","2017-04-13",3,12,5,17,13,"No",2,3,6,6
"5664","2017-04-13",4,11,3,14,16,"Yes",2,1,6,5
"5665","2017-04-13",2,4,4,8,8,"No",3,1,2,2
"5666","2017-04-13",6,12,6,18,18,"No",2,4,6,6
"5667","2017-04-14",7,4,8,12,12,"No",5,3,2,2
"5668","2017-04-13",3,6,6,12,9,"No",4,2,3,3
"5669","2017-04-13",10,20,5,25,25,"Yes",0,5,10,10
"5670","2017-04-13",2,7,7,14,14,"Yes",4,3,5,2
"5671","2017-04-13",2,7,2,9,9,"Yes",1,1,3,4
"5672","2017-04-13",2,4,11,15,15,"Yes",6,5,2,2
"5673","2017-04-13",5,10,11,21,18,"Yes",4,7,5,5
"5674","2017-04-13",4,8,8,16,16,"Yes",3,5,4,4
"5675","2017-04-13",7,10,10,20,20,"Yes",4,6,5,5
"5676","2017-04-13",2,4,0,4,4,"Yes",0,0,2,2
"5677","2017-04-13",3,3,7,10,10,"No",3,4,2,1
"5678","2017-04-13",8,16,16,32,32,"Yes",6,10,8,8
"5679","2017-04-13",8,8,5,13,13,"Yes",2,3,4,4
"5680","2017-04-13",2,3,7,10,10,"Yes",3,4,1,2
"5681","2017-04-13",3,9,7,16,16,"Yes",3,4,5,4
"5682","2017-04-13",3,6,5,11,11,"Yes",2,3,3,3
"5683","2017-04-13",9,17,14,31,35,"Yes",6,8,8,9
"5684","2017-04-20",6,15,6,21,21,"Yes",4,2,13,2
"5685","2017-04-13",3,2,8,10,10,"Yes",4,4,1,1
"5686","2017-04-13",3,5,7,12,12,"Yes",3,4,2,3
"5687","2017-04-13",8,10,11,21,12,"No",5,6,5,5
"5688","2017-04-13",NA,17,14,31,NA,"Yes",5,9,9,8
"5689","2017-04-13",5,12,10,22,22,"Yes",4,6,5,7
"5690","2017-04-13",3,6,5,11,11,"No",3,2,3,3
"5691","2017-04-10",3,6,2,8,8,"Yes",1,1,3,3
"5692","2017-04-14",4,8,2,10,10,"No",0,2,4,4
"5693","2017-04-14",3,6,12,18,18,"No",4,8,3,3
"5694","2017-04-14",3,5,10,15,15,"Yes",6,4,3,2
"5695","2017-04-14",4,9,11,20,20,"No",5,6,5,4
"5696","2017-04-14",5,15,7,22,25,"No",3,4,5,10
"5697","2017-04-14",2,9,6,15,15,"Yes",3,3,5,4
"5698","2017-04-14",3,6,8,14,14,"No",3,5,3,3
"5699","2017-04-14",14,20,10,30,29,"Yes",7,3,12,8
"5700","2017-04-14",3,11,7,18,17,"Yes",5,2,7,4
"5701","2017-04-14",3,6,11,17,16,"No",8,3,3,3
"5702","2017-04-14",1,1,3,4,5,"No",2,1,NA,1
"5703","2017-04-14",13,0,0,0,NA,"Yes",NA,NA,NA,NA
"5704","2017-04-14",1,2,0,2,2,"Yes",0,0,0,2
"5705","2017-04-14",5,9,6,15,15,"Yes",2,4,5,4
"5706","2017-04-14",2,7,4,11,10,"Yes",1,3,3,4
"5707","2017-04-14",9,14,16,30,30,"Yes",10,6,5,9
"5708","2017-04-14",1,6,0,6,6,"Yes",0,0,3,3
"5709","2017-04-14",6,11,4,15,16,"Yes",2,2,6,5
"5710","2017-04-14",3,6,9,15,15,"Yes",5,4,3,3
"5711","2017-04-14",8,19,9,28,28,"Yes",4,5,8,11
"5712","2017-04-14",2,4,6,10,10,"Yes",2,4,1,3
"5713","2017-04-14",7,17,13,30,32,"No",8,5,9,8
"5714","2017-04-14",1,3,5,8,11,"Yes",5,NA,2,1
"5715","2017-04-14",4,7,10,17,17,"Yes",6,4,4,3
"5716","2017-04-14",7,14,5,19,24,"No",3,2,7,7
"5717","2017-04-14",2,5,2,7,11,"No",2,0,2,3
"5718","2017-04-14",3,6,7,13,13,"Yes",3,4,3,3
"5719","2017-04-14",1,5,4,9,9,"Yes",2,2,2,3
"5720","2017-04-14",3,5,7,12,12,"Yes",4,3,2,3
"5721","2017-04-14",1,2,2,4,6,"No",0,2,0,2
"5722","2017-04-14",2,6,3,9,10,"No",1,2,4,2
"5723","2017-04-14",5,8,7,15,12,"No",2,5,5,3
"5724","2017-04-14",4,9,5,14,12,"Yes",4,1,5,4
"5725","2017-04-14",3,6,8,14,15,"Yes",6,2,3,3
"5726","2017-04-14",5,8,14,22,20,"Yes",2,12,3,5
"5727","2017-04-14",3,10,3,13,13,"Yes",2,1,6,4
"5728","2017-04-14",4,7,2,9,13,"Yes",2,0,3,4
"5729","2017-04-14",3,4,4,8,8,"Yes",2,2,2,2
"5730","2017-04-14",4,8,8,16,16,"Yes",2,6,4,4
"5731","2017-04-14",3,11,4,15,13,"Yes",1,3,3,8
"5732","2017-04-14",1,2,0,2,2,"No",NA,NA,1,1
"5733","2017-04-14",3,8,4,12,12,"No",3,1,4,4
"5734","2017-04-14",3,6,7,13,14,"No",6,1,3,3
"5735","2017-04-14",5,14,11,25,27,"Yes",4,7,5,9
"5736","2017-04-14",5,4,8,12,12,"No",4,4,2,2
"5737","2017-04-14",4,16,8,24,24,"No",2,6,8,8
"5738","2017-04-14",3,9,5,14,14,"Yes",2,3,3,6
"5739","2017-04-14",3,11,3,14,14,"Yes",1,2,5,6
"5740","2017-04-14",1,3,1,4,4,"Yes",NA,1,NA,3
"5741","2017-04-14",1,3,4,7,6,"Yes",2,2,1,2
"5742","2017-04-14",7,14,14,28,35,"Yes",5,9,7,7
"5743","2017-04-14",6,12,13,25,25,"Yes",8,5,6,6
"5744","2017-04-18",3,7,3,10,8,"No",2,1,3,4
"5745","2017-04-14",2,4,3,7,7,"No",1,2,2,2
"5746","2017-04-14",4,8,6,14,14,"No",1,5,3,5
"5747","2017-04-14",5,10,6,16,16,"Yes",2,4,5,5
"5748","2017-04-14",2,5,2,7,7,"No",2,0,3,2
"5749","2017-04-14",5,14,5,19,NA,"Yes",2,3,9,5
"5750","2017-04-14",12,15,25,40,40,"Yes",10,15,5,10
"5751","2017-04-14",8,19,7,26,26,"No",3,4,11,8
"5752","2017-04-21",1,2,5,7,8,"No",2,3,1,1
"5753","2017-04-14",5,14,13,27,27,"Yes",6,7,7,7
"5754","2017-04-14",5,7,4,11,11,"Yes",0,4,5,2
"5755","2017-04-14",15,29,16,45,45,"No",9,7,14,15
"5756","2017-04-14",2,4,4,8,8,"No",1,3,2,2
"5757","2017-04-14",5,14,10,24,24,"Yes",4,6,5,9
"5758","2017-04-14",NA,175,165,340,NA,"Yes",60,105,80,95
"5759","2017-04-14",6,13,8,21,24,"Yes",3,5,7,6
"5760","2017-04-14",3,7,6,13,13,"Yes",2,4,4,3
"5761","2017-04-14",11,25,59,84,94,"Yes",18,41,12,13
"5762","2017-04-14",10,16,10,26,NA,"Yes",7,3,10,6
"5763","2017-04-14",NA,180,80,260,NA,"No",50,30,80,100
"5764","2017-04-14",5,20,10,30,30,"Yes",4,6,10,10
"5765","2017-04-14",7,12,14,26,26,"No",6,8,6,6
"5766","2017-04-14",4,13,12,25,25,"Yes",5,7,6,7
"5767","2017-04-14",2,6,10,16,16,"Yes",3,7,4,2
"5768","2017-04-14",3,8,9,17,17,"Yes",4,5,3,5
"5769","2017-04-14",1,2,7,9,9,"Yes",4,3,1,1
"5770","2017-04-14",5,15,9,24,24,"Yes",4,5,6,9
"5771","2017-04-14",4,11,7,18,17,"Yes",4,3,7,4
"5772","2017-04-14",3,5,8,13,13,"Yes",5,3,2,3
"5773","2017-04-14",3,8,6,14,14,"Yes",4,2,4,4
"5774","2017-04-14",5,11,9,20,20,"Yes",3,6,2,9
"5775","2017-04-14",3,10,12,22,24,"No",6,6,5,5
"5776","2017-04-14",2,4,7,11,7,"Yes",4,3,2,2
"5777","2017-04-14",6,21,9,30,30,"Yes",5,4,16,5
"5778","2017-04-14",2,4,0,4,4,"Yes",NA,NA,2,2
"5779","2017-04-14",3,12,8,20,19,"Yes",5,3,2,10
"5780","2017-04-14",6,10,5,15,15,"No",2,3,4,6
"5781","2017-04-14",2,4,12,16,16,"Yes",8,4,2,2
"5782","2017-04-14",3,6,2,8,8,"No",1,1,3,3
"5783","2017-04-14",4,10,9,19,19,"Yes",2,7,5,5
"5784","2017-04-14",NA,3,1,4,4,"Yes",0,1,1,2
"5785","2017-04-15",4,8,4,12,12,"No",3,1,4,4
"5786","2017-04-14",4,5,8,13,15,"Yes",5,3,2,3
"5787","2017-04-14",9,18,12,30,30,"Yes",2,10,9,9
"5788","2017-04-14",1,5,4,9,9,"Yes",2,2,2,3
"5789","2017-04-14",2,4,9,13,13,"Yes",5,4,1,3
"5790","2017-04-14",3,10,3,13,9,"Yes",1,2,4,6
"5791","2017-04-14",4,10,9,19,19,"Yes",4,5,6,4
"5792","2017-04-14",3,7,2,9,9,"No",1,1,3,4
"5793","2017-04-14",5,9,6,15,15,"Yes",4,2,3,6
"5794","2017-04-14",3,8,2,10,10,"Yes",0,2,5,3
"5795","2017-04-14",6,14,24,38,38,"No",14,10,6,8
"5796","2017-04-14",1,3,5,8,8,"Yes",3,2,2,1
"5797","2017-04-14",1,3,4,7,5,"Yes",3,1,1,2
"5798","2017-04-14",4,8,3,11,12,"Yes",1,2,4,4
"5799","2017-04-14",1,2,0,2,2,"Yes",NA,NA,1,1
"5800","2017-04-15",6,9,5,14,14,"No",2,3,5,4
"5801","2017-04-14",3,10,5,15,15,"Yes",2,3,5,5
"5802","2017-04-14",1,4,1,5,5,"Yes",1,NA,3,1
"5803","2017-04-14",1,2,2,4,4,"Yes",0,2,1,1
"5804","2017-04-14",3,5,3,8,14,"Yes",1,2,2,3
"5805","2017-04-14",6,13,8,21,21,"No",3,5,6,7
"5806","2017-04-14",4,9,4,13,13,"Yes",1,3,4,5
"5807","2017-04-14",1,5,4,9,9,"Yes",2,2,5,0
"5808","2017-04-14",4,10,13,23,23,"Yes",6,7,4,6
"5809","2017-04-14",11,25,11,36,NA,"Yes",5,6,15,10
"5810","2017-04-14",3,6,11,17,19,"Yes",4,7,3,3
"5811","2017-04-14",1,2,5,7,7,"Yes",2,3,1,1
"5812","2017-04-14",1,2,2,4,4,"Yes",2,0,1,1
"5813","2017-04-14",5,9,8,17,25,"Yes",3,5,4,5
"5814","2017-04-14",9,0,0,0,NA,"No",NA,NA,NA,NA
"5815","2017-04-14",4,7,4,11,13,"No",0,4,3,4
"5816","2017-04-14",1,3,3,6,6,"Yes",2,1,0,3
"5817","2017-04-14",3,4,7,11,11,"Yes",5,2,2,2
"5818","2017-04-14",3,12,4,16,16,"Yes",2,2,6,6
"5819","2017-04-14",5,9,4,13,12,"No",1,3,5,4
"5820","2017-04-14",7,14,3,17,18,"No",1,2,10,4
"5821","2017-04-14",4,10,5,15,15,"No",3,2,5,5
"5822","2017-04-14",4,6,7,13,10,"Yes",3,4,4,2
"5823","2017-04-14",6,8,6,14,14,"No",4,2,3,5
"5824","2017-04-14",1,3,2,5,5,"Yes",1,1,2,1
"5825","2017-04-14",8,11,8,19,19,"No",3,5,4,7
"5826","2017-04-14",2,8,2,10,7,"Yes",1,1,3,5
"5827","2017-04-14",5,14,10,24,25,"Yes",4,6,5,9
"5828","2017-04-14",8,12,9,21,21,"No",3,6,6,6
"5829","2017-04-14",1,5,5,10,10,"Yes",1,4,3,2
"5830","2017-04-14",7,11,3,14,NA,"No",2,1,5,6
"5831","2017-04-14",2,7,5,12,10,"Yes",3,2,3,4
"5832","2017-04-14",3,3,0,3,3,"Yes",NA,NA,2,1
"5833","2017-04-14",4,9,11,20,20,"Yes",5,6,4,5
"5834",NA,5,12,8,20,17,"Yes",5,3,7,5
"5835","2017-04-14",6,10,6,16,16,"No",4,2,4,6
"5836","2017-04-14",1,3,3,6,6,NA,1,2,1,2
"5837","2017-04-14",1,2,6,8,8,"Yes",2,4,1,1
"5838","2017-04-14",9,14,11,25,25,"Yes",5,6,8,6
"5839","2017-04-14",9,13,9,22,22,"Yes",4,5,9,4
"5840","2017-04-14",7,14,6,20,20,"Yes",4,2,7,7
"5841","2017-04-14",1,4,6,10,8,"Yes",3,3,1,3
"5842","2017-04-15",6,9,9,18,18,"Yes",3,6,4,5
"5843","2017-04-14",2,4,7,11,11,"Yes",3,4,2,2
"5844","2017-04-14",1,5,2,7,7,"Yes",2,0,4,1
"5845","2017-04-14",1,2,4,6,6,"No",2,2,1,1
"5846","2017-04-14",4,8,13,21,21,"Yes",6,7,4,4
"5847","2017-04-14",7,16,9,25,24,"Yes",4,5,8,8
"5848","2017-04-14",1,7,3,10,6,"Yes",0,3,3,4
"5849","2017-04-14",NA,4,3,7,6,"No",1,2,2,2
"5850","2017-04-14",1,5,0,5,5,"Yes",NA,NA,2,3
"5851","2017-04-14",3,8,6,14,14,"No",4,2,5,3
"5852","2017-04-14",1,5,4,9,6,"Yes",3,1,3,2
"5853","2017-04-15",1,3,5,8,8,"No",2,3,2,1
"5854","2017-04-14",1,2,4,6,6,"Yes",2,2,1,1
"5855","2017-04-14",4,4,8,12,12,"Yes",3,5,2,2
"5856","2017-04-14",2,5,3,8,8,"Yes",2,1,2,3
"5857","2017-04-14",10,21,9,30,30,"Yes",4,5,10,11
"5858","2017-04-14",1,2,2,4,4,"Yes",1,1,1,1
"5859","2017-04-14",6,9,16,25,25,"No",4,12,6,3
"5860","2017-04-14",4,8,10,18,18,"Yes",4,6,4,4
"5861","2017-04-14",6,11,6,17,17,"Yes",3,3,6,5
"5862","2017-04-14",4,8,10,18,16,"No",2,8,4,4
"5863","2017-04-14",7,12,10,22,28,"No",6,4,7,5
"5864","2017-04-14",1,4,5,9,9,"No",2,3,2,2
"5865","2017-04-14",11,26,12,38,38,"Yes",4,8,11,15
"5866","2017-04-14",5,8,4,12,12,"Yes",1,3,4,4
"5867","2017-04-14",3,7,5,12,NA,"No",3,2,5,2
"5868","2017-04-14",1,2,1,3,3,"No",0,1,1,1
"5869","2017-04-14",10,20,20,40,40,"Yes",8,12,10,10
"5870","2017-04-14",4,8,3,11,12,"No",1,2,4,4
"5871","2017-04-14",3,8,11,19,14,"Yes",6,5,4,4
"5872","2017-04-14",2,4,6,10,10,"No",5,1,2,2
"5873","2017-04-14",4,12,5,17,12,"Yes",3,2,4,8
"5874","2017-04-14",2,4,4,8,10,"Yes",2,2,2,2
"5875","2017-04-14",4,12,2,14,14,"Yes",0,2,7,5
"5876","2017-04-14",7,11,8,19,16,"Yes",5,3,5,6
"5877","2017-04-14",6,11,5,16,16,"Yes",5,0,6,5
"5878","2017-04-14",2,6,5,11,11,"Yes",2,3,2,4
"5879","2017-04-07",5,12,9,21,21,"No",5,4,9,3
"5880","2017-04-14",3,10,9,19,19,"Yes",4,5,4,6
"5881","2017-04-13",4,4,1,5,5,"Yes",1,0,2,2
"5882","2017-04-13",3,5,7,12,10,"No",2,5,2,3
"5883","2017-04-14",4,11,13,24,24,"Yes",7,6,5,6
"5884","2017-04-14",4,5,7,12,12,"Yes",6,1,3,2
"5885","2017-04-14",3,5,6,11,11,"Yes",3,3,2,3
"5886","2017-04-17",8,16,10,26,NA,"Yes",5,5,8,8
"5887","2017-04-17",3,8,4,12,16,"Yes",0,4,2,6
"5888","2017-04-17",7,20,15,35,35,"No",8,7,10,10
"5889","2017-04-17",1,2,5,7,7,"Yes",3,2,1,1
"5890","2017-04-17",6,17,4,21,NA,"Yes",0,4,9,8
"5891","2017-04-17",5,30,32,62,20,"Yes",13,19,12,18
"5892","2017-04-17",1,5,2,7,7,"Yes",NA,2,3,2
"5893","2017-04-17",2,4,4,8,8,"Yes",2,2,2,2
"5894","2017-04-17",5,17,6,23,20,"Yes",3,3,11,6
"5895","2017-04-17",3,6,3,9,9,"Yes",1,2,2,4
"5896","2017-04-17",1,3,4,7,7,"No",2,2,1,2
"5897","2017-04-17",1,2,5,7,7,"No",2,3,1,1
"5898","2017-04-17",2,7,5,12,12,"Yes",2,3,4,3
"5899","2017-04-17",1,2,6,8,8,"Yes",3,3,1,1
"5900","2017-04-17",1,3,3,6,6,"Yes",2,1,1,2
"5901","2017-04-17",4,8,2,10,10,"No",0,2,4,4
"5902","2017-04-17",4,10,4,14,14,"Yes",1,3,4,6
"5903","2017-04-17",4,9,7,16,16,"Yes",3,4,4,5
"5904","2017-04-17",2,5,0,5,5,"Yes",0,0,3,2
"5905","2017-04-17",1,6,2,8,8,"Yes",1,1,2,4
"5906","2017-04-17",6,12,9,21,19,"No",4,5,6,6
"5907","2017-04-17",1,2,4,6,6,"Yes",2,2,1,1
"5908","2017-04-17",1,5,1,6,6,"Yes",1,0,2,3
"5909","2017-04-17",6,8,6,14,14,"Yes",5,1,3,5
"5910","2017-04-17",6,9,9,18,NA,"Yes",6,3,6,3
"5911","2017-04-17",2,6,4,10,10,"No",2,2,4,2
"5912","2017-04-17",4,11,7,18,NA,"Yes",4,3,5,6
"5913","2017-04-17",3,7,2,9,11,"Yes",1,1,3,4
"5914","2017-04-17",3,6,4,10,10,"No",1,3,4,2
"5915","2017-04-17",3,7,4,11,11,"Yes",2,2,3,4
"5916","2017-04-17",11,27,5,32,32,"Yes",2,3,12,15
"5917","2017-04-17",3,4,2,6,6,"No",1,1,2,2
"5918","2017-04-17",9,14,2,16,18,"No",2,0,9,5
"5919","2017-04-17",1,4,5,9,9,"Yes",1,4,2,2
"5920","2017-04-17",4,7,8,15,15,"Yes",4,4,4,3
"5921","2017-04-17",6,9,9,18,18,"No",5,4,4,5
"5922","2017-04-17",4,11,3,14,16,"Yes",2,1,5,6
"5923","2017-04-17",2,4,3,7,7,"Yes",2,1,2,2
"5924","2017-04-17",7,14,3,17,NA,"Yes",2,1,7,7
"5925","2017-04-17",4,5,4,9,9,"No",1,3,0,5
"5926","2017-04-17",NA,330,170,500,NA,"No",90,80,150,180
"5927","2017-04-17",NA,10,0,10,NA,"No",0,0,10,0
"5928","2017-04-17",1,2,2,4,4,"Yes",1,1,1,1
"5929","2017-04-10",4,7,6,13,13,"Yes",1,5,3,4
"5930","2017-04-17",1,3,1,4,4,"Yes",NA,1,1,2
"5931","2017-04-17",4,11,3,14,16,"Yes",2,1,5,6
"5932","2017-04-17",6,14,11,25,25,"Yes",5,6,8,6
"5933","2017-04-17",4,16,8,24,24,"No",4,4,8,8
"5934","2017-04-17",1,1,4,5,4,"No",1,3,0,1
"5935","2017-04-17",5,15,3,18,18,"Yes",1,2,6,9
"5936","2017-04-17",6,13,4,17,19,"No",NA,4,6,7
"5937","2017-04-17",3,6,0,6,10,"Yes",0,0,3,3
"5938","2017-04-17",4,8,10,18,18,"Yes",4,6,4,4
"5939","2017-04-17",6,13,7,20,27,"Yes",3,4,6,7
"5940","2017-04-17",1,5,3,8,8,"No",1,2,2,3
"5941","2017-04-17",4,10,3,13,13,"Yes",1,2,8,2
"5942","2017-04-17",2,4,4,8,8,"Yes",3,1,2,2
"5943","2017-04-17",1,2,2,4,4,"Yes",2,0,1,1
"5944","2017-04-17",2,7,5,12,12,"Yes",3,2,4,3
"5945","2017-04-17",3,6,3,9,12,"Yes",1,2,1,5
"5946","2017-04-17",4,11,4,15,15,"Yes",2,2,5,6
"5947","2017-04-17",6,10,7,17,17,"Yes",3,4,6,4
"5948","2017-04-17",2,4,8,12,17,"No",3,5,2,2
"5949","2017-04-17",6,12,4,16,15,"Yes",3,1,7,5
"5950","2017-04-17",2,8,3,11,10,"Yes",2,1,4,4
"5951","2017-04-17",2,4,3,7,7,"Yes",2,1,2,2
"5952","2017-04-17",3,10,0,10,10,"Yes",0,0,5,5
"5953","2017-04-17",2,4,2,6,6,"No",2,0,2,2
"5954","2017-04-17",8,11,7,18,NA,"Yes",3,4,4,7
"5955","2017-04-17",4,8,10,18,24,"Yes",6,4,4,4
"5956","2017-04-17",1,4,3,7,7,"Yes",NA,3,2,2
"5957","2017-04-17",2,3,5,8,10,"Yes",4,1,1,2
"5958","2017-04-17",3,17,8,25,25,NA,3,5,8,9
"5959","2017-04-17",4,4,10,14,14,"Yes",8,2,2,2
"5960","2017-04-17",3,5,10,15,12,"No",7,3,2,3
"5961","2017-04-17",1,0,3,3,7,"Yes",2,1,NA,NA
"5962","2017-04-17",4,9,6,15,15,"Yes",2,4,6,3
"5963","2017-04-17",1,4,4,8,9,"Yes",1,3,2,2
"5964","2017-04-17",4,9,6,15,12,"Yes",2,4,4,5
"5965","2017-04-17",4,10,6,16,16,"No",3,3,4,6
"5966","2017-04-17",1,4,5,9,9,"Yes",3,2,3,1
"5967","2017-04-17",3,7,7,14,17,"Yes",1,6,4,3
"5968","2017-04-17",2,5,2,7,7,"Yes",1,1,2,3
"5969","2017-04-17",4,11,6,17,18,"Yes",2,4,7,4
"5970","2017-04-17",1,4,3,7,7,"Yes",1,2,2,2
"5971","2017-04-17",5,9,9,18,18,"Yes",6,3,6,3
"5972","2017-04-17",4,8,2,10,10,"Yes",1,1,4,4
"5973","2017-04-17",1,2,4,6,6,"No",1,3,1,1
"5974","2017-04-17",7,16,11,27,NA,"Yes",4,7,9,7
"5975","2017-04-17",6,17,7,24,24,"Yes",3,4,8,9
"5976","2017-04-17",7,19,10,29,30,"Yes",4,6,7,12
"5977","2017-04-17",1,4,4,8,8,"No",1,3,2,2
"5978","2017-04-17",1,5,1,6,8,"Yes",0,1,2,3
"5979","2017-04-17",3,4,3,7,9,"Yes",1,2,2,2
"5980","2017-04-17",5,11,1,12,12,"Yes",NA,1,5,6
"5981","2017-04-17",1,5,4,9,9,"Yes",3,1,2,3
"5982","2017-04-17",10,25,11,36,36,"Yes",6,5,10,15
"5983","2017-04-17",2,6,3,9,9,"Yes",1,2,2,4
"5984","2017-04-17",5,10,5,15,15,"Yes",2,3,6,4
"5985","2017-04-17",4,7,8,15,15,"No",3,5,4,3
"5986","2017-04-17",11,26,9,35,NA,"No",1,8,15,11
"5987","2017-04-17",2,6,3,9,10,"Yes",1,2,3,3
"5988","2017-04-17",2,6,2,8,9,"Yes",NA,2,3,3
"5989","2017-04-17",3,15,3,18,19,"Yes",2,1,3,12
"5990","2017-04-17",3,7,3,10,10,"Yes",1,2,4,3
"5991","2017-04-17",NA,258,28,286,NA,"Yes",20,8,108,150
"5992","2017-04-17",3,5,8,13,13,"Yes",2,6,2,3
"5993","2017-04-17",6,15,8,23,NA,"Yes",4,4,7,8
"5994","2017-04-17",5,13,3,16,16,"Yes",1,2,5,8
"5995","2017-04-17",3,6,3,9,9,"No",1,2,3,3
"5996","2017-04-17",3,6,3,9,9,"Yes",1,2,3,3
"5997","2017-04-17",2,6,4,10,10,"Yes",1,3,2,4
"5998","2017-04-17",3,6,4,10,15,"Yes",3,1,4,2
"5999","2017-04-17",4,12,4,16,17,"No",1,3,4,8
"6000","2017-04-17",1,3,4,7,7,"Yes",2,2,1,2
"6001","2017-04-17",5,10,11,21,21,"Yes",6,5,5,5
"6002","2017-04-17",3,9,6,15,15,"Yes",4,2,4,5
"6003","2017-04-17",NA,40,167,207,NA,"No",82,85,15,25
"6004","2017-04-17",1,4,6,10,10,"Yes",2,4,2,2
"6005","2017-04-17",3,11,4,15,16,"Yes",1,3,4,7
"6006","2017-04-17",1,2,2,4,4,"No",2,0,1,1
"6007","2017-04-17",1,5,2,7,7,"Yes",1,1,3,2
"6008","2017-04-17",2,5,1,6,8,"Yes",1,NA,3,2
"6009","2017-04-17",2,7,7,14,14,"No",6,1,4,3
"6010","2017-04-17",7,12,1,13,NA,"No",1,0,6,6
"6011","2017-04-17",7,13,10,23,23,"Yes",7,3,8,5
"6012","2017-04-17",2,6,0,6,6,"No",0,0,3,3
"6013","2017-04-17",3,8,4,12,13,"Yes",2,2,5,3
"6014","2017-04-17",11,24,3,27,27,"Yes",2,1,11,13
"6015","2017-04-17",5,14,9,23,22,"Yes",5,4,6,8
"6016","2017-04-17",1,2,4,6,6,"Yes",1,3,1,1
"6017","2017-04-17",1,2,2,4,5,"No",0,2,1,1
"6018","2017-04-17",1,3,2,5,6,"Yes",1,1,2,1
"6019","2017-04-17",1,7,5,12,15,"Yes",3,2,3,4
"6020","2017-04-17",3,10,7,17,17,"No",3,4,5,5
"6021","2017-04-17",1,5,4,9,8,"Yes",1,3,2,3
"6022","2017-04-17",6,15,10,25,NA,"Yes",5,5,9,6
"6023","2017-04-17",1,4,1,5,5,"Yes",0,1,2,2
"6024","2017-04-17",17,30,8,38,38,"Yes",5,3,17,13
"6025","2017-04-17",4,7,2,9,12,"Yes",2,0,4,3
"6026","2017-04-17",2,3,4,7,8,"Yes",1,3,2,1
"6027","2017-04-17",2,4,6,10,10,"No",2,4,2,2
"6028","2017-04-17",5,10,7,17,NA,"Yes",3,4,4,6
"6029","2017-04-17",2,5,2,7,7,"Yes",1,1,3,2
"6030","2017-04-17",3,5,3,8,10,"Yes",2,1,3,2
"6031","2017-04-17",2,4,8,12,12,"No",5,3,2,2
"6032","2017-04-18",7,14,28,42,42,"No",6,22,7,7
"6033","2017-04-18",NA,22,400,422,NA,"Yes",150,250,11,11
"6034","2017-04-18",3,7,7,14,14,"No",1,6,3,4
"6035","2017-04-18",5,10,19,29,29,"No",10,9,5,5
"6036","2017-04-18",5,8,12,20,20,"Yes",5,7,3,5
"6037","2017-04-18",1,2,7,9,9,"No",3,4,1,1
"6038","2017-04-18",3,6,6,12,14,"Yes",1,5,3,3
"6039","2017-04-18",3,10,7,17,17,"No",4,3,4,6
"6040","2017-04-18",1,2,3,5,5,"Yes",2,1,1,1
"6041","2017-04-18",7,15,36,51,53,"Yes",15,21,7,8
"6042","2017-04-18",1,7,1,8,8,"Yes",1,0,3,4
"6043","2017-04-18",2,8,10,18,14,"No",2,8,4,4
"6044","2017-04-18",3,8,10,18,19,"Yes",6,4,3,5
"6045","2017-04-18",6,12,1,13,NA,"Yes",1,0,8,4
"6046","2017-04-18",5,15,23,38,38,"Yes",14,9,7,8
"6047","2017-04-18",1,2,1,3,3,"No",1,0,1,1
"6048","2017-04-18",5,10,6,16,16,"No",2,4,5,5
"6049","2017-04-18",2,4,8,12,12,"Yes",3,5,2,2
"6050","2017-04-18",4,6,9,15,15,"No",5,4,4,2
"6051","2017-04-18",2,5,1,6,6,"Yes",1,0,2,3
"6052","2017-04-18",3,11,9,20,18,"Yes",6,3,7,4
"6053","2017-04-18",13,30,76,106,106,"Yes",30,46,13,17
"6054","2017-04-18",2,6,2,8,8,"Yes",1,1,0,6
"6055","2017-04-18",4,8,1,9,9,"No",0,1,4,4
"6056","2017-04-18",6,11,8,19,19,"Yes",6,2,6,5
"6057","2017-04-18",4,9,4,13,14,"Yes",2,2,4,5
"6058","2017-04-18",3,8,4,12,12,"Yes",1,3,4,4
"6059","2017-04-18",1,2,3,5,5,"Yes",1,2,1,1
"6060","2017-04-18",1,2,5,7,7,"Yes",4,1,1,1
"6061","2017-04-18",1,4,4,8,8,"Yes",1,3,2,2
"6062","2017-04-18",4,8,9,17,17,"No",3,6,4,4
"6063","2017-04-18",3,5,4,9,9,"Yes",1,3,3,2
"6064","2017-04-18",5,11,8,19,19,"No",3,5,5,6
"6065","2017-04-18",1,3,2,5,5,"Yes",1,1,2,1
"6066","2017-04-12",1,5,1,6,6,"No",1,NA,2,3
"6067","2017-04-18",1,3,3,6,6,"Yes",0,3,1,2
"6068","2017-04-18",3,8,11,19,14,"Yes",6,5,4,4
"6069","2017-04-18",1,2,3,5,5,"Yes",1,2,1,1
"6070","2017-04-18",7,12,10,22,22,"Yes",6,4,7,5
"6071","2017-04-18",3,6,3,9,5,"Yes",1,2,4,2
"6072","2017-04-18",1,2,1,3,3,"Yes",1,0,1,1
"6073","2017-04-18",9,11,19,30,30,"No",10,9,5,6
"6074","2017-04-18",8,17,5,22,22,"No",3,2,8,9
"6075","2017-04-18",4,8,8,16,16,"No",3,5,4,4
"6076","2017-04-18",2,6,4,10,10,"Yes",4,0,3,3
"6077","2017-04-18",7,15,12,27,26,"Yes",3,9,7,8
"6078","2017-04-18",7,12,9,21,21,"Yes",3,6,7,5
"6079","2017-04-18",6,14,3,17,17,"Yes",1,2,6,8
"6080","2017-04-18",3,6,8,14,13,"Yes",5,3,3,3
"6081","2017-04-18",5,13,12,25,25,"Yes",8,4,5,8
"6082","2017-04-18",2,7,1,8,8,"No",1,0,3,4
"6083","2017-04-18",5,10,10,20,20,"Yes",6,4,5,5
"6084","2017-04-18",1,4,3,7,6,"No",2,1,3,1
"6085","2017-04-18",1,3,5,8,8,"Yes",2,3,1,2
"6086","2017-04-18",2,4,5,9,9,"Yes",0,5,2,2
"6087","2017-04-18",1,7,3,10,12,"Yes",2,1,4,3
"6088","2017-04-18",5,12,12,24,23,"No",5,7,6,6
"6089","2017-04-18",4,10,14,24,24,"Yes",5,9,5,5
"6090","2017-04-18",1,5,5,10,10,"Yes",0,5,1,4
"6091","2017-04-18",2,12,6,18,18,"No",2,4,6,6
"6092","2017-04-18",4,10,9,19,19,"No",3,6,5,5
"6093","2017-04-18",9,30,10,40,30,"No",4,6,14,16
"6094","2017-04-18",1,6,7,13,13,"Yes",1,6,2,4
"6095","2017-04-18",2,5,2,7,7,"Yes",0,2,2,3
"6096","2017-04-18",1,2,3,5,5,"Yes",1,2,1,1
"6097","2017-04-18",2,5,2,7,7,"Yes",0,2,2,3
"6098","2017-04-18",3,7,5,12,13,"No",3,2,4,3
"6099","2017-04-18",1,4,1,5,7,"Yes",0,1,2,2
"6100","2017-04-18",1,5,0,5,5,"No",NA,NA,2,3
"6101","2017-04-18",4,7,5,12,18,"Yes",4,1,4,3
"6102","2017-04-18",4,11,2,13,13,"Yes",1,1,5,6
"6103","2017-04-18",1,7,4,11,11,"Yes",3,1,3,4
"6104","2017-04-18",1,2,3,5,5,"Yes",1,2,1,1
"6105","2017-04-18",2,4,4,8,8,"Yes",1,3,2,2
"6106","2017-04-18",5,10,11,21,23,"Yes",4,7,5,5
"6107","2017-04-18",1,4,2,6,6,"Yes",1,1,3,1
"6108","2017-04-18",7,10,14,24,25,"Yes",9,5,7,3
"6109","2017-04-18",3,4,3,7,10,"No",1,2,2,2
"6110","2017-04-18",5,0,0,0,NA,"Yes",NA,NA,NA,NA
"6111","2017-04-18",1,2,5,7,7,"Yes",2,3,1,1
"6112","2017-04-18",1,3,2,5,5,"No",2,0,1,2
"6113","2017-04-18",3,6,4,10,12,"Yes",2,2,3,3
"6114","2017-04-18",8,15,35,50,40,"No",20,15,10,5
"6115","2017-04-18",4,10,6,16,16,"Yes",4,2,4,6
"6116","2017-04-18",2,3,7,10,11,"Yes",3,4,1,2
"6117","2017-04-18",4,8,12,20,20,"Yes",5,7,4,4
"6118","2017-04-18",6,14,10,24,26,"No",5,5,6,8
"6119","2017-04-18",7,0,0,0,NA,"No",NA,NA,NA,NA
"6120","2017-04-18",7,22,12,34,34,"Yes",5,7,10,12
"6121","2017-04-18",1,2,2,4,4,"Yes",1,1,1,1
"6122","2017-04-18",6,13,9,22,24,"No",0,9,6,7
"6123","2017-04-18",5,16,12,28,NA,"Yes",7,5,7,9
"6124","2017-04-18",2,3,4,7,7,"No",2,2,1,2
"6125","2017-04-18",3,4,13,17,17,"No",5,8,1,3
"6126","2017-04-18",1,4,2,6,6,"Yes",NA,2,2,2
"6127","2017-04-18",3,8,2,10,12,"Yes",1,1,5,3
"6128","2017-04-18",8,13,17,30,30,"Yes",8,9,7,6
"6129","2017-04-18",2,5,6,11,11,"Yes",5,1,2,3
"6130","2017-04-18",8,21,21,42,42,"No",4,17,8,13
"6131","2017-04-18",4,6,1,7,11,"No",0,1,3,3
"6132","2017-04-18",1,3,4,7,7,"Yes",3,1,1,2
"6133","2017-04-18",4,8,8,16,14,"Yes",2,6,4,4
"6134","2017-04-18",3,4,8,12,12,"Yes",4,4,2,2
"6135","2017-04-18",4,8,3,11,12,"No",1,2,4,4
"6136","2017-04-18",NA,15,121,136,NA,"Yes",50,71,6,9
"6137","2017-04-18",5,10,10,20,20,"No",6,4,5,5
"6138","2017-04-18",8,15,25,40,45,"Yes",10,15,5,10
"6139","2017-04-18",1,3,6,9,9,"Yes",4,2,1,2
"6140","2017-04-18",5,9,9,18,19,"Yes",4,5,5,4
"6141","2017-04-18",7,13,5,18,19,"Yes",2,3,7,6
"6142","2017-04-18",9,18,22,40,45,"Yes",12,10,9,9
"6143","2017-04-18",2,4,6,10,10,"Yes",3,3,2,2
"6144","2017-04-18",3,9,4,13,13,"Yes",4,0,3,6
"6145","2017-04-18",5,12,10,22,22,"Yes",6,4,6,6
"6146","2017-04-18",6,13,11,24,25,"Yes",2,9,6,7
"6147","2017-04-18",2,5,5,10,10,"Yes",1,4,2,3
"6148","2017-04-18",1,2,3,5,5,"Yes",3,0,1,1
"6149","2017-04-18",3,5,3,8,8,"Yes",2,1,1,4
"6150","2017-04-18",4,15,10,25,25,"Yes",5,5,5,10
"6151","2017-04-18",1,4,2,6,6,"No",1,1,3,1
"6152","2017-04-18",5,10,5,15,19,"Yes",2,3,4,6
"6153","2017-04-18",7,0,0,0,NA,"No",NA,NA,NA,NA
"6154","2017-04-18",5,8,11,19,14,"No",7,4,4,4
"6155","2017-04-18",3,10,6,16,17,"Yes",3,3,5,5
"6156","2017-04-18",2,4,10,14,16,"No",2,8,2,2
"6157","2017-04-18",6,16,4,20,20,"Yes",3,1,6,10
"6158","2017-04-18",3,6,11,17,16,"Yes",6,5,3,3
"6159","2017-04-18",1,4,4,8,8,"Yes",3,1,2,2
"6160","2017-04-18",11,24,14,38,38,"Yes",5,9,11,13
"6161","2017-04-18",3,5,2,7,7,"Yes",2,0,4,1
"6162","2017-04-18",3,4,4,8,7,"Yes",2,2,1,3
"6163","2017-04-18",2,10,3,13,8,"Yes",2,1,5,5
"6164","2017-04-18",1,2,3,5,5,"Yes",1,2,1,1
"6165","2017-04-18",4,7,6,13,16,"No",1,5,1,6
"6166","2017-04-18",3,7,4,11,14,"No",2,2,3,4
"6167","2017-04-18",NA,19,540,559,NA,"Yes",250,290,8,11
"6168","2017-04-18",5,10,11,21,21,"Yes",4,7,5,5
"6169","2017-04-18",8,9,41,50,50,"Yes",20,21,5,4
"6170","2017-04-18",2,4,5,9,9,"No",2,3,2,2
"6171","2017-04-18",4,9,14,23,26,"No",4,10,5,4
"6172","2017-04-18",5,12,2,14,14,"Yes",1,1,5,7
"6173","2017-04-18",5,10,9,19,18,"No",5,4,5,5
"6174","2017-04-18",2,6,5,11,9,"Yes",3,2,3,3
"6175","2017-04-18",5,10,15,25,25,"Yes",8,7,5,5
"6176","2017-04-18",5,16,5,21,23,"Yes",2,3,7,9
"6177","2017-04-18",2,4,10,14,14,"Yes",5,5,2,2
"6178","2017-04-18",3,5,6,11,16,"No",4,2,3,2
"6179","2017-04-18",3,5,10,15,15,"No",5,5,2,3
"6180","2017-04-18",2,5,0,5,5,"Yes",0,0,3,2
"6181",NA,6,12,8,20,18,"No",6,2,6,6
"6182","2017-04-18",1,2,4,6,6,"No",1,3,1,1
"6183","2017-04-18",3,7,7,14,15,"Yes",2,5,3,4
"6184","2017-04-18",4,8,4,12,12,"Yes",2,2,4,4
"6185","2017-04-18",4,7,7,14,14,"Yes",5,2,3,4
"6186","2017-04-18",1,2,6,8,8,"Yes",2,4,1,1
"6187","2017-04-18",7,18,10,28,28,"No",4,6,10,8
"6188","2017-04-18",1,2,3,5,5,"No",2,1,1,1
"6189","2017-04-18",2,2,4,6,6,"Yes",4,NA,1,1
"6190","2017-04-18",4,8,12,20,20,"Yes",6,6,4,4
"6191","2017-04-18",6,14,8,22,22,"No",4,4,7,7
"6192","2017-04-18",7,14,11,25,25,"Yes",6,5,7,7
"6193","2017-04-18",3,6,5,11,11,"Yes",2,3,3,3
"6194","2017-04-18",7,14,7,21,21,"Yes",4,3,7,7
"6195","2017-04-18",1,2,7,9,9,"Yes",4,3,1,1
"6196","2017-04-18",3,6,6,12,12,"Yes",2,4,3,3
"6197","2017-04-19",3,6,8,14,15,"No",1,7,3,3
"6198","2017-04-18",1,2,3,5,5,"Yes",1,2,1,1
"6199","2017-04-18",1,2,8,10,8,"No",5,3,1,1
"6200","2017-04-18",1,4,5,9,9,"Yes",2,3,2,2
"6201","2017-04-18",2,7,1,8,9,"No",1,0,5,2
"6202","2017-04-18",5,10,17,27,27,"Yes",7,10,5,5
"6203","2017-04-18",1,3,0,3,3,"No",0,0,2,1
"6204","2017-04-18",1,4,7,11,10,"Yes",2,5,1,3
"6205","2017-04-18",2,4,8,12,12,"No",4,4,2,2
"6206","2017-04-18",10,20,13,33,35,"Yes",5,8,11,9
"6207","2017-04-18",4,8,8,16,16,"Yes",5,3,5,3
"6208","2017-04-18",3,6,6,12,16,"No",2,4,3,3
"6209","2017-04-18",1,2,0,2,2,"Yes",0,0,1,1
"6210","2017-04-18",5,12,5,17,17,"Yes",2,3,5,7
"6211","2017-04-18",4,8,10,18,18,"Yes",3,7,4,4
"6212","2017-04-18",1,2,5,7,7,"No",3,2,1,1
"6213","2017-04-18",7,14,5,19,20,"Yes",3,2,5,9
"6214","2017-04-18",13,15,6,21,26,"Yes",2,4,6,9
"6215","2017-04-18",4,16,12,28,28,"Yes",7,5,8,8
"6216","2017-04-18",5,15,2,17,17,"Yes",1,1,7,8
"6217","2017-04-18",5,10,11,21,21,"Yes",5,6,5,5
"6218","2017-04-18",2,5,1,6,9,"Yes",0,1,3,2
"6219","2017-04-18",5,9,8,17,17,"Yes",4,4,5,4
"6220","2017-04-18",4,5,4,9,9,"Yes",2,2,4,1
"6221","2017-04-18",1,2,6,8,8,"Yes",3,3,1,1
"6222","2017-04-18",5,11,1,12,12,"No",0,1,6,5
"6223","2017-04-18",4,10,8,18,18,"Yes",4,4,6,4
"6224","2017-04-18",3,8,8,16,16,"Yes",4,4,3,5
"6225","2017-04-18",5,11,15,26,NA,"Yes",7,8,4,7
"6226","2017-04-18",5,8,9,17,13,"Yes",2,7,4,4
"6227","2017-04-18",2,5,7,12,11,"Yes",3,4,2,3
"6228","2017-04-18",6,10,12,22,22,"No",4,8,5,5
"6229","2017-04-14",3,8,2,10,10,"Yes",1,1,5,3
"6230","2017-04-18",5,10,10,20,23,"Yes",6,4,5,5
"6231","2017-04-18",11,22,5,27,29,"Yes",2,3,12,10
"6232","2017-04-18",1,2,10,12,12,"Yes",5,5,1,1
"6233","2017-04-14",5,10,6,16,16,"No",4,2,6,4
"6234","2017-04-18",9,17,3,20,25,"Yes",3,NA,8,9
"6235","2017-04-14",2,8,2,10,10,"Yes",2,0,5,3
"6236","2017-04-18",NA,4,1,5,NA,"No",1,0,2,2
"6237","2017-04-18",5,10,10,20,20,"Yes",7,3,5,5
"6238","2017-04-17",10,13,8,21,21,"Yes",4,4,7,6
"6239","2017-04-18",4,6,7,13,13,"Yes",5,2,3,3
"6240","2017-04-18",1,2,3,5,5,"Yes",1,2,1,1
"6241","2017-04-18",2,4,10,14,14,"Yes",4,6,2,2
"6242","2017-04-18",1,7,5,12,7,"Yes",3,2,4,3
"6243","2017-04-18",1,2,4,6,6,"Yes",2,2,1,1
"6244","2017-04-18",3,9,3,12,12,"Yes",1,2,4,5
"6245","2017-04-18",2,4,8,12,12,"Yes",3,5,2,2
"6246","2017-04-18",3,6,3,9,NA,"No",3,0,4,2
"6247","2017-04-18",3,6,2,8,8,"No",0,2,4,2
"6248","2017-04-17",5,8,5,13,13,"Yes",1,4,5,3
"6249","2017-04-18",1,2,4,6,6,"Yes",2,2,1,1
"6250","2017-04-18",3,6,2,8,8,"No",2,0,3,3
"6251","2017-04-18",2,4,7,11,11,"Yes",3,4,2,2
"6252","2017-04-18",2,4,3,7,7,"Yes",0,3,2,2
"6253","2017-04-18",3,5,10,15,15,"Yes",5,5,2,3
"6254","2017-04-18",3,7,6,13,12,"Yes",3,3,3,4
"6255","2017-04-18",2,4,1,5,6,"No",1,0,2,2
"6256","2017-04-18",4,10,8,18,18,"No",6,2,5,5
"6257","2017-04-18",1,2,5,7,7,"Yes",4,1,1,1
"6258","2017-04-18",4,8,4,12,13,"Yes",3,1,4,4
"6259","2017-04-18",3,7,3,10,11,"Yes",1,2,3,4
"6260","2017-04-18",2,4,6,10,10,"Yes",3,3,2,2
"6261","2017-04-18",1,6,2,8,8,"No",1,1,2,4
"6262","2017-04-18",2,4,5,9,9,"Yes",3,2,2,2
"6263","2017-04-18",2,0,6,6,11,"Yes",4,2,NA,NA
"6264","2017-04-18",4,10,15,25,25,"No",6,9,1,9
"6265","2017-04-18",1,2,3,5,5,"No",2,1,1,1
"6266","2017-04-18",5,14,5,19,NA,"Yes",2,3,5,9
"6267","2017-04-18",1,2,0,2,2,"Yes",NA,NA,1,1
"6268","2017-04-18",3,8,5,13,14,"Yes",3,2,5,3
"6269","2017-04-18",4,8,10,18,18,"Yes",4,6,4,4
"6270","2017-04-18",1,4,4,8,8,"Yes",3,1,3,1
"6271","2017-04-18",7,16,13,29,29,"Yes",7,6,8,8
"6272","2017-04-18",3,6,3,9,9,"Yes",3,0,3,3
"6273","2017-04-18",1,2,0,2,3,"No",NA,NA,1,1
"6274","2017-04-18",2,4,2,6,7,"No",1,1,2,2
"6275","2017-04-18",5,9,5,14,14,"Yes",3,2,5,4
"6276","2017-04-18",9,18,12,30,35,"Yes",7,5,9,9
"6277","2017-04-18",3,6,9,15,15,"Yes",4,5,3,3
"6278","2017-04-18",2,4,2,6,6,"Yes",1,1,2,2
"6279","2017-04-18",3,6,6,12,12,"Yes",3,3,3,3
"6280","2017-04-18",2,7,6,13,9,"Yes",3,3,4,3
"6281","2017-04-18",4,8,6,14,NA,"Yes",2,4,4,4
"6282","2017-04-18",1,2,6,8,8,"Yes",2,4,1,1
"6283","2017-04-18",2,7,5,12,12,"Yes",3,2,4,3
"6284","2017-04-18",2,2,7,9,11,"No",1,6,1,1
"6285","2017-04-18",2,7,4,11,8,"Yes",1,3,4,3
"6286","2017-04-18",4,10,9,19,24,"Yes",4,5,4,6
"6287","2017-04-18",3,6,8,14,14,"Yes",5,3,3,3
"6288","2017-04-18",5,6,16,22,22,"Yes",8,8,2,4
"6289","2017-04-18",3,7,2,9,9,"Yes",2,0,3,4
"6290","2017-04-18",5,20,2,22,22,"No",1,1,8,12
"6291","2017-04-18",5,10,1,11,11,"Yes",1,NA,5,5
"6292","2017-04-18",5,13,9,22,22,"Yes",6,3,5,8
"6293","2017-04-18",7,13,11,24,24,"Yes",4,7,7,6
"6294","2017-04-18",7,7,4,11,NA,"Yes",2,2,2,5
"6295","2017-04-18",7,14,9,23,24,"Yes",3,6,7,7
"6296","2017-04-18",4,5,20,25,25,"No",10,10,2,3
"6297","2017-04-18",2,4,9,13,12,"No",9,0,2,2
"6298","2017-04-18",7,14,8,22,21,"No",3,5,7,7
"6299","2017-04-18",2,4,0,4,4,"No",NA,NA,2,2
"6300","2017-04-18",4,7,10,17,23,"No",3,7,3,4
"6301","2017-04-18",4,11,5,16,16,"Yes",2,3,4,7
"6302","2017-04-18",1,2,5,7,7,"Yes",3,2,1,1
"6303","2017-04-18",4,8,4,12,8,"Yes",2,2,4,4
"6304","2017-04-18",1,2,4,6,6,"Yes",1,3,1,1
"6305","2017-04-14",10,21,21,42,42,"Yes",6,15,11,10
"6306","2017-04-17",4,7,7,14,14,"Yes",4,3,4,3
"6307","2017-04-12",1,1,2,3,3,"Yes",1,1,1,0
"6308","2017-04-10",2,3,2,5,6,"Yes",1,1,2,1
"6309","2017-04-04",2,5,8,13,13,"No",3,5,2,3
"6310","2017-04-10",5,8,10,18,18,"Yes",3,7,3,5
"6311","2017-04-10",1,3,6,9,9,"No",2,4,1,2
"6312","2017-04-10",1,2,1,3,3,"Yes",1,0,1,1
"6313","2017-04-10",2,7,6,13,13,"Yes",2,4,3,4
"6314","2017-04-10",5,10,9,19,19,"Yes",2,7,5,5
"6315","2017-04-08",NA,500,100,600,600,"No",50,50,250,250
"6316","2017-03-31",2,6,6,12,12,"Yes",2,4,3,3
"6317","2017-03-31",2,5,7,12,12,"Yes",4,3,3,2
"6318","2017-03-30",3,4,3,7,7,"Yes",1,2,1,3
"6319","2017-03-30",5,12,14,26,26,"Yes",7,7,5,7
"6320","2017-03-30",3,6,7,13,13,"Yes",2,5,3,3
"6321","2017-04-19",2,4,2,6,7,"Yes",1,1,2,2
"6322","2017-04-19",7,13,9,22,NA,"Yes",0,9,6,7
"6323","2017-04-19",1,9,4,13,13,"Yes",2,2,4,5
"6324","2017-04-19",4,8,4,12,12,"Yes",1,3,4,4
"6325","2017-04-19",1,2,5,7,7,"Yes",3,2,1,1
"6326","2017-03-20",3,5,5,10,10,"Yes",1,4,3,2
"6327","2017-04-19",7,11,12,23,NA,"Yes",8,4,2,9
"6328","2017-04-19",4,11,9,20,20,"Yes",3,6,5,6
"6329","2017-04-19",6,14,3,17,18,"No",2,1,9,5
"6330","2017-04-19",2,4,7,11,11,"Yes",3,4,2,2
"6331","2017-04-19",NA,220,143,363,NA,"No",65,78,90,130
"6332","2017-04-19",2,5,2,7,7,"Yes",0,2,2,3
"6333","2017-04-19",2,3,4,7,7,"Yes",2,2,1,2
"6334","2017-04-19",3,8,3,11,18,"No",2,1,3,5
"6335","2017-04-19",2,4,2,6,10,"No",1,1,2,2
"6336","2017-04-19",14,23,9,32,32,"Yes",4,5,15,8
"6337","2017-04-19",4,7,5,12,18,"Yes",2,3,2,5
"6338","2017-04-19",5,13,8,21,21,"Yes",4,4,6,7
"6339","2017-04-19",4,7,4,11,11,"Yes",3,1,5,2
"6340","2017-04-19",1,1,2,3,3,"Yes",1,1,NA,1
"6341","2017-04-19",NA,4,30,34,NA,"Yes",15,15,2,2
"6342","2017-04-19",2,4,3,7,7,"Yes",1,2,2,2
"6343","2017-04-19",4,11,8,19,20,"No",3,5,5,6
"6344","2017-04-19",5,14,6,20,NA,"No",4,2,6,8
"6345","2017-04-19",5,10,15,25,25,"Yes",5,10,5,5
"6346","2017-04-19",9,11,9,20,20,"Yes",2,7,6,5
"6347","2017-04-19",NA,14,288,302,NA,"No",138,150,5,9
"6348","2017-04-19",3,14,0,14,14,"Yes",0,0,10,4
"6349","2017-04-19",4,9,1,10,11,"Yes",1,NA,4,5
"6350","2017-04-19",2,6,1,7,7,"No",0,1,2,4
"6351","2017-04-19",4,8,3,11,11,"Yes",1,2,5,3
"6352","2017-04-19",1,2,2,4,4,"Yes",1,1,1,1
"6353","2017-04-19",4,8,8,16,16,"No",2,6,4,4
"6354","2017-04-19",NA,18,600,618,NA,"No",250,350,8,10
"6355","2017-04-19",2,4,10,14,14,"Yes",3,7,2,2
"6356","2017-04-19",3,4,1,5,5,"No",0,1,2,2
"6357","2017-04-19",6,10,12,22,22,"Yes",4,8,6,4
"6358","2017-04-19",2,4,4,8,8,"Yes",2,2,2,2
"6359","2017-04-19",4,4,7,11,11,"Yes",5,2,2,2
"6360","2017-04-19",1,8,0,8,8,"Yes",0,0,1,7
"6361","2017-04-19",2,4,3,7,7,"Yes",1,2,2,2
"6362","2017-04-19",4,6,1,7,8,"No",0,1,2,4
"6363","2017-04-19",1,5,5,10,10,"Yes",3,2,2,3
"6364","2017-04-19",2,6,6,12,12,"Yes",2,4,2,4
"6365","2017-04-19",1,8,8,16,13,"Yes",3,5,NA,8
"6366","2017-04-19",6,13,5,18,18,"No",4,1,8,5
"6367","2017-04-19",6,12,3,15,NA,"No",1,2,6,6
"6368","2017-04-19",1,4,0,4,4,"No",0,0,1,3
"6369","2017-04-19",2,3,4,7,7,"Yes",3,1,2,1
"6370","2017-04-19",2,4,1,5,5,"Yes",0,1,1,3
"6371","2017-04-19",1,4,4,8,8,"Yes",2,2,2,2
"6372","2017-04-19",2,3,4,7,7,"Yes",1,3,2,1
"6373","2017-04-19",4,10,3,13,18,"Yes",0,3,4,6
"6374","2017-04-19",5,6,4,10,10,"No",2,2,4,2
"6375","2017-04-19",4,6,14,20,20,"Yes",5,9,3,3
"6376","2017-04-19",1,2,5,7,7,"Yes",1,4,1,1
"6377","2017-04-19",3,6,3,9,9,"Yes",1,2,3,3
"6378","2017-04-19",4,5,5,10,10,"Yes",3,2,1,4
"6379","2017-04-19",NA,162,0,162,NA,"No",NA,NA,135,27
"6380","2017-04-19",1,3,1,4,8,"Yes",0,1,2,1
"6381","2017-04-19",1,2,0,2,2,"Yes",NA,NA,1,1
"6382","2017-04-19",5,11,12,23,23,"No",5,7,5,6
"6383","2017-04-19",2,5,3,8,8,"Yes",1,2,2,3
"6384","2017-04-19",3,14,12,26,26,"Yes",9,3,7,7
"6385","2017-04-19",2,4,6,10,10,"Yes",2,4,2,2
"6386","2017-04-19",4,11,7,18,18,"Yes",4,3,4,7
"6387","2017-04-19",1,3,4,7,8,"Yes",1,3,1,2
"6388","2017-04-19",5,9,11,20,20,"Yes",7,4,5,4
"6389","2017-04-19",1,4,2,6,7,"Yes",1,1,3,1
"6390","2017-04-19",2,4,5,9,9,"Yes",2,3,0,4
"6391",NA,2,4,5,9,9,"Yes",4,1,2,2
"6392","2017-04-19",3,6,2,8,10,"Yes",1,1,3,3
"6393","2017-04-19",5,10,12,22,23,"Yes",3,9,5,5
"6394","2017-04-19",7,20,15,35,30,"Yes",10,5,10,10
"6395","2017-04-19",5,10,10,20,20,"Yes",6,4,5,5
"6396","2017-04-19",1,3,4,7,7,"Yes",0,4,3,0
"6397","2017-04-19",3,6,3,9,9,"Yes",3,NA,3,3
"6398","2017-04-19",1,3,5,8,8,"Yes",2,3,2,1
"6399","2017-04-19",2,4,2,6,7,"Yes",1,1,2,2
"6400","2017-04-19",3,7,5,12,12,"Yes",2,3,4,3
"6401","2017-04-19",1,4,1,5,6,"No",NA,1,2,2
"6402","2017-04-19",1,16,3,19,20,"Yes",1,2,7,9
"6403","2017-04-19",4,5,7,12,12,"Yes",1,6,3,2
"6404","2017-04-18",1,5,6,11,11,"Yes",2,4,2,3
"6405","2017-04-19",2,2,5,7,7,"Yes",0,5,1,1
"6406","2017-04-19",1,2,3,5,4,"No",3,0,1,1
"6407","2017-04-19",2,7,2,9,9,"Yes",2,0,6,1
"6408","2017-04-19",1,4,3,7,7,"Yes",2,1,1,3
"6409","2017-04-19",3,6,3,9,9,"Yes",1,2,3,3
"6410","2017-04-19",1,3,3,6,6,"Yes",2,1,1,2
"6411","2017-04-19",4,8,13,21,21,"Yes",5,8,4,4
"6412","2017-04-19",1,3,0,3,3,"Yes",0,0,1,2
"6413","2017-04-19",2,2,3,5,7,"No",2,1,1,1
"6414","2017-04-19",4,8,8,16,16,"No",2,6,4,4
"6415","2017-04-19",1,3,2,5,5,"Yes",2,0,2,1
"6416","2017-04-19",3,6,7,13,13,"Yes",5,2,3,3
"6417","2017-04-19",4,8,7,15,15,"Yes",3,4,4,4
"6418","2017-04-19",2,8,5,13,13,"Yes",3,2,3,5
"6419","2017-04-19",6,5,20,25,25,"Yes",5,15,2,3
"6420","2017-04-19",6,12,11,23,23,"Yes",4,7,6,6
"6421","2017-04-19",1,2,1,3,3,"Yes",1,0,1,1
"6422","2017-04-13",1,8,3,11,11,"Yes",2,1,2,6
"6423","2017-04-19",11,18,8,26,26,"Yes",5,3,11,7
"6424","2017-04-19",3,6,4,10,10,"Yes",1,3,2,4
"6425","2017-04-19",3,11,2,13,13,"No",1,1,6,5
"6426","2017-04-19",5,7,8,15,15,"No",4,4,4,3
"6427","2017-04-19",1,2,6,8,8,"Yes",2,4,1,1
"6428","2017-04-19",4,5,5,10,NA,"Yes",4,1,3,2
"6429","2017-04-19",1,2,2,4,4,"No",2,0,1,1
"6430","2017-04-19",3,16,2,18,19,"No",1,1,7,9
"6431","2017-04-19",3,6,8,14,14,"Yes",3,5,3,3
"6432","2017-04-19",3,5,7,12,12,"Yes",2,5,3,2
"6433","2017-04-19",2,3,5,8,8,"Yes",2,3,1,2
"6434","2017-04-19",6,17,14,31,31,"Yes",6,8,9,8
"6435","2017-04-19",7,21,8,29,38,"Yes",3,5,9,12
"6436","2017-04-19",2,6,7,13,13,"Yes",2,5,3,3
"6437","2017-04-19",6,12,14,26,29,"No",6,8,6,6
"6438","2017-04-19",5,11,9,20,NA,"Yes",6,3,6,5
"6439","2017-04-19",2,4,3,7,7,"No",2,1,2,2
"6440","2017-04-19",1,5,3,8,8,"Yes",3,0,4,1
"6441","2017-04-19",5,15,7,22,22,"Yes",1,6,9,6
"6442","2017-04-19",3,3,1,4,4,"Yes",0,1,2,1
"6443","2017-04-19",3,5,6,11,11,"Yes",1,5,4,1
"6444","2017-04-19",1,2,4,6,6,"Yes",2,2,1,1
"6445","2017-04-19",3,7,5,12,11,"Yes",3,2,3,4
"6446","2017-04-19",2,9,5,14,14,"No",2,3,4,5
"6447","2017-04-19",2,4,3,7,7,"No",1,2,2,2
"6448","2017-04-19",1,6,0,6,6,"Yes",0,0,2,4
"6449","2017-04-19",3,0,0,0,NA,"Yes",NA,NA,NA,NA
"6450","2017-04-19",5,8,4,12,13,"Yes",2,2,5,3
"6451","2017-04-19",2,4,7,11,11,"No",2,5,2,2
"6452","2017-04-19",2,4,1,5,5,"No",1,0,2,2
"6453","2017-04-19",1,4,5,9,9,"No",2,3,1,3
"6454","2017-04-19",1,3,0,3,3,"Yes",0,0,1,2
"6455","2017-04-19",3,4,3,7,9,"No",1,2,1,3
"6456","2017-04-19",2,3,5,8,8,"No",2,3,2,1
"6457","2017-04-19",1,3,3,6,6,"Yes",2,1,1,2
"6458","2017-04-19",4,10,7,17,17,"No",2,5,5,5
"6459","2017-04-19",2,4,5,9,9,"Yes",4,1,2,2
"6460","2017-04-19",1,5,7,12,10,"Yes",1,6,2,3
"6461","2017-04-19",1,5,4,9,8,"Yes",2,2,3,2
"6462","2017-04-19",1,2,2,4,4,"Yes",0,2,1,1
"6463","2017-04-19",1,8,2,10,6,"Yes",2,0,6,2
"6464","2017-04-19",1,3,4,7,7,"Yes",2,2,1,2
"6465","2017-04-19",3,10,11,21,21,"Yes",6,5,6,4
"6466","2017-04-19",2,4,5,9,9,"Yes",2,3,2,2
"6467","2017-04-19",1,8,2,10,10,"Yes",0,2,4,4
"6468","2017-04-19",2,3,3,6,NA,"Yes",1,2,1,2
"6469","2017-04-19",2,3,6,9,9,"Yes",3,3,2,1
"6470","2017-04-19",6,12,20,32,32,"Yes",12,8,6,6
"6471","2017-04-19",3,9,4,13,15,"Yes",4,0,5,4
"6472","2017-04-19",1,2,1,3,3,"No",1,0,1,1
"6473","2017-04-19",4,8,16,24,24,"Yes",7,9,4,4
"6474","2017-04-19",5,12,12,24,25,"Yes",3,9,4,8
"6475","2017-04-19",3,3,4,7,7,"No",3,1,1,2
"6476","2017-04-19",4,10,9,19,19,"Yes",5,4,4,6
"6477","2017-04-19",1,4,1,5,6,"Yes",0,1,3,1
"6478","2017-04-19",5,0,0,0,NA,"Yes",NA,NA,NA,NA
"6479","2017-04-19",1,4,3,7,7,NA,3,NA,2,2
"6480","2017-04-19",3,7,6,13,15,"No",3,3,3,4
"6481","2017-04-19",5,11,10,21,24,"No",1,9,5,6
"6482","2017-04-19",3,8,8,16,16,"No",2,6,4,4
"6483","2017-04-19",3,5,2,7,11,"Yes",0,2,2,3
"6484","2017-04-19",3,6,12,18,18,"No",4,8,3,3
"6485","2017-04-19",6,12,17,29,30,"Yes",5,12,6,6
"6486","2017-04-19",5,12,5,17,17,"Yes",2,3,5,7
"6487","2017-04-19",4,11,7,18,18,"No",3,4,4,7
"6488","2017-04-19",2,7,4,11,9,"Yes",1,3,3,4
"6489","2017-04-19",2,4,8,12,12,"No",5,3,2,2
"6490","2017-04-19",4,7,22,29,28,"Yes",11,11,3,4
"6491","2017-04-19",4,6,5,11,11,"No",1,4,1,5
"6492","2017-04-19",2,5,10,15,15,"Yes",2,8,2,3
"6493","2017-04-19",2,5,3,8,8,"Yes",1,2,2,3
"6494","2017-04-19",1,5,2,7,7,"No",1,1,3,2
"6495","2017-04-19",3,6,4,10,13,"Yes",2,2,3,3
"6496","2017-04-19",2,2,7,9,9,"Yes",4,3,1,1
"6497","2017-04-19",3,6,4,10,10,"Yes",3,1,3,3
"6498","2017-04-19",3,6,8,14,14,"Yes",2,6,3,3
"6499","2017-04-19",4,8,2,10,10,"Yes",1,1,4,4
"6500","2017-04-19",11,27,14,41,45,"Yes",8,6,12,15
"6501","2017-04-19",1,3,4,7,9,"Yes",2,2,2,1
"6502","2017-04-19",2,4,1,5,8,"Yes",0,1,1,3
"6503","2017-04-19",2,5,7,12,12,"Yes",4,3,3,2
"6504","2017-04-19",2,4,8,12,12,"Yes",5,3,2,2
"6505","2017-04-19",1,2,5,7,7,"Yes",2,3,1,1
"6506","2017-04-19",NA,17,8193,8210,NA,"No",2561,5632,8,9
"6507","2017-04-19",2,4,1,5,7,"Yes",1,0,2,2
"6508","2017-04-19",4,9,7,16,16,"No",3,4,4,5
"6509","2017-04-19",4,8,8,16,16,"Yes",4,4,4,4
"6510","2017-04-19",7,15,9,24,25,"No",3,6,7,8
"6511","2017-04-19",3,6,10,16,16,"No",4,6,3,3
"6512","2017-04-19",1,2,3,5,5,"Yes",1,2,1,1
"6513","2017-04-19",1,2,3,5,5,"No",2,1,1,1
"6514","2017-04-19",1,4,2,6,6,"Yes",1,1,2,2
"6515","2017-04-19",3,6,4,10,10,"Yes",3,1,3,3
"6516","2017-04-19",6,10,8,18,18,"Yes",2,6,5,5
"6517","2017-04-19",3,5,5,10,10,"Yes",3,2,4,1
"6518","2017-04-19",6,11,3,14,14,"Yes",0,3,7,4
"6519","2017-04-19",3,10,7,17,20,"Yes",1,6,4,6
"6520","2017-04-19",5,10,8,18,18,"Yes",2,6,5,5
"6521","2017-04-19",1,7,1,8,8,"Yes",1,0,3,4
"6522","2017-04-19",1,6,6,12,9,"No",3,3,4,2
"6523","2017-04-19",1,1,3,4,4,"Yes",2,1,NA,1
"6524","2017-04-19",3,7,8,15,12,"No",4,4,4,3
"6525","2017-04-19",1,4,2,6,7,"Yes",0,2,3,1
"6526","2017-04-19",2,4,10,14,14,"Yes",4,6,2,2
"6527","2017-04-19",5,12,10,22,22,"Yes",5,5,6,6
"6528","2017-04-19",4,3,7,10,10,"Yes",3,4,1,2
"6529","2017-04-19",1,4,6,10,8,"Yes",2,4,3,1
"6530","2017-04-19",2,3,3,6,6,"No",2,1,2,1
"6531","2017-04-19",1,2,4,6,6,"Yes",2,2,1,1
"6532","2017-04-19",3,8,1,9,8,"Yes",0,1,4,4
"6533","2017-04-19",1,4,0,4,4,"Yes",0,0,2,2
"6534","2017-04-19",7,14,7,21,20,"No",3,4,7,7
"6535","2017-04-19",2,2,4,6,6,"Yes",2,2,1,1
"6536","2017-04-19",1,7,1,8,8,"Yes",NA,1,NA,7
"6537","2017-04-19",4,9,5,14,14,"No",3,2,4,5
"6538","2017-04-19",4,9,4,13,12,"Yes",1,3,5,4
"6539","2017-04-19",3,2,9,11,11,"Yes",3,6,1,1
"6540","2017-04-19",4,9,9,18,18,"Yes",4,5,4,5
"6541","2017-04-20",3,6,6,12,9,"Yes",3,3,4,2
"6542","2017-04-20",1,2,8,10,10,"Yes",4,4,1,1
"6543","2017-04-20",1,2,5,7,7,"Yes",2,3,1,1
"6544","2017-04-20",2,4,1,5,5,"Yes",0,1,2,2
"6545","2017-04-20",2,5,2,7,7,"Yes",2,0,3,2
"6546","2017-04-20",1,5,3,8,6,"Yes",3,0,4,1
"6547","2017-04-20",3,9,6,15,15,"Yes",3,3,4,5
"6548","2017-04-20",2,4,8,12,13,"Yes",3,5,2,2
"6549","2017-04-20",3,6,10,16,16,"Yes",4,6,3,3
"6550","2017-04-20",2,9,1,10,10,"Yes",1,0,3,6
"6551","2017-04-20",4,10,8,18,18,"No",4,4,4,6
"6552","2017-04-20",2,5,5,10,8,"Yes",2,3,2,3
"6553","2017-04-20",6,15,20,35,35,"No",10,10,5,10
"6554","2017-04-20",4,10,7,17,17,"No",3,4,6,4
"6555","2017-04-20",2,11,0,11,7,"Yes",0,0,7,4
"6556","2017-04-20",1,2,2,4,4,"Yes",0,2,1,1
"6557","2017-04-20",5,15,11,26,26,"Yes",6,5,7,8
"6558","2017-04-20",1,3,4,7,7,"Yes",2,2,1,2
"6559","2017-04-20",1,2,5,7,7,"Yes",2,3,1,1
"6560","2017-04-20",3,11,11,22,22,"Yes",5,6,3,8
"6561","2017-04-20",1,2,2,4,4,"Yes",2,0,1,1
"6562","2017-04-20",1,3,5,8,8,"Yes",1,4,2,1
"6563","2017-04-19",1,2,3,5,5,"Yes",1,2,1,1
"6564","2017-04-20",1,7,3,10,8,"Yes",2,1,3,4
"6565","2017-04-20",4,8,2,10,9,"Yes",1,1,4,4
"6566","2017-04-20",4,14,6,20,20,"Yes",2,4,6,8
"6567","2017-04-20",5,11,5,16,16,"Yes",3,2,5,6
"6568","2017-04-20",1,6,1,7,7,"Yes",0,1,2,4
"6569","2017-04-20",1,3,2,5,5,"Yes",1,1,2,1
"6570","2017-04-20",1,5,6,11,11,"No",5,1,3,2
"6571","2017-04-20",1,2,5,7,7,"Yes",3,2,1,1
"6572","2017-04-20",1,3,4,7,9,"Yes",1,3,1,2
"6573","2017-04-20",1,3,6,9,9,"Yes",3,3,1,2
"6574","2017-04-20",3,9,6,15,15,"Yes",2,4,3,6
"6575","2017-04-20",2,4,2,6,6,"No",0,2,2,2
"6576","2017-04-20",1,2,4,6,6,"Yes",3,1,1,1
"6577","2017-04-20",1,2,3,5,6,"Yes",0,3,1,1
"6578","2017-04-20",1,2,4,6,6,"Yes",2,2,1,1
"6579","2017-04-20",1,1,5,6,7,"Yes",3,2,NA,1
"6580","2017-04-20",1,2,2,4,4,"Yes",2,0,1,1
"6581","2017-04-20",2,4,3,7,9,"Yes",2,1,2,2
"6582","2017-04-20",2,5,10,15,15,"Yes",5,5,2,3
"6583","2017-04-20",1,14,14,28,15,"Yes",6,8,6,8
"6584","2017-04-20",1,2,5,7,7,"Yes",3,2,1,1
"6585","2017-04-20",3,7,11,18,18,"Yes",6,5,3,4
"6586","2017-04-20",3,2,8,10,10,"Yes",4,4,1,1
"6587","2017-04-20",3,8,10,18,13,"Yes",3,7,6,2
"6588","2017-04-20",3,7,8,15,133,"Yes",5,3,4,3
"6589","2017-04-20",6,10,15,25,24,"No",7,8,6,4
"6590","2017-04-20",4,8,9,17,17,"Yes",4,5,4,4
"6591","2017-04-20",1,5,3,8,8,"Yes",1,2,3,2
"6592","2017-04-20",1,6,1,7,7,"Yes",1,0,4,2
"6593","2017-04-20",4,6,9,15,11,"No",8,1,2,4
"6594","2017-04-20",1,6,2,8,8,"Yes",0,2,3,3
"6595","2017-04-20",6,16,8,24,24,"Yes",5,3,8,8
"6596","2017-04-20",4,8,1,9,9,"Yes",0,1,4,4
"6597","2017-04-20",1,2,3,5,6,"Yes",2,1,1,1
"6598","2017-04-20",6,13,5,18,NA,"Yes",2,3,8,5
"6599","2017-04-20",2,6,5,11,11,"Yes",2,3,2,4
"6600","2017-04-20",4,5,10,15,15,"Yes",5,5,2,3
"6601","2017-04-20",3,6,5,11,14,"No",2,3,3,3
"6602","2017-04-20",3,6,6,12,12,"Yes",1,5,3,3
"6603","2017-04-20",1,2,3,5,5,"No",1,2,1,1
"6604","2017-04-20",7,18,8,26,26,"Yes",3,5,8,10
"6605","2017-04-20",1,2,0,2,2,"No",0,0,1,1
"6606","2017-04-20",7,11,20,31,31,"No",9,11,7,4
"6607","2017-04-20",1,2,3,5,6,"No",1,2,1,1
"6608","2017-04-20",1,2,4,6,6,"No",3,1,1,1
"6609","2017-04-20",1,8,14,22,21,NA,3,11,4,4
"6610","2017-04-20",1,2,4,6,6,"Yes",1,3,1,1
"6611","2017-04-20",1,4,4,8,8,"Yes",1,3,2,2
"6612","2017-04-20",3,7,3,10,11,"Yes",2,1,4,3
"6613","2017-04-20",1,2,3,5,5,"Yes",3,0,1,1
"6614","2017-04-20",NA,43,0,43,NA,"No",0,0,40,3
"6615","2017-04-20",5,12,4,16,15,"No",2,2,6,6
"6616","2017-04-20",1,2,6,8,8,"Yes",4,2,1,1
"6617","2017-04-20",1,7,1,8,8,"Yes",0,1,3,4
"6618","2017-04-20",5,13,12,25,25,"Yes",7,5,5,8
"6619","2017-04-20",3,12,4,16,15,"No",2,2,6,6
"6620","2017-04-20",5,7,6,13,NA,"Yes",2,4,3,4
"6621","2017-04-20",3,8,5,13,13,"Yes",1,4,5,3
"6622","2017-04-20",1,4,2,6,7,"Yes",1,1,2,2
"6623","2017-04-19",3,8,5,13,13,"Yes",2,3,3,5
"6624","2017-04-20",3,6,11,17,17,"Yes",4,7,3,3
"6625","2017-04-20",2,4,8,12,13,"No",3,5,2,2
"6626","2017-04-20",3,5,10,15,15,"No",5,5,1,4
"6627","2017-04-20",1,6,3,9,8,"Yes",2,1,3,3
"6628","2017-04-20",2,4,4,8,6,"No",1,3,2,2
"6629","2017-04-20",2,5,0,5,5,"Yes",0,0,3,2
"6630","2017-04-20",4,7,11,18,15,"Yes",6,5,3,4
"6631","2017-04-20",4,8,10,18,16,"No",3,7,4,4
"6632","2017-04-20",3,15,10,25,25,"No",5,5,5,10
"6633","2017-04-20",4,10,4,14,14,"Yes",2,2,4,6
"6634","2017-04-20",7,14,6,20,20,"No",2,4,7,7
"6635","2017-04-20",3,6,4,10,8,"Yes",3,1,4,2
"6636","2017-04-20",4,9,6,15,15,"Yes",2,4,5,4
"6637","2017-04-20",4,8,12,20,20,"No",5,7,4,4
"6638","2017-04-20",3,12,2,14,NA,"Yes",0,2,7,5
"6639","2017-04-20",4,8,7,15,15,"No",3,4,4,4
"6640","2017-04-20",2,13,10,23,23,"No",5,5,6,7
"6641","2017-04-20",7,15,6,21,21,"Yes",2,4,11,4
"6642","2017-04-20",1,6,1,7,7,"No",0,1,3,3
"6643","2017-04-20",8,9,2,11,22,"Yes",NA,2,8,1
"6644","2017-04-20",4,8,7,15,NA,"No",4,3,4,4
"6645","2017-04-20",1,2,1,3,3,"No",0,1,1,1
"6646","2017-04-20",1,2,4,6,8,"Yes",3,1,1,1
"6647","2017-04-20",1,2,5,7,7,"Yes",3,2,1,1
"6648","2017-04-20",5,10,10,20,20,"Yes",8,2,4,6
"6649","2017-04-20",5,13,7,20,20,"Yes",4,3,5,8
"6650","2017-04-20",3,8,12,20,20,"Yes",5,7,4,4
"6651","2017-04-20",1,3,3,6,8,"Yes",2,1,1,2
"6652","2017-04-20",4,8,9,17,19,"Yes",5,4,4,4
"6653","2017-04-20",3,5,4,9,7,"Yes",2,2,2,3
"6654","2017-04-20",6,22,4,26,26,"Yes",3,1,10,12
"6655","2017-04-20",4,9,9,18,18,"Yes",6,3,4,5
"6656","2017-04-20",3,7,8,15,15,"No",3,5,4,3
"6657","2017-04-20",3,4,4,8,6,"Yes",3,1,3,1
"6658","2017-04-20",3,8,6,14,14,"No",2,4,4,4
"6659","2017-04-20",3,6,2,8,8,"Yes",2,0,3,3
"6660","2017-04-20",2,5,3,8,9,"Yes",1,2,2,3
"6661","2017-04-20",1,2,3,5,5,"No",3,NA,1,1
"6662","2017-04-20",1,4,9,13,13,"Yes",5,4,2,2
"6663","2017-04-20",4,7,6,13,13,"No",5,1,3,4
"6664","2017-04-20",1,2,1,3,3,"Yes",1,0,1,1
"6665","2017-04-20",11,21,6,27,27,"Yes",2,4,11,10
"6666","2017-04-20",3,6,2,8,8,"Yes",2,0,3,3
"6667","2017-04-20",1,2,3,5,5,"Yes",1,2,1,1
"6668","2017-04-20",1,3,1,4,4,"No",1,0,1,2
"6669","2017-04-20",12,27,2,29,29,"Yes",1,1,15,12
"6670","2017-04-20",3,8,4,12,14,"Yes",2,2,5,3
"6671","2017-04-20",1,8,3,11,11,"Yes",2,1,3,5
"6672","2017-04-20",1,2,2,4,4,"Yes",1,1,1,1
"6673","2017-04-20",5,11,3,14,14,"No",1,2,5,6
"6674","2017-04-20",3,7,1,8,8,"Yes",1,0,3,4
"6675","2017-04-20",3,7,7,14,18,"No",5,2,3,4
"6676","2017-04-20",5,10,5,15,16,"Yes",3,2,5,5
"6677","2017-04-20",1,2,4,6,6,"Yes",3,1,1,1
"6678","2017-04-20",8,16,12,28,28,"No",3,9,8,8
"6679","2017-04-20",2,4,2,6,6,"Yes",0,2,2,2
"6680","2017-04-20",4,10,5,15,9,"Yes",1,4,5,5
"6681","2017-04-20",1,2,0,2,3,"Yes",0,0,1,1
"6682","2017-04-20",1,3,4,7,6,"Yes",4,NA,1,2
"6683","2017-04-20",2,4,4,8,8,"Yes",1,3,2,2
"6684","2017-04-20",5,7,5,12,NA,"No",4,1,3,4
"6685","2017-04-19",3,10,7,17,17,"Yes",4,3,5,5
"6686","2017-04-20",4,2,2,4,4,"No",1,1,1,1
"6687","2017-04-20",1,3,3,6,6,"Yes",2,1,1,2
"6688","2017-04-19",5,16,7,23,23,"No",4,3,10,6
"6689","2017-04-20",6,14,16,30,23,"No",9,7,5,9
"6690","2017-04-20",4,14,5,19,18,"Yes",2,3,8,6
"6691","2017-04-19",1,7,3,10,10,"Yes",2,1,2,5
"6692","2017-04-20",1,2,3,5,66,"Yes",0,3,1,1
"6693","2017-04-20",1,4,5,9,9,"Yes",2,3,1,3
"6694","2017-04-20",2,4,4,8,9,"No",1,3,2,2
"6695","2017-04-20",2,5,2,7,7,"Yes",1,1,3,2
"6696","2017-04-20",1,0,3,3,6,"Yes",1,2,NA,NA
"6697","2017-04-20",1,4,2,6,6,"Yes",1,1,2,2
"6698","2017-04-20",5,9,9,18,18,"Yes",5,4,5,4
"6699","2017-04-20",1,1,4,5,5,"Yes",2,2,NA,1
"6700","2017-04-20",2,4,1,5,8,"Yes",1,0,1,3
"6701","2017-04-13",2,10,4,14,14,"Yes",2,2,6,4
"6702","2017-04-20",3,8,8,16,16,"Yes",5,3,4,4
"6703","2017-04-20",8,23,13,36,38,"No",5,8,8,15
"6704","2017-04-20",2,6,4,10,11,"No",1,3,4,2
"6705","2017-04-20",6,12,6,18,NA,"No",0,6,5,7
"6706","2017-04-20",4,12,6,18,18,"No",4,2,6,6
"6707","2017-04-20",3,4,7,11,11,"Yes",3,4,2,2
"6708","2017-04-20",6,12,9,21,21,"No",4,5,6,6
"6709","2017-04-20",NA,130,0,130,NA,"No",0,0,100,30
"6710","2017-04-20",3,8,4,12,12,"Yes",2,2,4,4
"6711","2017-04-20",NA,7,281,288,NA,"No",125,156,4,3
"6712","2017-04-20",9,20,6,26,NA,"Yes",4,2,7,13
"6713","2017-04-20",NA,124,0,124,NA,"No",NA,NA,100,24
"6714","2017-04-20",1,6,1,7,7,"Yes",1,NA,2,4
"6715","2017-04-20",5,17,9,26,26,"No",5,4,8,9
"6716","2017-04-20",2,7,3,10,10,"Yes",2,1,1,6
"6717","2017-04-13",2,5,3,8,8,"No",1,2,2,3
"6718","2017-04-20",7,16,2,18,NA,"No",0,2,5,11
"6719","2017-04-20",1,7,2,9,7,"Yes",2,NA,5,2
"6720","2017-04-20",7,15,13,28,28,"Yes",7,6,7,8
"6721","2017-04-20",6,22,9,31,NA,"No",4,5,6,16
"6722","2017-04-20",5,10,10,20,20,"Yes",6,4,5,5
"6723","2017-04-20",1,3,2,5,5,"Yes",NA,2,2,1
"6724","2017-04-20",2,4,1,5,5,"No",1,0,2,2
"6725","2017-04-20",5,9,11,20,23,"No",5,6,5,4
"6726","2017-04-20",2,4,4,8,8,"No",2,2,2,2
"6727","2017-04-20",4,13,6,19,19,"Yes",2,4,8,5
"6728","2017-04-20",3,8,2,10,10,"Yes",2,0,4,4
"6729","2017-04-20",1,7,3,10,10,"Yes",2,1,2,5
"6730","2017-04-20",5,9,12,21,NA,"Yes",4,8,4,5
"6731","2017-04-20",4,10,5,15,15,"Yes",2,3,5,5
"6732","2017-04-20",4,9,7,16,16,"No",2,5,4,5
"6733","2017-04-20",3,6,4,10,12,"No",2,2,3,3
"6734","2017-04-20",3,5,5,10,13,"Yes",3,2,2,3
"6735","2017-04-20",2,4,5,9,9,"No",3,2,2,2
"6736","2017-04-20",4,9,7,16,11,"No",4,3,3,6
"6737","2017-04-19",2,8,6,14,14,"Yes",2,4,4,4
"6738","2017-04-20",2,6,3,9,8,"Yes",1,2,4,2
"6739","2017-04-20",2,5,2,7,8,"Yes",1,1,2,3
"6740","2017-04-20",8,18,3,21,21,"Yes",1,2,8,10
"6741","2017-04-20",14,34,34,68,56,"No",10,24,16,18
"6742","2017-04-20",3,8,8,16,15,"Yes",5,3,3,5
"6743","2017-04-20",4,11,13,24,24,"Yes",9,4,5,6
"6744","2017-04-20",5,13,6,19,NA,"Yes",4,2,7,6
"6745","2017-04-20",6,14,7,21,20,"Yes",4,3,7,7
"6746","2017-04-20",1,2,2,4,4,"Yes",1,1,1,1
"6747","2017-04-20",3,8,6,14,14,"Yes",2,4,3,5
"6748","2017-04-20",2,8,12,20,20,"Yes",5,7,5,3
"6749","2017-10-20",NA,4,6,10,NA,"Yes",4,2,2,2
"6750","2017-10-13",NA,6,5,11,NA,"Yes",2,3,5,1
"6751","2017-10-13",NA,4,5,9,NA,"Yes",2,3,1,3
"6752","2017-10-13",8,7,8,15,15,"Yes",4,4,3,4
"6753","2017-10-13",2,15,28,43,10,"Yes",12,16,8,7
"6754","2017-10-13",NA,3,5,8,NA,"Yes",2,3,1,2
"6755","2017-10-13",NA,8,5,13,NA,"Yes",2,3,4,4
"6756","2017-10-13",NA,2,5,7,NA,"Yes",3,2,1,1
"6757","2017-10-13",NA,2,5,7,NA,"No",3,2,1,1
"6758","2017-10-13",NA,2,7,9,NA,"No",1,6,1,1
"6759","2017-10-14",2,4,3,7,7,"Yes",1,2,1,3
"6760","2017-10-14",4,17,14,31,31,"Yes",7,7,8,9
"6761","2017-10-14",4,12,10,22,22,"Yes",4,6,5,7
"6762","2017-10-14",1,1,3,4,4,"Yes",1,2,NA,1
"6763","2017-10-14",5,11,10,21,21,"Yes",7,3,6,5
"6764","2017-10-14",1,2,3,5,5,"No",1,2,1,1
"6765","2017-10-14",2,4,5,9,9,"Yes",2,3,2,2
"6766","2017-10-14",1,3,6,9,9,"Yes",2,4,1,2
"6767","2017-10-14",2,5,6,11,NA,"Yes",2,4,2,3
"6768","2017-10-14",NA,3,5,8,7,"No",2,3,1,2
"6769","2017-10-14",3,7,7,14,17,"Yes",2,5,3,4
"6770","2017-10-14",3,6,3,9,9,"Yes",2,1,2,4
"6771","2017-10-14",2,4,5,9,9,"Yes",2,3,2,2
"6772","2017-10-14",1,2,5,7,7,"No",3,2,1,1
"6773","2017-10-14",3,8,10,18,18,"Yes",7,3,4,4
"6774","2017-10-14",2,7,5,12,12,"No",3,2,4,3
"6775","2017-10-14",3,5,7,12,12,"Yes",5,2,2,3
"6776","2017-10-14",1,2,11,13,13,"Yes",3,8,1,1
"6777","2017-10-14",4,8,12,20,20,"Yes",4,8,4,4
"6778","2017-10-14",3,10,7,17,17,"Yes",3,4,4,6
"6779","2017-10-14",4,10,8,18,18,"Yes",4,4,4,6
"6780","2017-10-14",3,7,6,13,13,"Yes",3,3,3,4
"6781","2017-10-14",6,14,11,25,25,"No",6,5,5,9
"6782","2017-10-14",5,11,13,24,24,"No",4,9,5,6
"6783","2017-10-14",4,4,5,9,10,"No",2,3,2,2
"6784","2017-10-14",3,6,6,12,12,"Yes",2,4,3,3
"6785","2017-10-14",1,1,2,3,3,"No",1,1,NA,1
"6786","2017-10-14",3,6,8,14,14,"No",6,2,3,3
"6787","2017-10-14",1,4,3,7,7,"Yes",1,2,2,2
"6788","2017-10-14",5,10,15,25,25,"Yes",6,9,5,5
"6789","2017-10-14",5,11,10,21,21,"Yes",4,6,5,6
"6790","2017-10-14",NA,70,50,120,NA,"Yes",20,30,30,40
"6791","2017-10-14",1,1,3,4,4,"No",1,2,NA,1
"6792","2017-10-14",7,20,10,30,30,"No",6,4,8,12
"6793","2017-10-14",6,12,15,27,27,"No",8,7,6,6
"6794","2017-10-14",3,7,11,18,18,"No",5,6,3,4
"6795","2017-10-14",6,10,17,27,27,"Yes",7,10,4,6
"6796","2017-10-14",1,4,0,4,4,"Yes",NA,NA,NA,4
"6797","2017-10-14",6,16,6,22,22,"Yes",4,2,7,9
"6798","2017-10-14",6,14,15,29,29,"No",6,9,6,8
"6799","2017-10-14",2,4,4,8,8,"No",1,3,2,2
"6800","2017-10-14",1,4,1,5,5,"Yes",1,NA,2,2
"6801","2017-10-14",1,2,5,7,7,"No",3,2,1,1
"6802","2017-10-14",3,6,10,16,16,"Yes",6,4,3,3
"6803","2017-10-14",8,16,17,33,31,"Yes",8,9,6,10
"6804","2017-10-14",8,10,18,28,28,"Yes",8,10,5,5
"6805","2017-10-14",1,2,3,5,5,"Yes",1,2,1,1
"6806","2017-10-14",7,16,24,40,40,"No",11,13,6,10
"6807","2017-10-14",3,13,4,17,17,"Yes",1,3,6,7
"6808","2017-10-14",6,12,8,20,20,"Yes",3,5,6,6
"6809","2017-10-14",2,7,1,8,8,NA,NA,1,5,2
"6810","2017-10-14",5,7,2,9,9,"Yes",1,1,3,4
"6811","2017-10-14",4,12,8,20,20,"No",3,5,5,7
"6812","2017-10-14",9,19,26,45,45,"Yes",14,12,9,10
"6813","2017-10-14",5,9,12,21,NA,"No",6,6,4,5
"6814","2017-10-14",4,10,10,20,20,"Yes",4,6,4,6
"6815","2017-10-14",4,9,6,15,15,"Yes",3,3,4,5
"6816","2017-10-14",3,6,11,17,17,"No",7,4,3,3
"6817","2017-10-14",5,10,16,26,26,"Yes",5,11,5,5
"6818","2017-10-14",1,2,5,7,7,"Yes",2,3,1,1
"6819","2017-10-14",8,12,12,24,24,"No",5,7,4,8
"6820","2017-10-14",3,4,8,12,12,"No",2,6,2,2
"6821","2017-10-14",4,10,10,20,20,"Yes",4,6,5,5
"6822","2017-10-14",6,12,20,32,32,"Yes",12,8,6,6
"6823","2017-10-14",3,14,5,19,17,"Yes",3,2,6,8
"6824","2017-10-14",6,12,16,28,28,"Yes",7,9,6,6
"6825","2017-10-14",7,17,14,31,31,"Yes",6,8,7,10
"6826","2017-10-14",3,8,6,14,13,"Yes",2,4,4,4
"6827","2017-10-14",5,17,12,29,29,"Yes",5,7,7,10
"6828","2017-10-14",4,8,10,18,21,"No",6,4,3,5
"6829","2017-10-14",6,20,34,54,54,"Yes",19,15,9,11
"6830","2017-10-14",1,3,5,8,7,"No",3,2,1,2
"6831","2017-10-14",4,10,7,17,17,"Yes",3,4,4,6
"6832","2017-10-14",7,11,16,27,27,"Yes",8,8,4,7
"6833","2017-10-14",6,6,12,18,18,"Yes",4,8,3,3
"6834","2017-10-14",1,2,3,5,5,"Yes",1,2,1,1
"6835","2017-10-14",NA,10,14,24,NA,"No",6,8,3,7
"6836","2017-10-14",4,8,8,16,16,"Yes",3,5,4,4
"6837","2017-10-14",NA,10,13,23,NA,"Yes",5,8,4,6
"6838","2017-10-14",2,4,9,13,13,"Yes",3,6,2,2
"6839","2017-10-14",1,5,4,9,9,"Yes",3,1,2,3
"6840","2017-10-14",2,5,3,8,8,"No",1,2,2,3
"6841","2017-10-14",1,5,3,8,8,"Yes",1,2,2,3
"6842","2017-10-14",1,1,1,2,2,"Yes",1,NA,1,NA
"6843","2017-10-14",7,8,7,15,15,"No",4,3,4,4
"6844","2017-10-14",2,4,6,10,10,"Yes",2,4,2,2
"6845","2017-10-13",2,2,7,9,9,"Yes",2,5,1,1
"6846","2017-10-14",5,9,8,17,17,"Yes",1,7,4,5
"6847","2017-10-14",3,9,5,14,14,"No",4,1,7,2
"6848","2017-10-14",11,17,13,30,30,"Yes",7,6,11,6
"6849","2017-10-14",7,13,9,22,22,"Yes",5,4,7,6
"6850","2017-10-14",6,19,10,29,29,"Yes",6,4,4,15
"6851","2017-10-14",1,4,4,8,8,"Yes",1,3,2,2
"6852","2017-10-14",3,10,3,13,13,"Yes",1,2,4,6
"6853","2017-10-14",3,6,3,9,9,"Yes",1,2,4,2
"6854","2017-10-14",7,14,2,16,16,"Yes",NA,2,7,7
"6855","2017-10-14",4,6,2,8,8,"Yes",2,0,5,1
"6856","2017-10-14",3,7,8,15,15,"Yes",3,5,2,5
"6857","2017-10-14",3,8,6,14,14,"Yes",0,6,5,3
"6858","2017-10-14",3,9,6,15,15,"Yes",6,0,3,6
"6859","2017-10-14",7,21,10,31,30,"Yes",3,7,13,8
"6860","2017-10-14",3,5,5,10,10,"Yes",1,4,2,3
"6861","2017-10-14",2,7,5,12,12,"Yes",2,3,4,3
"6862","2017-10-14",2,5,5,10,10,"Yes",2,3,2,3
"6863","2017-10-14",4,8,11,19,19,"No",6,5,4,4
"6864","2017-10-14",3,10,4,14,14,"Yes",2,2,6,4
"6865","2017-10-14",4,7,5,12,12,"Yes",3,2,3,4
"6866","2017-10-14",1,9,3,12,12,"Yes",1,2,6,3
"6867","2017-10-14",3,5,8,13,13,"Yes",3,5,3,2
"6868","2017-10-14",5,12,15,27,27,"No",7,8,4,8
"6869","2017-10-14",5,10,5,15,15,"No",3,2,4,6
"6870","2017-10-14",4,10,13,23,23,"No",8,5,5,5
"6871","2017-10-14",1,2,2,4,4,"Yes",2,0,0,2
"6872","2017-10-14",5,12,7,19,6,"Yes",4,3,7,5
"6873","2017-10-15",22,8,5,13,8,"No",2,3,4,4
"6874","2017-10-16",NA,170,72,242,NA,"No",30,42,70,100
"6875","2017-10-16",NA,350,325,675,NA,"No",25,300,150,200
"6876","2017-10-16",NA,393,76,469,NA,"Yes",45,31,183,210
"6877","2017-10-16",NA,5,400,405,NA,"No",150,250,3,2
"6878","2017-10-14",NA,70,95,165,NA,NA,50,45,10,60
"6879","2017-10-16",NA,108,38,146,NA,"No",15,23,30,78
"6880","2017-10-16",NA,1,2,3,NA,"No",1,1,NA,1
"6881","2017-10-16",2,13,3,16,12,"Yes",1,2,6,7
"6882","2017-10-16",NA,38,0,38,NA,"Yes",0,0,23,15
"6883","2017-10-16",3,7,23,30,32,"Yes",1,22,1,6
"6884","2017-10-16",NA,10,5,15,NA,"Yes",3,2,6,4
"6885","2017-10-16",NA,100,59,159,NA,"No",30,29,60,40
"6886","2017-10-16",5,10,5,15,15,"No",NA,5,5,5
"6887","2017-10-16",NA,9,6,15,NA,"Yes",2,4,3,6
"6888","2017-10-16",NA,125,0,125,NA,"No",0,0,100,25
"6889","2017-10-16",NA,14,5,19,NA,"No",2,3,7,7
"6890","2017-10-16",NA,85,0,85,NA,"No",NA,NA,40,45
"6891","2017-10-16",NA,27,0,27,NA,"No",0,0,20,7
"6892","2017-10-16",1,2,1,3,3,"Yes",1,0,1,1
"6893","2017-10-16",NA,200,8,208,NA,"No",6,2,80,120
"6894","2017-10-16",NA,108,0,108,NA,"Yes",0,0,48,60
"6895","2017-10-17",5,10,7,17,17,"Yes",4,3,5,5
"6896","2017-10-16",6,14,10,24,25,"No",6,4,7,7
"6897","2017-10-16",2,4,6,10,10,"No",3,3,3,1
"6898","2017-10-16",3,8,5,13,13,"Yes",1,4,3,5
"6899","2017-10-16",5,9,2,11,11,"Yes",1,1,8,1
"6900","2017-10-16",1,2,10,12,12,"Yes",3,7,1,1
"6901","2017-10-16",5,10,15,25,5,"Yes",6,9,5,5
"6902","2017-10-16",6,7,13,20,23,"No",8,5,3,4
"6903","2017-10-16",2,5,5,10,10,"No",3,2,3,2
"6904","2017-10-16",1,2,6,8,8,"Yes",2,4,1,1
"6905","2017-10-16",7,17,15,32,42,"No",3,12,8,9
"6906","2017-10-16",10,10,1,11,11,"Yes",1,0,0,10
"6907","2017-10-16",8,11,10,21,22,"Yes",2,8,6,5
"6908","2017-10-16",NA,4,70,74,NA,"No",30,40,3,1
"6909","2017-10-16",2,10,34,44,44,"Yes",14,20,5,5
"6910","2017-10-16",2,4,10,14,14,"No",4,6,2,2
"6911","2017-10-16",2,7,5,12,13,"Yes",1,4,4,3
"6912","2017-10-16",5,10,15,25,25,"Yes",6,9,5,5
"6913","2017-10-16",4,5,8,13,13,"No",5,3,3,2
"6914","2017-10-16",5,14,6,20,20,"No",5,1,5,9
"6915","2017-10-16",3,6,6,12,12,"Yes",2,4,3,3
"6916","2017-10-23",5,7,6,13,5,"No",2,4,6,1
"6917","2017-10-16",3,6,7,13,16,"Yes",3,4,3,3
"6918","2017-10-16",4,8,10,18,18,"Yes",5,5,4,4
"6919","2017-10-16",14,33,5,38,38,NA,3,2,16,17
"6920","2017-10-16",4,9,14,23,23,"No",6,8,3,6
"6921","2017-10-16",6,15,10,25,25,"Yes",4,6,7,8
"6922","2017-10-16",3,10,8,18,20,"Yes",1,7,4,6
"6923","2017-10-14",1,4,6,10,8,"Yes",3,3,1,3
"6924","2017-10-16",NA,5,1,6,NA,"No",0,1,4,1
"6925","2017-10-16",NA,6,140,146,NA,"No",65,75,4,2
"6926","2017-10-14",3,9,10,19,20,"Yes",5,5,4,5
"6927","2017-10-14",1,4,3,7,8,"Yes",2,1,1,3
"6928","2017-10-16",5,12,20,32,28,"Yes",17,3,7,5
"6929","2017-10-16",7,13,7,20,7,"Yes",5,2,7,6
"6930","2017-10-16",2,4,3,7,7,"Yes",2,1,1,3
"6931","2017-10-16",NA,500,150,650,NA,"No",70,80,200,300
"6932","2017-10-16",8,20,7,27,25,"Yes",3,4,7,13
"6933","2017-10-16",7,12,9,21,21,"No",5,4,7,5
"6934","2017-10-16",4,9,10,19,21,"Yes",6,4,4,5
"6935","2017-10-16",7,21,36,57,53,"Yes",9,27,8,13
"6936","2017-10-16",4,10,4,14,15,"Yes",2,2,4,6
"6937","2017-10-16",4,5,7,12,12,"No",2,5,1,4
"6938","2017-10-16",6,7,8,15,15,"Yes",5,3,4,3
"6939","2017-10-16",4,8,8,16,16,"Yes",2,6,4,4
"6940","2017-10-16",5,10,9,19,19,"Yes",4,5,6,4
"6941","2017-10-16",9,15,6,21,21,"Yes",4,2,5,10
"6942","2017-10-16",1,5,3,8,8,"Yes",2,1,2,3
"6943",NA,3,5,1,6,6,"Yes",NA,1,2,3
"6944","2017-10-16",2,6,4,10,10,"No",1,3,4,2
"6945","2017-10-16",8,11,10,21,23,"Yes",6,4,4,7
"6946","2017-10-16",NA,150,30,180,NA,"No",10,20,70,80
"6947","2017-10-16",5,11,8,19,19,"Yes",4,4,5,6
"6948","2017-10-16",5,10,10,20,15,"Yes",5,5,5,5
"6949","2017-10-16",5,19,10,29,29,"Yes",5,5,8,11
"6950","2017-10-16",3,10,8,18,18,"Yes",4,4,6,4
"6951","2017-10-16",3,4,5,9,9,"Yes",2,3,2,2
"6952","2017-10-16",4,11,4,15,15,"Yes",1,3,4,7
"6953","2017-10-16",1,2,3,5,5,"No",1,2,1,1
"6954","2017-10-16",6,15,17,32,32,"No",NA,17,8,7
"6955","2017-10-16",2,5,2,7,7,"Yes",1,1,3,2
"6956","2017-10-16",3,8,13,21,21,"Yes",5,8,4,4
"6957","2017-10-16",9,20,21,41,20,"Yes",10,11,9,11
"6958","2017-10-16",5,13,11,24,24,"Yes",4,7,5,8
"6959","2017-10-16",6,15,15,30,30,"Yes",7,8,7,8
"6960","2017-10-16",5,9,8,17,17,"Yes",2,6,4,5
"6961","2017-10-16",3,16,9,25,21,"Yes",4,5,10,6
"6962","2017-10-16",8,11,8,19,19,"Yes",5,3,5,6
"6963","2017-10-16",12,10,20,30,30,"Yes",8,12,6,4
"6964","2017-10-16",NA,170,0,170,NA,"No",NA,NA,120,50
"6965","2017-10-16",4,11,6,17,17,"No",4,2,5,6
"6966","2017-10-16",28,13,7,20,28,"Yes",4,3,6,7
"6967","2017-10-16",1,2,2,4,5,"No",1,1,1,1
"6968","2017-10-16",3,5,2,7,7,"No",1,1,3,2
"6969","2017-10-16",6,8,7,15,15,"Yes",2,5,2,6
"6970","2017-10-16",4,8,10,18,18,"Yes",5,5,4,4
"6971","2017-10-16",8,8,7,15,15,"Yes",3,4,5,3
"6972","2017-10-16",8,22,18,40,40,"Yes",8,10,10,12
"6973","2017-10-16",NA,8,82,90,NA,"Yes",52,30,4,4
"6974","2017-10-16",8,24,8,32,32,"No",4,4,11,13
"6975","2017-10-16",5,7,17,24,25,"No",9,8,2,5
"6976","2017-10-16",6,10,12,22,22,"No",4,8,6,4
"6977","2017-10-16",4,17,11,28,20,"No",8,3,8,9
"6978","2017-10-16",6,13,7,20,20,"Yes",4,3,7,6
"6979","2017-10-16",1,2,3,5,5,"Yes",1,2,1,1
"6980","2017-10-16",5,6,11,17,17,"Yes",7,4,2,4
"6981","2017-10-16",NA,12,130,142,NA,"No",58,72,4,8
"6982","2017-10-16",7,9,13,22,25,"No",5,8,6,3
"6983","2017-10-16",10,19,12,31,22,"No",4,8,9,10
"6984","2017-10-16",6,6,1,7,8,"Yes",0,1,4,2
"6985","2017-10-16",5,9,11,20,20,"Yes",7,4,4,5
"6986","2017-10-16",4,8,3,11,11,"Yes",2,1,5,3
"6987","2017-10-16",1,2,4,6,6,"Yes",1,3,1,1
"6988","2017-10-16",6,16,7,23,62,"No",2,5,12,4
"6989","2017-10-16",4,11,5,16,16,"No",5,0,4,7
"6990",NA,5,14,5,19,19,"Yes",2,3,9,5
"6991","2017-10-16",4,8,10,18,18,"Yes",6,4,4,4
"6992","2017-10-16",6,11,10,21,21,"Yes",1,9,6,5
"6993","2017-10-16",2,5,3,8,8,"Yes",1,2,4,1
"6994","2017-10-16",5,9,6,15,10,"Yes",4,2,7,2
"6995","2017-10-16",6,10,15,25,25,"Yes",5,10,4,6
"6996","2017-10-16",6,18,38,56,56,"No",16,22,7,11
"6997","2017-10-16",9,12,4,16,20,"No",2,2,9,3
"6998","2017-10-16",7,16,15,31,31,"Yes",6,9,7,9
"6999","2017-10-16",8,27,42,69,69,"No",19,23,11,16
"7000","2017-10-16",3,5,12,17,17,"No",6,6,3,2
"7001","2017-10-16",9,29,7,36,36,"No",2,5,15,14
"7002","2017-10-16",6,8,5,13,14,"Yes",2,3,4,4
"7003","2017-10-16",4,9,7,16,15,"Yes",4,3,4,5
"7004","2017-10-16",1,3,2,5,5,"No",1,1,2,1
"7005","2017-10-16",5,9,5,14,14,"Yes",2,3,6,3
"7006","2017-10-16",4,15,3,18,18,"Yes",1,2,5,10
"7007","2017-10-16",14,17,15,32,32,"Yes",6,9,9,8
"7008","2017-10-16",1,1,4,5,5,"No",1,3,0,1
"7009","2017-10-16",2,8,4,12,12,"Yes",1,3,4,4
"7010","2017-10-16",3,6,3,9,9,"Yes",1,2,3,3
"7011","2017-10-16",6,10,8,18,18,"No",5,3,5,5
"7012","2017-10-16",5,19,6,25,25,"Yes",2,4,9,10
"7013","2017-10-16",5,8,12,20,20,"Yes",5,7,5,3
"7014","2017-10-16",9,7,17,24,19,"No",5,12,4,3
"7015","2017-10-16",1,2,6,8,8,"No",4,2,1,1
"7016","2017-10-16",4,8,12,20,20,"Yes",4,8,4,4
"7017","2017-10-16",6,10,5,15,15,"Yes",5,0,8,2
"7018","2017-10-16",13,20,9,29,29,"Yes",4,5,10,10
"7019","2017-10-16",5,8,4,12,18,"No",3,1,4,4
"7020","2017-10-16",5,12,5,17,17,"Yes",3,2,5,7
"7021","2017-10-16",NA,39,0,39,NA,"Yes",NA,NA,30,9
"7022","2017-10-16",1,5,3,8,8,"No",1,2,2,3
"7023","2017-10-16",NA,240,60,300,NA,"No",30,30,120,120
"7024","2017-10-16",3,7,7,14,9,"Yes",1,6,4,3
"7025","2017-10-14",NA,140,45,185,NA,"No",20,25,70,70
"7026","2017-10-16",NA,3,45,48,NA,NA,20,25,1,2
"7027","2017-10-16",NA,0,0,0,NA,"No",NA,NA,NA,NA
"7028","2017-10-16",4,18,2,20,20,"No",0,2,10,8
"7029","2017-10-16",NA,60,20,80,NA,"No",10,10,30,30
"7030","2017-10-16",1,1,5,6,5,"Yes",2,3,0,1
"7031","2017-10-16",NA,295,80,375,NA,"No",30,50,125,170
"7032","2017-10-16",3,7,3,10,10,"Yes",1,2,5,2
"7033","2017-10-16",NA,35,0,35,NA,"Yes",NA,NA,15,20
"7034","2017-10-16",9,26,27,53,50,"Yes",12,15,8,18
"7035","2017-10-16",1,3,2,5,5,"Yes",1,1,1,2
"7036","2017-10-16",1,2,3,5,6,"Yes",3,0,1,1
"7037","2017-10-16",NA,104,58,162,NA,"Yes",20,38,35,69
"7038","2017-10-16",3,8,4,12,12,"Yes",1,3,4,4
"7039","2017-10-16",1,2,6,8,8,"Yes",2,4,1,1
"7040","2017-10-16",9,20,20,40,40,"Yes",10,10,15,5
"7041","2017-10-16",1,5,10,15,15,"No",6,4,2,3
"7042","2017-10-16",3,8,8,16,16,"Yes",3,5,4,4
"7043","2017-10-16",1,2,5,7,7,"Yes",3,2,1,1
"7044","2017-10-16",3,12,7,19,15,"Yes",1,6,6,6
"7045","2017-10-16",7,20,10,30,32,"Yes",5,5,12,8
"7046","2017-10-16",5,11,8,19,19,"Yes",5,3,5,6
"7047","2017-10-16",1,5,0,5,5,"Yes",0,0,1,4
"7048","2017-10-16",7,18,11,29,27,"No",4,7,10,8
"7049","2017-10-16",4,8,16,24,24,"Yes",7,9,4,4
"7050","2017-10-16",6,16,22,38,38,"No",9,13,7,9
"7051","2017-10-16",6,13,16,29,26,"Yes",9,7,5,8
"7052","2017-10-16",7,8,8,16,16,"Yes",2,6,4,4
"7053","2017-10-16",3,6,6,12,12,"Yes",1,5,2,4
"7054","2017-10-16",2,5,5,10,10,"Yes",4,1,2,3
"7055","2017-10-16",4,8,5,13,10,"Yes",3,2,4,4
"7056","2017-10-16",NA,100,0,100,NA,"Yes",NA,NA,50,50
"7057","2017-10-16",6,7,9,16,16,"No",2,7,4,3
"7058","2017-10-16",7,10,7,17,17,"Yes",1,6,5,5
"7059","2017-10-16",NA,330,0,330,NA,"Yes",NA,NA,80,250
"7060","2017-10-16",2,4,6,10,10,"No",3,3,2,2
"7061","2017-10-16",5,14,9,23,22,"Yes",3,6,7,7
"7062","2017-10-16",6,11,8,19,19,"Yes",1,7,6,5
"7063","2017-10-16",7,8,5,13,13,"No",2,3,4,4
"7064","2017-10-16",NA,10,100,110,NA,"No",45,55,4,6
"7065","2017-10-16",1,5,4,9,8,"Yes",NA,4,2,3
"7066","2017-10-16",7,11,10,21,23,"Yes",5,5,5,6
"7067","2017-10-16",5,8,9,17,17,"Yes",2,7,3,5
"7068","2017-10-16",3,6,3,9,9,"No",3,0,3,3
"7069","2017-10-16",5,15,11,26,26,"Yes",4,7,10,5
"7070","2017-10-16",6,16,9,25,25,"Yes",3,6,8,8
"7071","2017-10-16",4,8,13,21,21,"No",5,8,3,5
"7072","2017-10-17",4,8,6,14,11,"No",2,4,4,4
"7073","2017-10-17",3,6,9,15,15,"Yes",1,8,3,3
"7074","2017-10-17",4,10,14,24,24,"Yes",3,11,6,4
"7075","2017-10-17",1,4,4,8,8,"Yes",1,3,2,2
"7076","2017-10-17",NA,91,41,132,NA,"No",20,21,56,35
"7077","2017-10-17",6,11,6,17,22,"No",2,4,5,6
"7078","2017-10-17",7,14,7,21,21,"Yes",3,4,6,8
"7079","2017-10-17",2,10,11,21,21,"No",5,6,6,4
"7080","2017-10-17",5,14,10,24,24,"Yes",5,5,5,9
"7081","2017-10-17",4,7,5,12,12,"Yes",2,3,4,3
"7082","2017-10-17",5,10,10,20,20,"No",5,5,5,5
"7083","2017-10-17",8,13,7,20,20,"No",3,4,7,6
"7084","2017-10-17",NA,3,73,76,NA,"Yes",48,25,1,2
"7085","2017-10-17",3,8,4,12,15,"Yes",2,2,4,4
"7086","2017-10-17",4,9,14,23,23,"Yes",9,5,5,4
"7087","2017-10-16",1,5,4,9,9,"Yes",2,2,2,3
"7088","2017-10-17",6,12,18,30,30,"Yes",7,11,6,6
"7089","2017-10-17",2,3,3,6,6,"Yes",2,1,1,2
"7090","2017-10-17",4,8,4,12,12,"No",2,2,4,4
"7091","2017-10-17",6,11,13,24,25,"Yes",4,9,5,6
"7092","2017-10-17",3,7,10,17,16,"Yes",8,2,4,3
"7093","2017-10-17",3,16,5,21,21,"Yes",3,2,7,9
"7094","2017-10-17",3,6,13,19,21,"Yes",9,4,3,3
"7095","2017-10-17",7,13,13,26,25,"Yes",5,8,7,6
"7096","2017-10-17",3,6,10,16,16,"Yes",5,5,3,3
"7097","2017-10-17",1,5,4,9,8,"Yes",2,2,4,1
"7098","2017-10-17",1,2,5,7,7,"Yes",2,3,1,1
"7099","2017-10-17",2,6,6,12,12,"No",2,4,2,4
"7100","2017-10-17",5,9,21,30,26,"Yes",13,8,6,3
"7101","2017-10-17",4,10,8,18,18,"Yes",3,5,6,4
"7102","2017-10-17",1,2,5,7,7,"Yes",3,2,1,1
"7103","2017-10-17",4,8,16,24,18,"Yes",7,9,4,4
"7104","2017-10-17",4,9,10,19,20,"Yes",4,6,4,5
"7105","2017-10-17",5,11,19,30,30,"No",8,11,4,7
"7106","2017-10-17",4,8,6,14,14,"No",2,4,4,4
"7107","2017-10-17",8,8,12,20,20,"Yes",5,7,5,3
"7108","2017-10-17",1,8,10,18,18,"Yes",8,2,3,5
"7109","2017-10-17",8,6,9,15,15,"Yes",5,4,3,3
"7110",NA,6,13,0,13,42,"Yes",NA,NA,6,7
"7111","2017-10-17",5,8,12,20,20,"Yes",5,7,5,3
"7112","2017-10-17",7,15,3,18,17,"No",1,2,7,8
"7113","2017-10-17",12,21,21,42,42,"Yes",6,15,9,12
"7114","2017-10-17",5,10,7,17,15,"No",2,5,5,5
"7115","2017-10-17",1,7,2,9,9,"No",0,2,4,3
"7116","2017-10-17",2,4,4,8,8,"Yes",1,3,2,2
"7117","2017-10-17",3,6,5,11,11,"Yes",NA,5,3,3
"7118","2017-10-17",3,6,11,17,17,"Yes",4,7,3,3
"7119","2017-10-17",4,15,18,33,33,"Yes",8,10,9,6
"7120","2017-10-17",2,4,4,8,8,"No",1,3,2,2
"7121","2017-10-17",3,7,5,12,12,"Yes",3,2,4,3
"7122","2017-10-17",5,5,10,15,18,"Yes",4,6,2,3
"7123","2017-10-17",7,16,11,27,27,"No",8,3,8,8
"7124","2017-10-17",5,6,4,10,10,"No",2,2,3,3
"7125","2017-10-17",2,9,6,15,15,"Yes",3,3,4,5
"7126","2017-10-17",10,14,6,20,20,"Yes",2,4,10,4
"7127","2017-10-17",6,10,10,20,20,"No",3,7,4,6
"7128","2017-10-17",14,19,25,44,46,"No",10,15,9,10
"7129","2017-10-17",5,12,12,24,28,"Yes",4,8,6,6
"7130","2017-10-17",7,14,7,21,25,"Yes",2,5,7,7
"7131","2017-10-17",7,13,11,24,24,"Yes",5,6,7,6
"7132","2017-10-17",9,19,11,30,30,"Yes",4,7,10,9
"7133","2017-10-17",9,21,9,30,30,"No",4,5,6,15
"7134","2017-10-17",6,18,17,35,35,"Yes",7,10,6,12
"7135","2017-10-17",6,12,18,30,30,"No",8,10,5,7
"7136","2017-10-17",3,7,5,12,13,"No",2,3,3,4
"7137","2017-10-17",1,5,4,9,9,"No",0,4,3,2
"7138","2017-10-17",4,7,9,16,16,"Yes",6,3,4,3
"7139","2017-10-17",3,10,7,17,17,"No",3,4,7,3
"7140","2017-10-17",4,8,10,18,18,"No",3,7,4,4
"7141","2017-10-17",6,10,5,15,20,"Yes",3,2,5,5
"7142","2017-10-17",3,8,3,11,11,"Yes",3,0,6,2
"7143","2017-10-17",2,5,9,14,13,"Yes",7,2,2,3
"7144","2017-10-17",7,1,9,10,10,"Yes",7,2,1,0
"7145","2017-10-17",412,9,2,11,18,"No",1,1,4,5
"7146","2017-10-17",1,4,3,7,7,"Yes",1,2,2,2
"7147","2017-10-17",1,2,5,7,7,"No",2,3,1,1
"7148","2017-10-17",5,14,11,25,25,"Yes",6,5,7,7
"7149","2017-10-17",2,7,4,11,11,"Yes",3,1,2,5
"7150","2017-10-17",3,7,4,11,11,"Yes",1,3,3,4
"7151","2017-10-17",4,13,10,23,24,"No",3,7,8,5
"7152","2017-10-17",1,2,3,5,5,"Yes",1,2,1,1
"7153","2017-10-17",7,16,5,21,18,"Yes",2,3,7,9
"7154","2017-10-17",11,11,14,25,25,"Yes",7,7,3,8
"7155","2017-10-17",7,10,8,18,18,"Yes",5,3,6,4
"7156","2017-10-17",8,16,9,25,25,"Yes",5,4,7,9
"7157","2017-10-17",4,11,4,15,15,"Yes",2,2,5,6
"7158","2017-10-17",6,12,8,20,19,"No",3,5,6,6
"7159","2017-10-17",5,10,5,15,28,"Yes",2,3,4,6
"7160","2017-10-17",1,25,21,46,46,"No",9,12,10,15
"7161","2017-10-17",6,9,5,14,14,"No",NA,5,4,5
"7162","2017-10-17",6,8,7,15,14,"Yes",3,4,3,5
"7163","2017-10-17",7,15,7,22,19,"Yes",5,2,9,6
"7164","2017-10-17",5,10,7,17,17,"Yes",3,4,5,5
"7165","2017-10-17",7,13,10,23,23,"Yes",3,7,7,6
"7166","2017-10-17",4,10,0,10,10,"No",0,0,5,5
"7167","2017-10-17",4,9,9,18,18,"Yes",4,5,5,4
"7168","2017-10-17",4,11,1,12,12,"Yes",1,0,6,5
"7169","2017-10-17",6,19,20,39,29,"No",12,8,9,10
"7170","2017-10-17",4,8,8,16,16,"No",2,6,4,4
"7171","2017-10-17",5,13,5,18,18,"No",2,3,5,8
"7172","2017-10-17",6,12,6,18,16,"Yes",0,6,8,4
"7173","2017-10-17",NA,7,3,10,NA,"No",2,1,4,3
"7174","2017-10-17",8,17,10,27,27,"Yes",3,7,7,10
"7175","2017-10-17",4,10,6,16,16,"No",2,4,4,6
"7176","2017-10-17",4,12,8,20,20,"Yes",4,4,5,7
"7177","2017-10-17",6,5,10,15,15,"Yes",5,5,2,3
"7178","2017-10-17",NA,7,29,36,NA,"Yes",13,16,4,3
"7179","2017-10-17",4,8,4,12,12,"No",1,3,2,6
"7180","2017-10-17",8,16,30,46,54,"No",14,16,8,8
"7181","2017-10-17",3,6,7,13,13,"Yes",3,4,3,3
"7182","2017-10-17",5,12,4,16,15,"Yes",2,2,6,6
"7183","2017-10-17",8,18,20,38,48,"No",5,15,8,10
"7184","2017-10-17",8,15,10,25,25,"Yes",6,4,10,5
"7185","2017-10-17",3,10,8,18,18,"Yes",2,6,5,5
"7186","2017-10-17",1,3,4,7,7,"Yes",2,2,2,1
"7187","2017-10-17",2,6,3,9,9,"Yes",1,2,2,4
"7188","2017-10-17",4,9,13,22,22,"Yes",4,9,4,5
"7189","2017-10-17",5,10,15,25,25,"No",8,7,5,5
"7190","2017-10-17",4,10,21,31,14,"No",15,6,4,6
"7191","2017-10-17",4,9,5,14,13,"Yes",2,3,4,5
"7192","2017-10-16",2,7,8,15,15,"No",2,6,4,3
"7193","2017-10-17",2,6,2,8,8,"Yes",1,1,3,3
"7194","2017-10-17",4,6,8,14,14,"Yes",3,5,3,3
"7195","2017-10-17",6,8,10,18,18,"Yes",5,5,4,4
"7196","2017-10-17",2,8,10,18,16,"No",8,2,3,5
"7197","2017-10-17",5,14,4,18,18,"Yes",1,3,9,5
"7198","2017-10-17",5,6,7,13,13,"Yes",5,2,4,2
"7199","2017-10-17",7,19,21,40,24,"No",9,12,9,10
"7200","2017-10-17",4,8,2,10,12,"Yes",2,0,4,4
"7201","2017-10-17",6,10,6,16,20,"Yes",2,4,4,6
"7202","2017-10-14",1,6,4,10,11,"Yes",3,1,3,3
"7203","2017-10-17",4,6,7,13,13,"Yes",4,3,3,3
"7204","2017-10-17",1,2,3,5,5,"Yes",1,2,1,1
"7205","2017-10-17",3,7,1,8,8,"Yes",0,1,4,3
"7206","2017-10-17",5,11,4,15,14,"Yes",3,1,5,6
"7207","2017-10-17",4,8,2,10,10,"Yes",0,2,4,4
"7208","2017-10-17",6,14,11,25,25,"Yes",4,7,6,8
"7209","2017-10-17",5,10,10,20,20,"No",7,3,5,5
"7210","2017-10-17",5,7,8,15,15,"No",2,6,4,3
"7211","2017-10-16",5,11,5,16,15,"Yes",3,2,5,6
"7212","2017-10-17",5,12,9,21,21,"No",2,7,7,5
"7213","2017-10-17",10,21,6,27,NA,"Yes",1,5,13,8
"7214","2017-10-17",1,4,6,10,10,"Yes",3,3,2,2
"7215","2017-10-17",3,6,3,9,9,"Yes",1,2,2,4
"7216","2017-10-17",7,5,12,17,17,"Yes",7,5,3,2
"7217","2017-10-17",9,18,4,22,22,"No",1,3,9,9
"7218","2017-10-17",5,7,7,14,14,"No",2,5,3,4
"7219","2017-10-17",4,8,5,13,13,"Yes",2,3,6,2
"7220","2017-10-17",22,41,39,80,80,"Yes",15,24,22,19
"7221","2017-10-17",4,11,6,17,17,"Yes",0,6,5,6
"7222","2017-10-17",5,10,13,23,23,"Yes",5,8,5,5
"7223","2017-10-17",3,13,8,21,21,"No",3,5,6,7
"7224","2017-10-17",4,14,17,31,26,"Yes",8,9,5,9
"7225","2017-10-17",5,10,19,29,29,"Yes",13,6,5,5
"7226","2017-10-17",8,29,11,40,40,"Yes",5,6,20,9
"7227","2017-10-17",4,8,10,18,18,"Yes",4,6,4,4
"7228","2017-10-17",5,11,4,15,121,"No",2,2,3,8
"7229","2017-10-17",NA,0,0,0,NA,"No",NA,NA,NA,NA
"7230","2017-10-17",6,9,6,15,15,"Yes",2,4,6,3
"7231","2017-10-17",4,10,2,12,12,"Yes",1,1,3,7
"7232","2017-10-17",5,5,11,16,6,"Yes",5,6,4,1
"7233","2017-10-17",3,11,4,15,15,"Yes",1,3,4,7
"7234","2017-10-17",3,6,3,9,9,"Yes",1,2,3,3
"7235","2017-10-16",8,20,22,42,32,"No",7,15,8,12
"7236","2017-10-17",3,9,7,16,13,"Yes",4,3,3,6
"7237","2017-10-17",2,6,5,11,11,"Yes",1,4,2,4
"7238","2017-10-17",6,12,7,19,19,"No",3,4,5,7
"7239","2017-10-17",2,12,5,17,17,"Yes",2,3,5,7
"7240","2017-10-17",4,8,14,22,28,"No",8,6,4,4
"7241","2017-10-17",4,11,7,18,19,"No",4,3,5,6
"7242","2017-10-17",4,6,8,14,15,"Yes",6,2,3,3
"7243","2017-10-17",4,17,23,40,34,"Yes",19,4,6,11
"7244","2017-10-17",4,8,10,18,18,"Yes",4,6,4,4
"7245","2017-10-17",3,7,3,10,10,"Yes",1,2,2,5
"7246","2017-10-17",6,12,6,18,18,"Yes",2,4,6,6
"7247","2017-10-17",2,8,3,11,11,"Yes",1,2,3,5
"7248","2017-10-17",9,11,11,22,22,"No",5,6,6,5
"7249","2017-10-17",5,8,10,18,18,"No",2,8,4,4
"7250","2017-10-17",2,5,8,13,13,"No",3,5,2,3
"7251","2017-10-17",4,9,7,16,16,"Yes",3,4,4,5
"7252","2017-10-16",4,4,10,14,21,"Yes",4,6,2,2
"7253","2017-10-17",1,2,8,10,10,"No",2,6,1,1
"7254","2017-10-17",4,8,9,17,17,NA,3,6,4,4
"7255","2017-10-17",3,7,8,15,15,"Yes",3,5,3,4
"7256","2017-10-17",4,10,7,17,17,"No",5,2,5,5
"7257","2017-10-17",3,11,7,18,18,"Yes",2,5,6,5
"7258","2017-10-17",5,10,4,14,14,"No",1,3,5,5
"7259","2017-10-17",4,6,11,17,18,"No",3,8,4,2
"7260","2017-10-17",5,9,6,15,15,"Yes",3,3,5,4
"7261","2017-10-17",4,8,6,14,14,"Yes",3,3,4,4
"7262","2017-10-17",3,5,8,13,13,"Yes",4,4,2,3
"7263","2017-10-17",3,8,8,16,16,"Yes",2,6,5,3
"7264","2017-10-17",2,9,3,12,12,"No",1,2,4,5
"7265","2017-10-17",7,16,24,40,40,"Yes",9,15,9,7
"7266","2017-10-17",10,10,15,25,25,"Yes",10,5,5,5
"7267","2017-10-17",3,12,5,17,17,"Yes",1,4,3,9
"7268","2017-10-17",8,13,7,20,20,"Yes",3,4,8,5
"7269","2017-10-17",2,5,5,10,10,"Yes",3,2,2,3
"7270","2017-10-17",2,5,1,6,6,"Yes",1,NA,2,3
"7271","2017-10-17",1,5,4,9,9,"Yes",3,1,2,3
"7272","2017-10-17",4,6,7,13,13,"Yes",4,3,3,3
"7273","2017-10-17",NA,20,10,30,NA,"No",4,6,12,8
"7274","2017-10-17",4,12,9,21,21,"Yes",3,6,5,7
"7275","2017-10-17",9,19,4,23,23,"No",2,2,9,10
"7276","2017-10-17",3,6,8,14,14,"No",3,5,3,3
"7277","2017-10-17",8,12,3,15,15,"Yes",2,1,7,5
"7278","2017-10-17",5,10,12,22,22,"Yes",6,6,5,5
"7279","2017-10-17",8,16,9,25,25,"Yes",6,3,7,9
"7280","2017-10-17",8,18,13,31,31,"No",9,4,8,10
"7281","2017-10-17",4,10,8,18,18,"Yes",4,4,4,6
"7282","2017-10-17",4,10,5,15,15,"No",2,3,5,5
"7283","2017-10-17",3,6,5,11,21,"No",2,3,3,3
"7284","2017-10-17",4,8,22,30,30,"Yes",7,15,4,4
"7285","2017-10-17",3,5,9,14,14,"Yes",4,5,3,2
"7286","2017-10-17",4,13,4,17,17,"Yes",2,2,7,6
"7287","2017-10-17",4,11,13,24,24,"No",7,6,5,6
"7288","2017-10-17",NA,7,118,125,NA,"Yes",50,68,1,6
"7289","2017-10-17",1,6,1,7,7,"Yes",0,1,5,1
"7290","2017-10-17",2,4,1,5,5,"Yes",0,1,2,2
"7291","2017-10-17",2,5,4,9,12,"Yes",3,1,2,3
"7292","2017-10-17",4,7,5,12,12,"Yes",3,2,4,3
"7293","2017-10-17",3,4,6,10,10,"Yes",1,5,2,2
"7294","2017-10-17",NA,50,0,50,NA,"No",0,0,40,10
"7295","2017-10-17",6,24,39,63,72,"Yes",21,18,11,13
"7296","2017-10-17",1,2,3,5,5,"No",1,2,1,1
"7297","2017-10-24",4,11,4,15,19,"No",3,1,6,5
"7298","2017-10-17",6,10,3,13,13,"Yes",0,3,4,6
"7299","2017-10-17",1,5,4,9,10,"Yes",1,3,4,1
"7300","2017-10-17",3,21,23,44,44,"Yes",11,12,11,10
"7301","2017-10-17",6,13,8,21,21,"Yes",3,5,8,5
"7302","2017-10-17",1,5,3,8,8,"Yes",3,0,1,4
"7303","2017-10-17",1,3,0,3,3,"Yes",NA,NA,2,1
"7304","2017-10-17",4,8,8,16,16,"Yes",3,5,4,4
"7305","2017-10-17",4,7,10,17,17,"Yes",4,6,3,4
"7306","2017-10-17",5,10,10,20,20,"No",7,3,6,4
"7307","2017-10-17",6,9,9,18,18,"No",5,4,4,5
"7308","2017-10-24",5,10,11,21,21,"No",4,7,3,7
"7309","2017-10-17",4,4,8,12,15,"Yes",4,4,4,NA
"7310","2017-10-17",1,7,4,11,11,"Yes",1,3,4,3
"7311","2017-10-17",1,4,3,7,7,"Yes",2,1,2,2
"7312","2017-10-17",3,8,10,18,18,"No",2,8,4,4
"7313","2017-10-17",5,8,7,15,15,"No",3,4,3,5
"7314","2017-10-17",3,7,5,12,12,"Yes",3,2,3,4
"7315","2017-10-17",3,7,5,12,12,"Yes",2,3,3,4
"7316","2017-10-17",5,14,4,18,18,"Yes",2,2,9,5
"7317","2017-10-17",5,8,10,18,17,"No",4,6,3,5
"7318","2017-10-17",4,14,4,18,18,"Yes",3,1,5,9
"7319","2017-10-17",5,8,12,20,20,"No",8,4,3,5
"7320","2017-10-24",3,10,8,18,18,"No",4,4,6,4
"7321","2017-10-17",6,0,0,0,NA,"Yes",NA,NA,NA,NA
"7322","2017-10-17",3,6,8,14,14,"No",5,3,3,3
"7323","2017-10-17",1,2,3,5,5,"Yes",1,2,1,1
"7324","2017-10-17",2,4,5,9,8,"No",1,4,1,3
"7325","2017-10-17",NA,0,0,0,NA,"No",NA,NA,NA,NA
"7326","2017-10-17",3,6,2,8,8,"Yes",2,0,3,3
"7327","2017-10-17",3,11,8,19,19,"Yes",2,6,5,6
"7328","2017-10-17",NA,8,140,148,NA,"Yes",75,65,2,6
"7329","2017-10-17",3,7,8,15,15,"Yes",3,5,3,4
"7330","2017-10-17",8,16,14,30,30,"No",9,5,8,8
"7331","2017-10-17",4,8,8,16,17,"No",5,3,4,4
"7332","2017-10-17",7,14,11,25,25,"No",5,6,7,7
"7333","2017-10-17",5,10,17,27,27,"No",7,10,5,5
"7334","2017-10-17",3,5,0,5,5,"Yes",0,0,2,3
"7335","2017-10-17",NA,7,0,7,NA,"No",0,0,4,3
"7336",NA,3,9,5,14,14,"No",3,2,5,4
"7337","2017-10-17",2,4,3,7,7,"Yes",2,1,1,3
"7338","2017-10-17",NA,100,0,100,NA,"No",0,0,60,40
"7339","2017-10-17",2,10,2,12,12,"Yes",1,1,8,2
"7340","2017-10-17",3,8,11,19,19,"Yes",5,6,4,4
"7341","2017-10-17",4,12,0,12,12,"Yes",0,0,6,6
"7342","2017-10-17",5,10,14,24,24,"No",8,6,5,5
"7343","2017-10-17",2,2,5,7,7,"No",2,3,1,1
"7344","2017-10-17",1,2,3,5,5,"Yes",2,1,1,1
"7345","2017-10-17",2,5,5,10,10,"Yes",2,3,3,2
"7346","2017-10-17",3,2,12,14,14,"Yes",3,9,1,1
"7347","2017-10-17",7,12,6,18,18,"No",2,4,5,7
"7348","2017-10-17",NA,0,0,0,NA,"Yes",NA,NA,NA,NA
"7349","2017-10-17",4,14,7,21,21,"No",4,3,6,8
"7350","2017-10-17",NA,12,250,262,NA,"No",100,150,6,6
"7351","2017-10-17",2,4,5,9,9,"No",3,2,2,2
"7352","2017-10-17",5,9,11,20,20,"No",7,4,5,4
"7353","2017-10-17",2,4,5,9,9,"Yes",3,2,2,2
"7354","2017-10-17",3,7,9,16,16,"Yes",2,7,1,6
"7355","2017-10-17",4,10,10,20,17,"Yes",3,7,4,6
"7356","2017-10-17",4,8,16,24,24,"Yes",6,10,4,4
"7357","2017-10-17",4,5,7,12,12,"No",5,2,1,4
"7358","2017-10-17",1,2,0,2,2,"Yes",0,0,1,1
"7359","2017-10-17",NA,0,0,0,NA,"No",NA,NA,NA,NA
"7360","2017-10-17",NA,123,6,129,NA,"Yes",2,4,71,52
"7361","2017-10-17",4,6,0,6,6,"No",0,0,4,2
"7362","2017-10-17",3,4,4,8,8,"No",3,1,2,2
"7363","2017-10-17",4,10,11,21,21,"Yes",6,5,4,6
"7364","2017-10-17",4,10,5,15,15,"No",2,3,5,5
"7365","2017-10-17",3,5,4,9,9,"No",1,3,2,3
"7366","2017-10-17",6,18,15,33,32,"Yes",6,9,8,10
"7367","2017-10-17",3,6,5,11,11,"No",3,2,1,5
"7368","2017-10-17",4,7,5,12,12,"No",1,4,4,3
"7369","2017-10-17",3,3,7,10,10,"Yes",3,4,0,3
"7370","2017-10-17",3,4,5,9,9,"Yes",2,3,2,2
"7371","2017-10-17",4,6,12,18,18,"Yes",5,7,4,2
"7372","2017-10-17",1,2,3,5,5,"Yes",2,1,1,1
"7373","2017-10-17",3,5,5,10,10,"No",1,4,2,3
"7374","2017-10-17",1,8,2,10,10,"Yes",2,0,6,2
"7375","2017-10-17",3,5,4,9,9,"Yes",2,2,3,2
"7376","2017-10-17",1,4,2,6,6,"Yes",1,1,2,2
"7377","2017-10-17",1,7,9,16,16,"Yes",5,4,3,4
"7378","2017-10-17",4,10,9,19,19,"No",5,4,4,6
"7379","2017-10-17",3,8,11,19,16,"No",3,8,3,5
"7380","2017-10-17",6,12,2,14,12,"Yes",0,2,6,6
"7381","2017-10-17",4,17,6,23,23,"No",3,3,7,10
"7382","2017-10-17",3,4,5,9,9,"Yes",2,3,2,2
"7383","2017-10-17",5,0,0,0,NA,"Yes",NA,NA,NA,NA
"7384","2017-10-17",5,19,21,40,38,NA,13,8,9,10
"7385","2017-10-17",1,6,4,10,10,"Yes",1,3,4,2
"7386","2017-10-17",4,8,4,12,12,"Yes",2,2,4,4
"7387","2017-10-17",6,14,5,19,19,"Yes",3,2,6,8
"7388","2017-10-17",4,8,10,18,18,"Yes",6,4,4,4
"7389","2017-10-17",4,9,10,19,19,"Yes",7,3,4,5
"7390","2017-10-17",5,10,5,15,15,"Yes",3,2,5,5
"7391","2017-10-17",4,7,4,11,11,"Yes",3,1,3,4
"7392","2017-10-17",1,3,0,3,6,NA,NA,NA,1,2
"7393","2017-10-17",5,13,10,23,23,"No",6,4,4,9
"7394","2017-10-17",3,5,10,15,15,"Yes",4,6,3,2
"7395","2017-10-17",2,7,3,10,10,"Yes",1,2,4,3
"7396","2017-10-17",6,12,2,14,12,"Yes",2,0,6,6
"7397","2017-10-17",2,4,3,7,7,"Yes",2,1,3,1
"7398","2017-10-24",5,10,15,25,25,"No",5,10,6,4
"7399","2017-10-17",2,5,6,11,11,"No",2,4,1,4
"7400","2017-10-17",3,6,5,11,11,"No",3,2,3,3
"7401","2017-10-17",8,13,12,25,25,"Yes",4,8,3,10
"7402","2017-10-17",2,6,1,7,7,"Yes",NA,1,3,3
"7403","2017-10-17",1,5,2,7,7,"Yes",2,NA,2,3
"7404","2017-10-17",2,5,4,9,9,"No",2,2,2,3
"7405","2017-10-17",5,10,3,13,13,"Yes",1,2,6,4
"7406","2017-10-17",3,0,0,0,NA,"No",NA,NA,NA,NA
"7407","2017-10-17",1,6,3,9,9,"Yes",2,1,4,2
"7408","2017-10-17",4,10,10,20,28,"No",7,3,4,6
"7409","2017-10-17",4,10,2,12,12,"Yes",1,1,7,3
"7410","2017-10-17",6,11,9,20,20,"No",4,5,4,7
"7411","2017-10-17",3,6,5,11,11,"No",2,3,3,3
"7412","2017-10-17",7,0,0,0,NA,"Yes",NA,NA,NA,NA
"7413","2017-10-17",6,11,8,19,19,NA,3,5,8,3
"7414","2017-10-17",NA,0,0,0,NA,"No",NA,NA,NA,NA
"7415","2017-10-17",3,5,7,12,12,"Yes",5,2,2,3
"7416","2017-10-14",1,4,1,5,5,"No",0,1,1,3
"7417","2017-10-16",7,0,0,0,NA,"Yes",NA,NA,NA,NA
"7418","2017-10-16",2,7,9,16,15,"Yes",2,7,3,4
"7419","2017-10-16",5,12,14,26,25,"Yes",6,8,8,4
"7420","2017-10-16",4,0,0,0,NA,"Yes",NA,NA,NA,NA
"7421","2017-10-16",5,0,0,0,NA,"Yes",NA,NA,NA,NA
"7422","2017-10-16",5,10,15,25,25,"No",7,8,5,5
"7423","2017-10-16",16,11,7,18,18,"Yes",2,5,2,9
"7424","2017-10-16",7,13,5,18,18,"Yes",3,2,7,6
"7425","2017-10-16",5,7,10,17,17,"Yes",5,5,4,3
"7426","2017-10-16",6,5,9,14,14,"Yes",3,6,2,3
"7427","2017-10-16",5,9,7,16,16,"Yes",4,3,3,6
"7428","2017-10-16",3,5,3,8,8,"Yes",1,2,2,3
"7429","2017-10-16",6,9,6,15,15,"No",3,3,5,4
"7430","2017-10-16",1,2,3,5,5,"Yes",NA,3,1,1
"7431","2017-10-16",1,2,4,6,6,"Yes",3,1,1,1
"7432","2017-10-17",7,0,0,0,NA,"No",NA,NA,NA,NA
"7433","2017-10-14",4,8,12,20,20,"Yes",5,7,4,4
"7434","2017-10-17",5,0,0,0,NA,"No",NA,NA,NA,NA
"7435","2017-10-17",7,10,10,20,10,"No",4,6,4,6
"7436","2017-10-14",3,5,5,10,10,"Yes",1,4,3,2
"7437","2017-10-14",9,13,10,23,23,"Yes",4,6,7,6
"7438","2017-10-14",5,7,13,20,20,"No",9,4,2,5
"7439","2017-10-14",7,16,9,25,25,"No",5,4,8,8
"7440","2017-10-14",1,7,5,12,12,"Yes",2,3,3,4
"7441","2017-10-14",NA,2,3,5,NA,"No",1,2,1,1
"7442","2017-10-16",5,13,10,23,23,"Yes",6,4,4,9
"7443","2017-10-17",6,11,13,24,24,"No",4,9,5,6
"7444","2017-10-17",4,9,8,17,17,"Yes",3,5,5,4
"7445","2017-10-17",1,5,2,7,7,"No",1,1,2,3
"7446",NA,7,9,6,15,15,"No",3,3,3,6
"7447","2017-10-17",8,9,15,24,24,"Yes",9,6,5,4
"7448","2017-10-18",6,8,4,12,12,"No",2,2,4,4
"7449","2017-10-18",2,5,5,10,10,"No",1,4,2,3
"7450","2017-10-18",3,6,3,9,9,"Yes",1,2,5,1
"7451","2017-10-18",1,6,6,12,12,"Yes",6,NA,3,3
"7452","2017-10-18",6,11,11,22,22,"Yes",7,4,5,6
"7453","2017-10-18",2,3,3,6,6,"Yes",2,1,1,2
"7454","2017-10-18",9,13,20,33,31,"Yes",9,11,7,6
"7455","2017-10-18",3,6,8,14,14,"Yes",3,5,3,3
"7456","2017-10-18",4,0,0,0,NA,"No",NA,NA,NA,NA
"7457","2017-10-18",5,17,4,21,21,"Yes",2,2,9,8
"7458","2017-10-18",3,10,10,20,22,"Yes",4,6,2,8
"7459","2017-10-18",3,6,8,14,14,"No",3,5,3,3
"7460","2017-10-18",5,7,14,21,21,"No",6,8,4,3
"7461","2017-10-18",7,15,4,19,19,"Yes",0,4,10,5
"7462","2017-10-18",5,11,9,20,20,"Yes",4,5,5,6
"7463","2017-10-18",2,4,6,10,10,"No",4,2,2,2
"7464","2017-10-18",6,9,3,12,12,"Yes",1,2,5,4
"7465","2017-10-18",5,6,6,12,12,"No",1,5,3,3
"7466","2017-10-18",3,8,9,17,17,"No",4,5,3,5
"7467","2017-10-25",2,5,3,8,8,"Yes",2,1,2,3
"7468","2017-10-18",7,12,9,21,22,"Yes",5,4,4,8
"7469","2017-10-18",4,5,3,8,8,"Yes",0,3,4,1
"7470","2017-10-18",5,8,9,17,17,"Yes",3,6,5,3
"7471","2017-10-18",1,4,1,5,5,"Yes",0,1,3,1
"7472","2017-10-18",5,0,0,0,NA,"Yes",NA,NA,NA,NA
"7473","2017-10-18",17,32,18,50,50,"No",10,8,17,15
"7474","2017-10-18",7,12,7,19,19,"No",4,3,7,5
"7475","2017-10-18",2,7,1,8,8,"Yes",1,0,4,3
"7476","2017-10-18",1,2,7,9,9,"Yes",4,3,1,1
"7477","2017-10-18",4,11,7,18,18,"Yes",3,4,2,9
"7478","2017-10-18",5,10,5,15,15,"Yes",2,3,5,5
"7479","2017-10-18",1,2,4,6,6,"Yes",2,2,1,1
"7480","2017-10-18",4,5,5,10,15,"Yes",3,2,4,1
"7481","2017-10-18",3,5,8,13,13,"Yes",5,3,2,3
"7482","2017-10-18",3,5,4,9,9,"No",2,2,3,2
"7483","2017-10-18",1,5,5,10,10,"Yes",2,3,4,1
"7484","2017-10-18",5,10,8,18,18,"No",0,8,5,5
"7485","2017-10-18",1,2,5,7,7,"Yes",4,1,1,1
"7486","2017-10-18",7,12,10,22,22,"Yes",5,5,5,7
"7487","2017-10-18",3,6,7,13,12,"Yes",4,3,3,3
"7488","2017-10-18",5,10,15,25,25,"No",10,5,5,5
"7489","2017-10-18",7,14,5,19,19,"No",2,3,7,7
"7490","2017-10-18",2,3,4,7,7,"Yes",1,3,1,2
"7491","2017-10-18",3,6,11,17,17,"No",7,4,3,3
"7492","2017-10-18",3,4,5,9,9,"No",3,2,1,3
"7493","2017-10-18",4,8,12,20,20,"No",6,6,4,4
"7494","2017-10-18",6,7,13,20,20,"No",6,7,4,3
"7495","2017-10-18",1,5,1,6,6,"Yes",1,0,3,2
"7496","2017-10-18",1,1,3,4,4,"Yes",2,1,1,NA
"7497","2017-10-18",2,4,11,15,15,"No",6,5,2,2
"7498","2017-10-18",1,6,9,15,15,"Yes",5,4,3,3
"7499","2017-10-18",1,2,2,4,4,"Yes",1,1,NA,2
"7500","2017-10-18",2,6,5,11,11,"No",3,2,2,4
"7501","2017-10-18",2,5,2,7,7,"No",1,1,3,2
"7502","2017-10-18",3,6,10,16,16,"No",4,6,3,3
"7503","2017-10-18",3,9,6,15,15,NA,4,2,3,6
"7504","2017-10-18",1,10,3,13,8,"Yes",1,2,7,3
"7505","2017-10-18",1,2,1,3,3,"Yes",NA,1,1,1
"7506","2017-10-18",4,8,7,15,15,"No",2,5,5,3
"7507","2017-10-18",1,6,0,6,6,"Yes",0,0,3,3
"7508","2017-10-18",1,4,8,12,12,"Yes",3,5,2,2
"7509","2017-10-18",2,4,4,8,8,"No",1,3,2,2
"7510","2017-10-18",1,4,3,7,7,"Yes",1,2,2,2
"7511","2017-10-18",2,4,6,10,10,"Yes",2,4,2,2
"7512","2017-10-18",3,6,14,20,20,"Yes",7,7,3,3
"7513","2017-10-18",5,17,16,33,23,"No",6,10,8,9
"7514","2017-10-18",3,6,3,9,9,"No",2,1,4,2
"7515","2017-10-18",2,2,4,6,6,"No",2,2,1,1
"7516","2017-10-18",4,8,5,13,13,"Yes",2,3,4,4
"7517","2017-10-18",3,3,8,11,11,"Yes",4,4,1,2
"7518","2017-10-18",2,9,5,14,14,"No",3,2,4,5
"7519","2017-10-18",4,8,9,17,17,"Yes",5,4,3,5
"7520","2017-10-14",3,7,6,13,15,"Yes",3,3,4,3
"7521","2017-10-14",5,6,5,11,12,"No",2,3,2,4
"7522","2017-10-14",7,12,9,21,23,"Yes",2,7,4,8
"7523","2017-10-14",4,5,4,9,10,"No",2,2,3,2
"7524","2017-10-14",5,11,9,20,23,"Yes",5,4,6,5
"7525","2017-10-14",3,5,5,10,17,"No",5,0,2,3
"7526","2017-10-18",3,8,12,20,20,"Yes",5,7,5,3
"7527","2017-10-18",2,4,0,4,4,"Yes",0,0,2,2
"7528","2017-10-18",2,6,3,9,9,"Yes",2,1,1,5
"7529","2017-10-18",4,12,5,17,17,"No",2,3,3,9
"7530","2017-10-18",4,8,9,17,17,"Yes",5,4,3,5
"7531","2017-10-18",7,14,12,26,26,"Yes",2,10,6,8
"7532","2017-10-18",5,12,7,19,19,"Yes",4,3,7,5
"7533","2017-10-17",2,5,9,14,14,"Yes",5,4,2,3
"7534","2017-10-17",6,7,15,22,22,"No",4,11,4,3
"7535","2017-10-17",4,10,9,19,19,"Yes",6,3,5,5
"7536","2017-10-17",4,11,4,15,15,"Yes",2,2,4,7
"7537","2017-10-17",7,14,10,24,24,"Yes",4,6,5,9
"7538","2017-10-17",5,7,6,13,13,"No",3,3,3,4
"7539","2017-10-17",7,11,4,15,15,"Yes",1,3,5,6
"7540","2017-10-19",2,11,5,16,16,"Yes",2,3,6,5
"7541","2017-10-19",3,7,7,14,14,"Yes",5,2,5,2
"7542","2017-10-19",4,6,3,9,9,"Yes",NA,3,2,4
"7543","2017-10-19",4,10,9,19,19,"No",7,2,3,7
"7544","2017-10-19",4,8,15,23,24,"Yes",3,12,4,4
"7545","2017-10-17",6,12,8,20,20,"No",3,5,6,6
"7546","2017-10-17",5,10,8,18,18,"Yes",6,2,5,5
"7547","2017-10-17",5,10,11,21,21,"Yes",5,6,5,5
"7548","2017-10-19",5,22,11,33,36,"No",6,5,13,9
"7549","2017-10-19",2,4,11,15,17,"Yes",1,10,2,2
"7550","2017-10-17",5,10,11,21,21,"Yes",5,6,6,4
"7551","2017-10-19",1,3,3,6,6,"Yes",1,2,1,2
"7552","2017-10-19",1,4,8,12,12,"Yes",3,5,2,2
"7553","2017-10-16",NA,180,100,280,NA,"Yes",50,50,90,90
"7554","2017-10-16",NA,100,50,150,NA,"No",25,25,50,50
"7555","2017-10-19",1,5,4,9,9,"Yes",1,3,3,2
"7556","2017-10-19",2,7,2,9,9,"Yes",0,2,3,4
"7557","2017-10-17",6,11,11,22,22,"Yes",4,7,6,5
"7558","2017-10-19",1,6,14,20,24,"Yes",8,6,2,4
"7559","2017-10-17",5,10,9,19,19,"No",5,4,4,6
"7560","2017-10-19",1,10,7,17,17,"Yes",3,4,6,4
"7561","2017-10-17",1,3,1,4,4,"No",1,0,1,2
"7562","2017-10-17",4,18,7,25,27,"Yes",5,2,10,8
"7563","2017-10-17",7,14,13,27,29,"No",5,8,5,9
"7564","2017-10-18",1,8,3,11,12,"Yes",2,1,4,4
"7565","2017-10-16",1,15,14,29,45,"Yes",5,9,10,5
"7566","2017-10-18",3,10,7,17,19,"Yes",5,2,7,3
"7567","2017-10-16",2,8,7,15,19,"Yes",4,3,5,3
"7568","2017-10-17",6,11,5,16,16,"Yes",3,2,6,5
"7569","2017-10-18",5,8,3,11,14,"Yes",3,0,3,5
"7570","2017-10-17",7,14,7,21,25,"No",4,3,9,5
"7571","2017-10-17",5,11,9,20,23,"No",6,3,5,6
"7572","2017-10-18",NA,0,0,0,NA,"No",NA,NA,NA,NA
"7573","2017-10-17",5,11,8,19,19,"Yes",5,3,5,6
"7574","2017-10-16",4,10,7,17,18,"No",4,3,3,7
"7575","2017-10-16",4,12,11,23,23,"Yes",8,3,7,5
"7576","2017-10-18",2,6,3,9,9,"Yes",1,2,3,3
"7577","2017-10-19",3,40,0,40,28,"Yes",NA,NA,30,10
"7578","2017-10-16",6,9,7,16,16,"No",4,3,5,4
"7579","2017-10-16",12,18,7,25,26,"No",5,2,10,8
"7580","2017-10-17",5,13,10,23,23,"Yes",2,8,6,7
"7581","2017-10-17",8,14,11,25,26,"No",4,7,5,9
"7582","2017-10-17",10,18,11,29,31,NA,2,9,11,7
"7583","2017-10-17",3,7,2,9,9,"Yes",1,1,5,2
"7584","2017-10-17",3,10,7,17,19,"Yes",3,4,3,7
"7585","2017-10-18",2,10,1,11,10,"No",0,1,2,8
"7586","2017-10-17",5,9,4,13,15,"Yes",3,1,4,5
"7587","2017-10-17",3,11,1,12,15,"Yes",1,0,4,7
"7588","2017-10-17",5,11,7,18,19,"Yes",2,5,4,7
"7589","2017-10-17",4,6,5,11,12,"No",2,3,3,3
"7590","2017-10-17",4,20,9,29,36,"No",2,7,9,11
"7591","2017-10-18",4,9,5,14,16,"No",3,2,5,4
"7592","2017-10-18",1,2,5,7,8,"No",3,2,1,1
"7593","2017-10-17",5,10,6,16,17,"Yes",3,3,6,4
"7594","2017-10-18",5,9,9,18,18,"No",3,6,5,4
"7595","2017-10-18",4,11,9,20,21,"Yes",4,5,5,6
"7596","2017-10-17",5,13,5,18,20,"No",3,2,7,6
"7597","2017-10-17",6,13,8,21,26,"Yes",5,3,4,9
"7598","2017-10-18",6,13,11,24,29,"Yes",3,8,9,4
"7599","2017-10-14",2,4,2,6,6,"No",1,1,1,3
"7600","2017-10-18",5,10,8,18,23,"No",5,3,4,6
"7601","2017-10-18",3,9,9,18,18,"Yes",3,6,4,5
"7602","2017-10-16",6,13,11,24,26,"Yes",7,4,5,8
"7603","2017-10-17",5,12,5,17,21,"Yes",4,1,7,5
"7604","2017-10-17",4,7,4,11,8,"No",1,3,3,4
"7605","2017-10-17",4,7,4,11,14,"Yes",2,2,3,4
"7606","2017-10-17",6,14,4,18,23,"Yes",1,3,5,9
"7607","2017-10-18",4,11,9,20,20,"No",5,4,5,6
"7608","2017-10-17",5,7,13,20,17,"No",5,8,3,4
"7609","2017-10-16",5,2,14,16,21,"No",9,5,0,2
"7610","2017-10-17",5,11,8,19,19,"No",5,3,4,7
"7611","2017-10-18",4,7,6,13,14,"No",1,5,5,2
"7612","2017-10-17",5,10,8,18,16,"No",3,5,7,3
"7613","2017-10-17",6,12,8,20,23,"No",3,5,5,7
"7614","2017-10-17",3,5,5,10,13,"Yes",5,0,0,5
"7615","2017-10-17",6,13,11,24,24,"Yes",5,6,6,7
"7616","2017-10-16",3,3,3,6,7,"No",2,1,2,1
"7617","2017-10-16",5,15,19,34,33,"Yes",6,13,9,6
"7618","2017-10-17",2,3,4,7,10,"Yes",3,1,1,2
"7619","2017-10-18",2,5,4,9,11,"Yes",2,2,3,2
"7620","2017-10-18",3,7,5,12,14,"Yes",2,3,4,3
"7621","2017-10-17",6,22,11,33,36,"Yes",3,8,9,13
"7622","2017-10-18",NA,0,0,0,NA,"Yes",NA,NA,NA,NA
"7623","2017-10-16",8,19,13,32,35,"No",8,5,6,13
"7624","2017-10-17",2,6,8,14,14,"Yes",6,2,4,2
"7625","2017-10-17",3,9,5,14,12,"Yes",2,3,5,4
"7626","2017-10-18",6,12,11,23,24,"No",5,6,8,4
"7627","2017-10-18",4,9,4,13,13,"No",1,3,3,6
"7628","2017-10-18",2,7,7,14,14,"Yes",2,5,3,4
"7629","2017-10-14",2,5,5,10,8,"Yes",2,3,3,2
"7630","2017-10-14",12,13,7,20,20,"Yes",2,5,4,9
"7631","2017-10-19",5,10,4,14,14,"No",3,1,6,4
"7632","2017-10-19",2,4,2,6,6,"No",2,NA,2,2
"7633","2017-10-19",2,7,5,12,12,"Yes",2,3,4,3
"7634","2017-10-19",5,13,6,19,19,"No",3,3,7,6
"7635","2017-10-19",1,4,2,6,6,"No",2,NA,2,2
"7636","2017-10-19",9,14,11,25,24,"Yes",3,8,5,9
"7637","2017-10-19",2,5,4,9,10,"Yes",3,1,3,2
"7638","2017-10-19",5,15,6,21,21,"No",6,0,5,10
"7639","2017-10-19",7,14,16,30,30,"No",6,10,7,7
"7640","2017-10-19",3,7,4,11,11,"Yes",2,2,4,3
"7641","2017-10-19",8,15,8,23,23,"No",3,5,8,7
"7642","2017-10-19",5,12,11,23,23,"Yes",5,6,7,5
"7643","2017-10-19",NA,2,28,30,NA,"Yes",15,13,1,1
"7644","2017-10-19",2,4,4,8,8,"Yes",2,2,2,2
"7645","2017-10-19",2,4,4,8,8,"No",2,2,2,2
"7646","2017-10-19",1,4,2,6,6,"Yes",1,1,2,2
"7647","2017-10-19",3,6,3,9,9,"No",1,2,3,3
"7648","2017-10-19",5,10,4,14,14,"Yes",1,3,4,6
"7649","2017-10-19",NA,4,99,103,NA,"No",49,50,1,3
"7650","2017-10-19",4,8,9,17,17,"Yes",8,1,4,4
"7651","2017-10-19",4,6,9,15,15,"No",4,5,3,3
"7652","2017-10-12",3,10,5,15,15,"Yes",2,3,3,7
"7653","2017-10-19",6,14,12,26,26,"Yes",7,5,7,7
"7654","2017-10-19",5,10,15,25,25,"Yes",7,8,5,5
"7655","2017-10-19",NA,320,0,320,NA,"No",NA,NA,200,120
"7656","2017-10-19",4,9,6,15,16,"Yes",1,5,4,5
"7657","2017-10-19",4,5,2,7,7,"No",NA,2,2,3
"7658","2017-10-19",2,4,4,8,8,"No",1,3,2,2
"7659","2017-10-19",5,15,4,19,21,"Yes",1,3,10,5
"7660","2017-10-17",4,10,3,13,18,"Yes",2,1,5,5
"7661","2017-10-19",2,7,0,7,18,"No",NA,NA,1,6
"7662","2017-10-19",4,10,6,16,16,"Yes",2,4,4,6
"7663","2017-10-19",1,2,5,7,6,"Yes",2,3,1,1
"7664","2017-10-19",2,4,4,8,9,"Yes",3,1,2,2
"7665","2017-10-19",1,2,1,3,3,"No",1,0,1,1
"7666","2017-10-19",3,8,4,12,12,"Yes",1,3,3,5
"7667","2017-10-19",1,2,3,5,5,"No",0,3,1,1
"7668","2017-10-19",1,4,7,11,11,"Yes",2,5,1,3
"7669","2017-10-19",1,4,2,6,8,"No",2,0,1,3
"7670","2017-10-19",3,9,10,19,20,"No",3,7,4,5
"7671","2017-10-19",1,2,1,3,3,"Yes",1,NA,1,1
"7672","2017-10-19",3,10,0,10,23,"Yes",NA,NA,7,3
"7673","2017-10-19",1,4,2,6,6,"Yes",1,1,3,1
"7674","2017-10-19",NA,328,0,328,NA,"Yes",NA,NA,128,200
"7675","2017-10-19",1,10,0,10,10,"Yes",0,0,4,6
"7676","2017-10-19",NA,1,0,1,NA,"No",0,0,1,0
"7677","2017-10-19",NA,6,0,6,NA,"No",0,0,3,3
"7678","2017-10-17",1,1,3,4,4,"Yes",2,1,0,1
"7679","2017-10-19",4,16,17,33,38,"Yes",7,10,8,8
"7680","2017-10-19",3,6,5,11,12,"No",3,2,3,3
"7681","2017-10-19",2,4,8,12,12,"Yes",4,4,2,2
"7682","2017-10-19",2,7,4,11,11,"No",2,2,3,4
"7683","2017-10-19",1,2,0,2,2,"Yes",0,0,1,1
"7684","2017-10-19",1,3,2,5,5,"Yes",0,2,1,2
"7685","2017-10-19",5,79,14,93,20,"No",6,8,79,NA
"7686","2017-10-19",2,4,8,12,12,"Yes",6,2,2,2
"7687","2017-10-19",1,4,6,10,10,"Yes",5,1,3,1
"7688","2017-10-19",4,7,13,20,20,"Yes",5,8,3,4
"7689","2017-10-19",7,8,1,9,9,"Yes",NA,1,3,5
"7690","2017-10-19",2,9,2,11,10,"No",1,1,2,7
"7691","2017-10-19",7,9,7,16,16,"Yes",3,4,7,2
"7692","2017-10-19",2,6,4,10,12,"No",1,3,3,3
"7693","2017-10-19",3,8,12,20,20,"Yes",3,9,3,5
"7694","2017-10-19",1,2,7,9,9,"Yes",2,5,1,1
"7695","2017-10-19",1,4,5,9,10,"Yes",3,2,2,2
"7696","2017-10-19",4,11,5,16,16,"No",3,2,4,7
"7697","2017-10-19",6,12,12,24,24,"Yes",5,7,6,6
"7698","2017-10-19",1,6,1,7,7,"Yes",1,0,4,2
"7699","2017-10-19",4,6,3,9,7,"Yes",NA,3,4,2
"7700","2017-10-19",2,9,5,14,15,"Yes",2,3,6,3
"7701","2017-10-19",5,11,6,17,27,"Yes",3,3,6,5
"7702","2017-10-19",2,9,5,14,14,"Yes",2,3,4,5
"7703","2017-10-19",4,10,3,13,14,"Yes",2,1,4,6
"7704","2017-10-19",4,8,12,20,20,"No",6,6,4,4
"7705","2017-10-19",2,4,8,12,12,"Yes",3,5,2,2
"7706","2017-10-19",4,10,5,15,15,"Yes",2,3,5,5
"7707","2017-10-19",5,6,4,10,10,NA,2,2,3,3
"7708","2017-10-19",NA,0,360,360,NA,"Yes",200,160,NA,NA
"7709","2017-10-19",15,25,23,48,32,"Yes",10,13,14,11
"7710","2017-10-19",3,7,10,17,18,"Yes",6,4,2,5
"7711","2017-10-19",1,4,1,5,5,"Yes",1,0,1,3
"7712","2017-10-19",1,3,1,4,4,"Yes",1,0,2,1
"7713","2017-10-19",2,4,6,10,10,"Yes",3,3,3,1
"7714","2017-10-19",2,6,4,10,10,"Yes",2,2,3,3
"7715","2017-10-19",2,8,7,15,15,"No",3,4,3,5
"7716","2017-10-19",5,10,25,35,35,"Yes",10,15,5,5
"7717","2017-10-19",3,8,6,14,14,"Yes",3,3,2,6
"7718","2017-10-19",2,4,4,8,8,"Yes",2,2,2,2
"7719","2017-10-19",4,8,8,16,18,"No",2,6,4,4
"7720","2017-10-19",1,2,6,8,8,"Yes",3,3,1,1
"7721","2017-10-19",1,2,2,4,4,"Yes",1,1,1,1
"7722","2017-10-19",3,10,14,24,23,"Yes",4,10,5,5
"7723","2017-10-19",2,6,2,8,8,"Yes",1,1,2,4
"7724","2017-10-19",2,3,1,4,4,"Yes",1,0,2,1
"7725","2017-10-19",2,4,3,7,7,"No",1,2,2,2
"7726","2017-10-19",7,14,16,30,30,"No",6,10,7,7
"7727","2017-10-19",4,9,8,17,17,"Yes",4,4,3,6
"7728","2017-10-19",1,1,1,2,2,"Yes",1,0,0,1
"7729",NA,2,7,3,10,10,"Yes",1,2,4,3
"7730","2017-10-19",2,4,4,8,8,"Yes",2,2,2,2
"7731","2017-10-19",5,6,6,12,12,"Yes",4,2,3,3
"7732","2017-10-19",4,8,10,18,18,"Yes",6,4,4,4
"7733","2017-10-19",4,6,8,14,14,"Yes",4,4,3,3
"7734","2017-10-19",1,4,1,5,6,"Yes",0,1,3,1
"7735","2017-10-19",5,8,7,15,16,"Yes",4,3,3,5
"7736","2017-10-19",1,2,3,5,5,"Yes",3,0,1,1
"7737","2017-10-12",2,6,5,11,11,"No",3,2,1,5
"7738","2017-10-19",1,5,1,6,8,"Yes",1,0,3,2
"7739","2017-10-19",3,6,2,8,8,"Yes",2,NA,3,3
"7740","2017-10-19",2,4,7,11,12,"Yes",5,2,2,2
"7741","2017-10-19",1,2,5,7,7,"No",2,3,1,1
"7742","2017-10-19",4,8,7,15,15,"Yes",5,2,4,4
"7743","2017-10-19",2,8,5,13,14,"No",2,3,6,2
"7744","2017-10-19",1,3,4,7,8,"Yes",1,3,1,2
"7745","2017-10-19",1,4,2,6,6,"Yes",1,1,2,2
"7746","2017-10-19",1,2,5,7,7,"Yes",0,5,1,1
"7747","2017-10-19",1,3,2,5,5,"Yes",1,1,2,1
"7748","2017-10-19",1,5,5,10,10,"No",3,2,2,3
"7749","2017-10-19",7,14,16,30,30,"Yes",8,8,7,7
"7750","2017-10-19",1,2,8,10,10,"No",3,5,1,1
"7751","2017-10-19",3,7,7,14,15,"No",2,5,3,4
"7752","2017-10-19",1,7,2,9,7,"Yes",1,1,4,3
"7753","2017-10-19",1,1,4,5,5,"Yes",3,1,1,NA
"7754","2017-10-19",1,3,4,7,7,"No",2,2,1,2
"7755","2017-10-19",NA,4,0,4,NA,"No",0,0,2,2
"7756","2017-10-19",4,8,8,16,16,"No",3,5,4,4
"7757","2017-10-18",3,4,10,14,14,"Yes",6,4,2,2
"7758","2017-10-19",4,14,6,20,20,"Yes",2,4,6,8
"7759","2017-10-19",8,15,11,26,16,"Yes",4,7,10,5
"7760","2017-10-19",4,10,6,16,16,"Yes",2,4,4,6
"7761","2017-10-19",4,8,12,20,20,"Yes",5,7,4,4
"7762","2017-10-19",3,6,6,12,14,"Yes",2,4,3,3
"7763","2017-10-19",1,6,3,9,9,"Yes",3,0,4,2
"7764","2017-10-19",4,7,8,15,13,"Yes",2,6,4,3
"7765","2017-10-19",3,8,8,16,16,"No",4,4,4,4
"7766","2017-10-19",8,13,10,23,31,"Yes",5,5,7,6
"7767","2017-10-19",3,8,0,8,8,"Yes",0,0,4,4
"7768","2017-10-19",12,20,11,31,41,"No",5,6,10,10
"7769","2017-10-19",4,7,1,8,8,"Yes",1,0,4,3
"7770","2017-10-19",NA,6,140,146,NA,"No",80,60,4,2
"7771","2017-10-19",2,3,5,8,8,"No",2,3,1,2
"7772","2017-10-19",1,5,4,9,9,"Yes",1,3,2,3
"7773","2017-10-19",3,7,10,17,19,"Yes",6,4,4,3
"7774","2017-10-19",6,10,5,15,15,"Yes",3,2,5,5
"7775","2017-10-19",3,6,4,10,10,"Yes",2,2,3,3
"7776","2017-10-19",6,12,4,16,16,"Yes",2,2,2,10
"7777","2017-10-19",3,5,3,8,8,"Yes",1,2,2,3
"7778","2017-10-19",4,12,8,20,20,"Yes",2,6,4,8
"7779","2017-10-26",1,2,3,5,5,"Yes",1,2,1,1
"7780","2017-10-19",2,4,7,11,11,"Yes",2,5,2,2
"7781","2017-10-19",3,5,5,10,10,"No",2,3,3,2
"7782","2017-10-19",2,2,3,5,5,"No",2,1,1,1
"7783","2017-10-19",6,9,5,14,14,"Yes",2,3,5,4
"7784","2017-10-19",7,11,14,25,25,"No",8,6,4,7
"7785","2017-10-19",3,6,3,9,9,"No",1,2,3,3
"7786","2017-10-19",3,12,5,17,16,"Yes",2,3,7,5
"7787","2017-10-19",3,8,2,10,10,"Yes",1,1,3,5
"7788","2017-10-19",7,11,4,15,15,"No",2,2,5,6
"7789","2017-10-19",2,6,3,9,9,"Yes",2,1,3,3
"7790","2017-10-19",5,12,11,23,23,"Yes",4,7,6,6
"7791","2017-10-19",9,17,16,33,33,"Yes",8,8,8,9
"7792","2017-10-19",4,11,7,18,19,"Yes",4,3,4,7
"7793","2017-10-19",1,2,6,8,8,"Yes",1,5,1,1
"7794","2017-10-19",3,7,9,16,10,"Yes",6,3,3,4
"7795","2017-10-19",7,10,22,32,32,"Yes",10,12,5,5
"7796","2017-10-19",4,5,5,10,10,"Yes",1,4,3,2
"7797","2017-10-19",9,11,11,22,22,"Yes",6,5,8,3
"7798","2017-10-19",1,5,1,6,6,"Yes",1,0,3,2
"7799","2017-10-19",2,3,2,5,7,"No",1,1,0,3
"7800","2017-10-19",1,4,6,10,7,"No",5,1,1,3
"7801","2017-10-19",2,6,3,9,9,"Yes",3,NA,3,3
"7802","2017-10-19",4,5,7,12,12,"Yes",4,3,2,3
"7803","2017-10-19",7,13,11,24,23,"Yes",6,5,6,7
"7804","2017-10-19",1,2,8,10,10,"Yes",3,5,1,1
"7805","2017-10-19",2,6,3,9,11,"No",1,2,2,4
"7806","2017-10-19",2,4,4,8,10,"Yes",2,2,2,2
"7807","2017-10-19",1,7,4,11,10,"Yes",2,2,2,5
"7808","2017-10-19",4,8,12,20,20,"Yes",6,6,4,4
"7809","2017-10-19",2,4,4,8,8,"Yes",1,3,2,2
"7810","2017-10-19",3,14,4,18,18,"Yes",2,2,6,8
"7811","2017-10-19",7,12,18,30,30,"No",8,10,8,4
"7812","2017-10-19",5,10,5,15,16,"Yes",2,3,5,5
"7813","2017-10-19",7,13,3,16,23,"No",1,2,7,6
"7814","2017-10-19",7,14,9,23,25,"Yes",4,5,7,7
"7815","2017-10-19",1,7,5,12,12,"No",2,3,3,4
"7816","2017-10-19",1,5,2,7,6,"Yes",1,1,3,2
"7817","2017-10-19",1,4,3,7,7,"No",1,2,2,2
"7818","2017-10-19",3,8,3,11,13,"Yes",2,1,3,5
"7819","2017-10-19",2,4,3,7,7,"No",1,2,2,2
"7820","2017-10-19",3,7,2,9,9,"Yes",1,1,3,4
"7821","2017-10-19",4,6,5,11,11,"Yes",2,3,4,2
"7822","2017-10-19",3,12,7,19,18,"Yes",4,3,8,4
"7823","2017-10-19",3,4,4,8,9,"No",1,3,2,2
"7824","2017-10-19",1,4,0,4,4,"Yes",0,0,1,3
"7825","2017-10-19",4,8,5,13,13,"Yes",3,2,4,4
"7826","2017-10-19",NA,12,0,12,NA,"Yes",NA,NA,11,1
"7827","2017-10-19",4,9,7,16,16,"Yes",3,4,5,4
"7828","2017-10-19",3,9,11,20,15,"Yes",4,7,5,4
"7829","2017-10-19",2,5,7,12,12,"Yes",4,3,3,2
"7830","2017-10-19",4,9,18,27,27,"Yes",4,14,4,5
"7831","2017-10-19",6,12,5,17,17,"Yes",2,3,6,6
"7832","2017-10-19",6,2,4,6,5,"Yes",2,2,1,1
"7833","2017-10-19",8,11,2,13,19,"Yes",2,0,6,5
"7834","2017-10-17",1,5,3,8,8,"Yes",1,2,2,3
"7835","2017-10-19",1,3,3,6,7,"Yes",2,1,1,2
"7836","2017-10-19",6,10,7,17,17,"Yes",6,1,5,5
"7837",NA,3,9,7,16,16,"No",3,4,4,5
"7838","2017-10-19",1,2,6,8,3,"No",3,3,1,1
"7839","2017-10-19",10,12,8,20,20,"No",5,3,6,6
"7840","2017-10-19",2,3,6,9,9,"Yes",2,4,1,2
"7841","2017-10-19",5,10,15,25,25,"No",5,10,5,5
"7842","2017-10-19",3,8,3,11,11,"No",2,1,5,3
"7843","2017-10-19",1,3,3,6,4,"Yes",0,3,2,1
"7844","2017-10-19",2,4,8,12,12,"Yes",2,6,2,2
"7845","2017-10-19",2,4,3,7,7,"Yes",1,2,2,2
"7846","2017-10-19",2,4,2,6,6,"Yes",1,1,2,2
"7847","2017-10-19",2,5,4,9,9,"No",1,3,2,3
"7848","2017-10-19",2,4,4,8,8,"Yes",2,2,2,2
"7849","2017-10-19",1,2,4,6,6,"Yes",4,0,1,1
"7850","2017-10-19",4,10,8,18,14,"Yes",4,4,5,5
"7851","2017-10-19",3,6,7,13,13,"Yes",4,3,3,3
"7852","2017-10-19",2,4,4,8,8,"No",2,2,2,2
"7853","2017-10-19",1,1,3,4,4,"Yes",1,2,NA,1
"7854","2017-10-19",1,2,4,6,6,"Yes",1,3,1,1
"7855","2017-10-19",6,7,1,8,8,"No",0,1,4,3
"7856","2017-10-19",3,6,3,9,9,"Yes",1,2,3,3
"7857","2017-10-19",5,13,8,21,23,"No",5,3,8,5
"7858","2017-10-19",3,8,5,13,13,"No",4,1,5,3
"7859","2017-10-19",4,20,7,27,27,"No",3,4,10,10
"7860","2017-10-19",3,5,12,17,17,"Yes",1,11,3,2
"7861","2017-10-19",3,8,6,14,13,"Yes",3,3,6,2
"7862","2017-10-19",5,7,7,14,14,"Yes",7,0,5,2
"7863","2017-10-19",3,6,6,12,13,"Yes",2,4,3,3
"7864","2017-10-19",4,15,20,35,30,"Yes",12,8,8,7
"7865","2017-10-19",4,7,3,10,10,"No",2,1,4,3
"7866","2017-10-19",9,24,6,30,30,"No",2,4,14,10
"7867","2017-10-19",4,10,11,21,21,"No",6,5,1,9
"7868","2017-10-19",3,6,5,11,11,"No",2,3,3,3
"7869","2017-10-19",1,3,2,5,5,"No",1,1,2,1
"7870","2017-10-19",1,4,8,12,12,"No",6,2,2,2
"7871","2017-10-19",5,10,9,19,19,"No",4,5,5,5
"7872","2017-10-19",6,16,5,21,18,"No",2,3,9,7
"7873","2017-10-19",1,4,4,8,8,"Yes",1,3,2,2
"7874","2017-10-19",4,10,2,12,12,"Yes",1,1,6,4
"7875","2017-10-20",3,10,5,15,20,"Yes",5,0,4,6
"7876","2017-10-20",5,13,1,14,16,"No",1,0,8,5
"7877","2017-10-20",3,7,3,10,13,"Yes",1,2,4,3
"7878","2017-10-20",5,10,5,15,16,"No",3,2,5,5
"7879","2017-10-20",NA,7,200,207,NA,"No",120,80,5,2
"7880","2017-10-20",NA,44,17,61,NA,"No",6,11,16,28
"7881","2017-10-20",1,5,2,7,8,"Yes",1,1,3,2
"7882","2017-10-20",5,10,11,21,21,"No",5,6,5,5
"7883","2017-10-20",10,23,14,37,30,"Yes",6,8,9,14
"7884","2017-10-20",1,3,2,5,5,"Yes",1,1,1,2
"7885","2017-10-20",1,2,2,4,4,"No",2,0,1,1
"7886","2017-10-20",2,4,5,9,9,"Yes",2,3,1,3
"7887","2017-10-20",3,7,3,10,10,"No",1,2,3,4
"7888","2017-10-20",1,2,4,6,6,"Yes",1,3,1,1
"7889","2017-10-20",1,2,2,4,4,"Yes",1,1,1,1
"7890","2017-10-20",2,2,4,6,6,"Yes",2,2,NA,2
"7891","2017-10-20",7,7,0,7,7,"No",0,0,4,3
"7892","2017-10-20",3,6,4,10,10,"No",1,3,3,3
"7893","2017-10-20",2,7,8,15,16,"Yes",3,5,4,3
"7894","2017-10-20",3,7,5,12,12,"No",3,2,3,4
"7895","2017-10-20",1,6,7,13,10,"Yes",3,4,1,5
"7896","2017-10-20",3,9,3,12,12,"No",1,2,5,4
"7897","2017-10-20",1,3,2,5,5,"No",0,2,2,1
"7898","2017-10-20",2,4,2,6,6,"Yes",1,1,2,2
"7899","2017-10-20",7,12,7,19,16,"No",3,4,7,5
"7900","2017-10-20",2,4,4,8,8,"No",3,1,2,2
"7901","2017-10-20",6,12,8,20,20,"Yes",3,5,6,6
"7902","2017-10-19",1,3,5,8,10,"Yes",2,3,2,1
"7903","2017-10-19",4,0,0,0,5,"Yes",NA,NA,NA,NA
"7904","2017-10-20",1,5,1,6,6,"Yes",1,0,2,3
"7905","2017-10-20",NA,5,3,8,9,"Yes",1,2,2,3
"7906","2017-10-20",8,9,15,24,25,"Yes",5,10,4,5
"7907","2017-10-20",2,4,4,8,8,"Yes",3,1,3,1
"7908","2017-10-20",5,10,4,14,14,"Yes",3,1,6,4
"7909","2017-10-20",5,10,6,16,16,"No",2,4,5,5
"7910","2017-10-20",5,7,6,13,13,"Yes",3,3,5,2
"7911","2017-10-20",4,9,7,16,15,"Yes",4,3,5,4
"7912","2017-10-20",2,3,3,6,6,"Yes",1,2,1,2
"7913","2017-10-20",4,7,8,15,19,"No",3,5,4,3
"7914","2017-10-27",1,2,4,6,6,"No",2,2,1,1
"7915","2017-10-20",1,1,4,5,5,"Yes",4,NA,NA,1
"7916","2017-10-20",1,5,2,7,6,"Yes",0,2,2,3
"7917","2017-10-20",4,11,4,15,15,"Yes",2,2,5,6
"7918","2017-10-20",3,7,5,12,12,"Yes",2,3,3,4
"7919","2017-10-20",4,8,1,9,9,"Yes",0,1,4,4
"7920","2017-10-20",NA,24,190,214,NA,"No",70,120,12,12
"7921","2017-10-20",6,15,7,22,23,"Yes",4,3,8,7
"7922","2017-10-20",1,2,2,4,4,"No",1,1,1,1
"7923","2017-10-20",3,3,3,6,6,"Yes",1,2,1,2
"7924","2017-10-20",2,4,5,9,9,"Yes",2,3,2,2
"7925","2017-10-20",3,5,4,9,9,"Yes",1,3,1,4
"7926","2017-10-20",1,5,5,10,10,"Yes",3,2,1,4
"7927","2017-10-20",5,9,3,12,12,"Yes",2,1,4,5
"7928","2017-10-20",3,9,4,13,17,"No",2,2,5,4
"7929","2017-10-20",1,3,2,5,5,"No",2,0,2,1
"7930","2017-10-20",2,4,4,8,8,"Yes",1,3,2,2
"7931","2017-10-20",1,7,1,8,8,"Yes",0,1,3,4
"7932","2017-10-20",4,9,10,19,19,"Yes",3,7,4,5
"7933","2017-10-20",4,9,10,19,14,"Yes",4,6,5,4
"7934","2017-10-20",2,4,11,15,15,"Yes",8,3,2,2
"7935","2017-10-20",4,8,10,18,18,"Yes",5,5,4,4
"7936","2017-10-20",1,4,2,6,6,"Yes",1,1,3,1
"7937","2017-10-20",3,6,6,12,12,"Yes",4,2,3,3
"7938","2017-10-13",1,2,4,6,6,"Yes",1,3,1,1
"7939","2017-10-20",3,2,7,9,9,"Yes",2,5,1,1
"7940","2017-10-20",1,2,11,13,13,"Yes",6,5,1,1
"7941","2017-10-20",8,16,15,31,31,"No",5,10,10,6
"7942","2017-10-20",4,6,5,11,13,"No",3,2,4,2
"7943","2017-10-20",1,2,2,4,4,"Yes",1,1,1,1
"7944","2017-10-20",1,2,1,3,3,"Yes",1,0,1,1
"7945","2017-10-20",4,6,6,12,13,"No",3,3,3,3
"7946","2017-10-20",6,12,14,26,26,"Yes",5,9,6,6
"7947","2017-10-20",1,3,4,7,7,"Yes",2,2,2,1
"7948","2017-10-20",1,4,2,6,6,"No",1,1,2,2
"7949","2017-10-20",4,11,5,16,28,"Yes",3,2,5,6
"7950","2017-10-20",5,4,11,15,15,"No",5,6,2,2
"7951","2017-10-20",4,11,9,20,20,"Yes",3,6,4,7
"7952","2017-10-20",1,2,3,5,5,"No",2,1,1,1
"7953","2017-10-20",NA,11,6,17,NA,"Yes",2,4,5,6
"7954","2017-10-20",1,2,5,7,8,"No",2,3,1,1
"7955","2017-10-20",2,2,0,2,2,"No",NA,NA,2,NA
"7956","2017-10-20",4,7,5,12,12,"Yes",3,2,3,4
"7957","2017-10-20",1,2,0,2,2,"Yes",NA,NA,1,1
"7958","2017-10-20",3,8,8,16,16,"No",6,2,3,5
"7959","2017-10-20",1,5,1,6,6,"Yes",1,NA,2,3
"7960","2017-10-20",3,8,7,15,15,"No",4,3,3,5
"7961","2017-10-20",2,8,3,11,11,"Yes",1,2,3,5
"7962","2017-10-20",1,6,2,8,8,"Yes",1,1,4,2
"7963","2017-10-20",6,13,6,19,17,"Yes",2,4,4,9
"7964","2017-10-20",2,4,4,8,8,"No",3,1,2,2
"7965","2017-10-20",3,9,9,18,18,"Yes",6,3,7,2
"7966","2017-10-20",3,8,6,14,5,"Yes",2,4,5,3
"7967","2017-10-20",2,4,3,7,7,"Yes",1,2,2,2
"7968","2017-10-20",6,13,14,27,29,"Yes",5,9,6,7
"7969","2017-10-20",4,8,8,16,16,"Yes",3,5,4,4
"7970","2017-10-20",4,7,10,17,17,"Yes",7,3,3,4
"7971","2017-10-20",4,13,3,16,16,"Yes",1,2,6,7
"7972","2017-10-20",1,7,3,10,10,"Yes",1,2,3,4
"7973","2017-10-20",7,17,8,25,25,"Yes",5,3,7,10
"7974","2017-10-20",4,9,3,12,14,"Yes",0,3,5,4
"7975","2017-10-20",4,7,5,12,12,"Yes",1,4,4,3
"7976","2017-10-20",7,14,11,25,25,"Yes",6,5,7,7
"7977","2017-10-20",1,4,0,4,4,"Yes",0,0,2,2
"7978","2017-10-20",4,7,7,14,14,"Yes",2,5,3,4
"7979","2017-10-19",NA,2,6,8,NA,"No",3,3,1,1
"7980","2017-10-20",3,7,3,10,10,"Yes",2,1,4,3
"7981","2017-10-20",4,10,14,24,24,"Yes",5,9,5,5
"7982","2017-10-20",1,2,6,8,8,"Yes",2,4,1,1
"7983","2017-10-20",4,11,11,22,22,"Yes",5,6,4,7
"7984","2017-10-20",3,6,6,12,12,"Yes",2,4,3,3
"7985","2017-10-20",2,6,9,15,14,"No",2,7,2,4
"7986","2017-10-20",2,4,5,9,9,"Yes",2,3,2,2
"7987","2017-10-20",1,2,4,6,6,"No",3,1,1,1
"7988","2017-10-20",3,5,7,12,12,"Yes",4,3,2,3
"7989","2017-10-20",4,7,10,17,17,"Yes",6,4,2,5
"7990","2017-10-20",1,2,1,3,3,"No",1,0,1,1
"7991","2017-10-20",5,7,2,9,20,"No",0,2,2,5
"7992","2017-10-20",3,7,0,7,7,"No",0,0,3,4
"7993","2017-10-20",2,4,3,7,7,"No",1,2,3,1
"7994","2017-10-20",4,10,16,26,22,"Yes",11,5,4,6
"7995","2017-10-27",2,2,4,6,9,"Yes",2,2,1,1
"7996","2017-10-20",1,3,2,5,5,"No",1,1,2,1
"7997","2017-10-27",2,3,3,6,6,"Yes",1,2,0,3
"7998","2017-10-20",3,2,3,5,7,"Yes",2,1,NA,2
"7999","2017-10-20",4,12,6,18,18,NA,3,3,6,6
"8000","2017-10-20",3,6,3,9,11,"No",2,1,3,3
"8001","2017-10-20",4,9,6,15,15,"Yes",2,4,5,4
"8002","2017-10-20",1,2,2,4,4,"Yes",1,1,1,1
"8003","2017-10-20",4,16,8,24,22,"No",3,5,8,8
"8004","2017-10-20",1,4,2,6,6,"No",1,1,3,1
"8005","2017-10-20",1,7,5,12,12,"Yes",1,4,4,3
"8006","2017-10-20",3,10,7,17,17,"Yes",3,4,7,3
"8007","2017-10-20",2,3,2,5,5,"No",1,1,1,2
"8008","2017-10-20",7,15,5,20,20,"Yes",2,3,7,8
"8009","2017-10-20",3,7,6,13,13,"No",2,4,3,4
"8010","2017-10-20",1,3,1,4,4,"No",0,1,1,2
"8011","2017-10-20",12,19,16,35,56,"No",8,8,9,10
"8012","2017-10-20",2,8,6,14,14,"Yes",3,3,4,4
"8013","2017-10-20",3,4,4,8,8,"Yes",0,4,2,2
"8014","2017-10-20",1,6,2,8,7,"Yes",1,1,3,3
"8015","2017-10-20",2,9,4,13,13,"Yes",2,2,4,5
"8016","2017-10-20",1,2,0,2,2,"Yes",0,0,1,1
"8017","2017-10-20",1,2,8,10,10,"Yes",4,4,1,1
"8018","2017-10-20",1,6,1,7,8,"Yes",1,0,5,1
"8019","2017-10-20",1,2,8,10,8,"Yes",1,7,1,1
"8020","2017-10-20",2,4,6,10,10,"No",4,2,2,2
"8021","2017-10-20",3,6,1,7,7,NA,0,1,5,1
"8022","2017-10-20",1,2,5,7,7,"Yes",1,4,1,1
"8023","2017-10-20",2,5,4,9,9,"Yes",2,2,2,3
"8024","2017-10-20",1,3,1,4,4,"Yes",0,1,1,2
"8025","2017-10-20",6,16,10,26,26,"Yes",4,6,9,7
"8026","2017-10-20",1,2,8,10,10,"Yes",3,5,1,1
"8027","2017-10-20",2,4,5,9,9,"Yes",3,2,2,2
"8028","2017-10-20",6,9,4,13,14,"No",2,2,7,2
"8029","2017-10-20",2,5,3,8,9,"Yes",2,1,2,3
"8030","2017-10-20",3,9,3,12,14,"No",1,2,3,6
"8031","2017-10-20",NA,2,1,3,1,"Yes",1,0,1,1
"8032","2017-10-20",2,11,4,15,15,"Yes",2,2,7,4
"8033","2017-10-20",5,15,17,32,25,"Yes",7,10,8,7
"8034","2017-10-20",1,4,2,6,6,"Yes",1,1,2,2
"8035","2017-10-20",2,4,7,11,8,"No",2,5,2,2
"8036","2017-10-20",1,4,0,4,3,"Yes",0,0,2,2
"8037","2017-10-20",2,8,2,10,11,"Yes",1,1,4,4
"8038","2017-10-20",1,7,2,9,9,"Yes",0,2,3,4
"8039","2017-10-20",3,8,1,9,9,"No",0,1,4,4
"8040","2017-10-20",3,8,9,17,17,"No",5,4,3,5
"8041","2017-10-20",2,6,3,9,9,"No",0,3,2,4
"8042","2017-10-20",1,3,3,6,6,"Yes",1,2,2,1
"8043","2017-10-20",NA,2000,2000,4000,NA,"No",1000,1000,1000,1000
"8044","2017-10-20",1,4,6,10,8,"Yes",3,3,1,3
"8045","2017-10-20",2,4,6,10,12,"Yes",2,4,2,2
"8046","2017-10-20",2,5,2,7,7,"No",1,1,2,3
"8047","2017-10-20",2,3,6,9,9,"No",3,3,1,2
"8048","2017-10-20",3,11,8,19,19,"Yes",5,3,4,7
"8049","2017-10-20",2,9,1,10,10,"Yes",0,1,4,5
"8050","2017-10-20",3,9,5,14,14,"Yes",3,2,3,6
"8051","2017-10-20",2,5,2,7,5,"Yes",1,1,2,3
"8052","2017-10-20",1,3,4,7,7,"Yes",2,2,1,2
"8053","2017-10-20",10,20,10,30,30,"No",6,4,12,8
"8054","2017-10-20",5,10,15,25,24,"No",6,9,5,5
"8055","2017-10-20",1,3,5,8,9,"Yes",3,2,2,1
"8056","2017-10-20",2,4,4,8,8,"Yes",1,3,2,2
"8057","2017-10-20",7,19,11,30,30,"No",5,6,8,11
"8058","2017-10-20",NA,8,130,138,NA,"No",50,80,2,6
"8059","2017-10-20",5,5,10,15,15,"Yes",4,6,2,3
"8060","2017-10-20",1,2,0,2,2,"Yes",0,0,1,1
"8061","2017-10-20",3,6,3,9,9,"No",1,2,3,3
"8062","2017-10-20",3,7,4,11,12,"Yes",2,2,3,4
"8063","2017-10-20",3,6,12,18,18,"Yes",5,7,3,3
"8064","2017-10-27",NA,5,270,275,NA,"No",145,125,2,3
"8065","2017-10-20",1,1,2,3,5,"Yes",1,1,NA,1
"8066","2017-10-20",1,7,2,9,9,"Yes",2,0,4,3
"8067","2017-10-20",3,4,3,7,7,"Yes",1,2,2,2
"8068","2017-10-20",1,3,2,5,4,"No",1,1,1,2
"8069","2017-10-20",5,5,8,13,14,"No",2,6,2,3
"8070","2017-10-20",1,4,4,8,8,"No",1,3,2,2
"8071","2017-10-20",2,3,2,5,5,"No",0,2,1,2
"8072","2017-10-20",4,10,8,18,18,"Yes",4,4,6,4
"8073","2017-10-20",2,5,4,9,10,"Yes",3,1,2,3
"8074","2017-10-20",5,10,15,25,25,"No",7,8,5,5
"8075","2017-10-20",2,9,3,12,12,"Yes",2,1,4,5
"8076","2017-10-20",3,5,5,10,14,"No",2,3,2,3
"8077","2017-10-20",1,6,0,6,7,"Yes",0,0,2,4
"8078","2017-10-20",3,7,5,12,9,"Yes",3,2,3,4
"8079","2017-10-20",5,8,8,16,16,"Yes",3,5,4,4
"8080","2017-10-20",1,2,3,5,5,"No",1,2,1,1
"8081","2017-10-20",2,7,2,9,9,"Yes",2,NA,3,4
"8082","2017-10-20",3,12,4,16,16,"Yes",1,3,6,6
"8083","2017-10-20",4,8,7,15,15,NA,4,3,4,4
"8084","2017-10-20",9,14,15,29,28,"Yes",7,8,6,8
"8085","2017-10-20",5,10,3,13,13,"Yes",0,3,5,5
"8086","2017-10-20",3,10,3,13,13,"Yes",1,2,7,3
"8087","2017-10-20",4,5,3,8,8,"No",2,1,3,2
"8088","2017-10-20",2,4,4,8,8,"Yes",2,2,2,2
"8089","2017-10-20",5,12,9,21,19,"No",6,3,6,6
"8090","2017-10-20",3,5,5,10,10,"Yes",3,2,2,3
"8091","2017-10-20",2,11,10,21,13,"Yes",5,5,5,6
"8092","2017-10-20",5,10,5,15,15,"No",3,2,5,5
"8093","2017-10-20",8,15,8,23,24,"Yes",3,5,7,8
"8094","2017-10-20",2,3,5,8,8,"No",4,1,1,2
"8095","2017-10-20",2,4,2,6,6,"Yes",2,NA,2,2
"8096","2017-10-20",2,6,5,11,10,"Yes",2,3,3,3
"8097","2017-10-20",1,6,0,6,6,"Yes",0,0,3,3
"8098","2017-10-20",1,6,4,10,3,"Yes",2,2,3,3
"8099","2017-10-20",1,2,0,2,2,"Yes",0,0,1,1
"8100","2017-10-20",4,6,4,10,11,"No",1,3,4,2
"8101","2017-10-20",3,6,4,10,10,"Yes",2,2,3,3
"8102","2017-10-20",1,3,5,8,8,"Yes",2,3,1,2
"8103","2017-10-20",5,14,2,16,16,"No",1,1,8,6
"8104","2017-10-20",2,4,5,9,9,"No",2,3,2,2
"8105","2017-10-20",1,2,3,5,7,"Yes",2,1,1,1
"8106","2017-10-20",1,1,4,5,5,"Yes",NA,4,1,NA
"8107","2017-10-20",6,10,4,14,14,"No",1,3,5,5
"8108","2017-10-20",10,21,16,37,42,"No",9,7,11,10
"8109","2017-10-20",6,17,8,25,27,"Yes",1,7,9,8
"8110","2017-10-20",6,10,5,15,19,"Yes",3,2,3,7
"8111","2017-10-20",1,2,4,6,6,"Yes",1,3,1,1
"8112","2017-10-20",1,8,0,8,4,"Yes",0,0,3,5
"8113","2017-10-20",2,4,8,12,12,"Yes",5,3,2,2
"8114","2017-10-20",1,3,4,7,7,"Yes",2,2,1,2
"8115","2017-10-20",1,4,4,8,8,"Yes",1,3,2,2
"8116",NA,4,5,12,17,17,"No",5,7,2,3
"8117","2017-10-20",2,4,3,7,7,"Yes",2,1,3,1
"8118","2017-10-20",7,24,52,76,78,"Yes",25,27,13,11
"8119","2017-10-20",1,3,0,3,3,"Yes",0,0,1,2
"8120","2017-10-20",7,19,10,29,34,"No",4,6,10,9
"8121","2017-10-20",1,2,10,12,12,"Yes",4,6,1,1
"8122","2017-10-20",3,4,4,8,8,"No",2,2,3,1
"8123","2017-10-20",3,8,8,16,16,"No",2,6,4,4
"8124","2017-10-20",3,6,8,14,14,"Yes",3,5,4,2
"8125","2017-10-20",2,2,4,6,8,"Yes",2,2,1,1
"8126","2017-10-20",1,2,5,7,7,"Yes",2,3,1,1
"8127","2017-10-20",3,8,8,16,15,"Yes",5,3,4,4
"8128","2017-10-20",1,2,3,5,5,"Yes",2,1,1,1
"8129","2017-10-20",2,4,4,8,8,"Yes",2,2,2,2
"8130","2017-10-20",1,2,2,4,4,"Yes",1,1,1,1
"8131","2017-10-20",2,2,2,4,4,"Yes",1,1,1,1
"8132","2017-10-20",4,8,0,8,8,"Yes",NA,NA,3,5
"8133","2017-10-20",2,5,7,12,6,"No",1,6,2,3
"8134","2017-10-20",5,15,11,26,27,"Yes",5,6,6,9
"8135","2017-10-20",3,4,5,9,9,"Yes",2,3,2,2
"8136","2017-10-20",4,8,11,19,19,"No",5,6,4,4
"8137","2017-10-20",7,11,10,21,24,"Yes",4,6,5,6
"8138","2017-10-20",2,3,6,9,9,"Yes",3,3,1,2
"8139","2017-10-20",3,6,6,12,12,"Yes",4,2,3,3
"8140","2017-10-20",1,4,4,8,9,"No",1,3,2,2
"8141","2017-10-27",3,8,1,9,10,"Yes",1,0,5,3
"8142","2017-10-20",4,8,4,12,16,"No",2,2,4,4
"8143","2017-10-20",4,15,8,23,27,"No",3,5,9,6
"8144","2017-10-20",8,16,18,34,34,"Yes",5,13,8,8
"8145","2017-10-20",1,2,3,5,5,"Yes",0,3,1,1
"8146","2017-10-20",1,3,2,5,5,"No",1,1,2,1
"8147","2017-10-20",4,10,8,18,18,"Yes",3,5,4,6
"8148","2017-10-20",1,2,4,6,6,"No",1,3,1,1
"8149","2017-10-20",1,5,1,6,6,"Yes",1,0,3,2
"8150","2017-10-20",3,35,11,46,19,"No",4,7,35,NA
"8151","2017-10-20",1,2,7,9,9,"No",3,4,1,1
"8152","2017-10-20",3,8,2,10,10,"No",1,1,3,5
"8153","2017-10-20",1,5,2,7,7,"Yes",1,1,2,3
"8154",NA,2,2,2,4,4,"Yes",1,1,1,1
"8155","2017-10-20",1,3,3,6,5,"Yes",1,2,2,1
"8156","2017-10-20",2,5,10,15,15,"No",3,7,3,2
"8157","2017-10-20",1,2,2,4,4,"Yes",1,1,1,1
"8158","2017-10-20",1,7,5,12,13,"Yes",3,2,3,4
"8159","2017-10-20",1,2,4,6,NA,"Yes",2,2,1,1
"8160","2017-10-20",2,11,5,16,13,"No",1,4,5,6
"8161","2017-10-20",4,9,5,14,NA,"Yes",2,3,4,5
"8162","2017-10-20",2,4,6,10,10,"Yes",2,4,2,2
"8163","2017-10-20",8,16,9,25,15,"Yes",6,3,8,8
"8164","2017-10-20",4,11,9,20,20,"No",4,5,5,6
"8165","2017-10-20",5,9,4,13,12,"Yes",1,3,5,4
"8166","2017-10-19",4,10,6,16,16,"Yes",3,3,5,5
"8167","2017-10-20",3,9,9,18,18,"No",4,5,3,6
"8168","2017-10-20",3,8,9,17,17,"Yes",4,5,3,5
"8169","2017-10-20",2,4,4,8,8,"Yes",1,3,2,2
"8170","2017-10-20",1,10,1,11,6,"Yes",1,0,5,5
"8171","2017-10-20",1,2,1,3,3,"Yes",0,1,1,1
"8172","2017-10-20",6,13,12,25,25,"No",4,8,6,7
"8173","2017-10-20",1,5,3,8,9,"Yes",3,0,1,4
"8174","2017-10-20",2,6,6,12,12,"Yes",2,4,3,3
"8175","2017-10-20",3,5,4,9,9,"No",2,2,3,2
"8176","2017-10-20",3,6,8,14,14,"No",5,3,3,3
"8177","2017-10-20",3,7,10,17,18,"No",6,4,3,4
"8178","2017-10-20",3,9,6,15,15,"Yes",2,4,4,5
"8179","2017-10-20",5,7,3,10,9,"Yes",2,1,3,4
"8180","2017-10-20",3,6,12,18,18,"No",6,6,3,3
"8181","2017-10-20",4,13,9,22,23,"No",5,4,7,6
"8182","2017-10-20",7,13,10,23,23,"No",7,3,8,5
"8183","2017-10-20",2,4,3,7,7,"Yes",0,3,2,2
"8184","2017-10-20",4,10,11,21,21,"Yes",4,7,5,5
"8185","2017-10-20",5,13,12,25,22,"Yes",9,3,6,7
"8186","2017-10-20",1,2,3,5,5,"Yes",2,1,1,1
"8187","2017-10-20",1,4,3,7,6,"No",1,2,1,3
"8188","2017-10-20",2,8,7,15,12,"No",6,1,3,5
"8189","2017-10-20",4,8,2,10,10,"Yes",1,1,4,4
"8190","2017-10-20",2,5,0,5,5,"Yes",0,0,2,3
"8191","2017-10-20",1,8,0,8,8,"Yes",0,0,2,6
"8192","2017-10-20",4,6,10,16,16,"No",5,5,3,3
"8193","2017-10-20",1,6,2,8,8,"Yes",0,2,4,2
"8194","2017-10-20",6,13,9,22,19,"Yes",3,6,6,7
"8195","2017-10-20",5,12,10,22,22,"Yes",6,4,6,6
"8196","2017-10-20",1,2,0,2,7,"Yes",NA,NA,1,1
"8197","2017-10-20",1,4,4,8,8,"Yes",1,3,3,1
"8198","2017-10-20",4,10,5,15,11,"No",4,1,8,2
"8199","2017-10-20",2,4,4,8,7,"Yes",1,3,2,2
"8200","2017-10-20",11,15,10,25,25,"No",5,5,8,7
"8201","2017-10-20",2,4,6,10,10,"Yes",0,6,2,2
"8202","2017-10-20",4,7,2,9,9,"Yes",1,1,4,3
"8203","2017-10-20",3,6,8,14,14,"Yes",3,5,3,3
"8204","2017-10-20",2,4,4,8,8,"Yes",1,3,2,2
"8205","2017-10-20",4,5,4,9,11,"No",2,2,3,2
"8206","2017-10-20",1,2,3,5,5,"Yes",2,1,1,1
"8207","2017-10-20",3,6,11,17,17,"Yes",4,7,3,3
"8208","2017-10-20",3,6,6,12,12,"Yes",3,3,4,2
"8209","2017-10-20",1,5,3,8,9,"No",2,1,3,2
"8210","2017-10-20",1,4,4,8,6,"Yes",2,2,2,2
"8211","2017-10-20",4,7,7,14,14,"No",2,5,4,3
"8212","2017-10-20",1,2,6,8,8,"Yes",3,3,1,1
"8213","2017-10-20",NA,200,0,200,NA,"No",NA,NA,100,100
"8214","2017-10-20",1,2,5,7,9,"Yes",2,3,1,1
"8215","2017-10-20",5,5,16,21,21,"Yes",7,9,2,3
"8216","2017-10-20",1,5,3,8,8,"Yes",1,2,3,2
"8217","2017-10-19",1,3,3,6,6,"Yes",1,2,2,1
"8218","2017-10-19",1,2,4,6,6,"Yes",3,1,1,1
"8219","2017-10-21",1,3,4,7,7,"No",2,2,1,2
"8220","2017-10-21",4,8,4,12,12,"Yes",1,3,4,4
"8221","2017-10-21",3,6,4,10,10,"Yes",3,1,3,3
"8222","2017-10-21",1,2,3,5,5,"Yes",2,1,1,1
"8223","2017-10-21",1,2,3,5,5,"Yes",1,2,1,1
"8224","2017-10-21",4,12,3,15,15,"Yes",3,0,7,5
"8225","2017-10-21",1,3,5,8,8,"Yes",2,3,1,2
"8226","2017-10-21",1,2,3,5,5,"Yes",3,0,0,2
"8227","2017-10-21",7,10,14,24,23,"No",6,8,4,6
"8228","2017-10-21",2,4,5,9,8,"Yes",3,2,2,2
"8229","2017-10-21",1,3,4,7,7,"Yes",2,2,1,2
"8230","2017-10-21",1,6,1,7,7,"Yes",0,1,3,3
"8231","2017-10-21",3,4,3,7,7,"Yes",1,2,2,2
"8232","2017-10-20",1,2,4,6,6,"Yes",2,2,1,1
"8233","2017-10-14",1,11,4,15,15,"Yes",3,1,6,5
"8234","2017-10-21",1,2,3,5,5,"No",1,2,1,1
"8235","2017-10-21",3,10,8,18,15,"Yes",3,5,5,5
"8236","2017-10-21",4,4,10,14,14,"No",5,5,3,1
"8237","2017-10-21",2,3,5,8,8,"No",3,2,1,2
"8238","2017-10-21",1,2,4,6,6,"Yes",3,1,1,1
"8239","2017-10-21",5,9,6,15,12,"Yes",0,6,4,5
"8240","2017-10-21",2,5,0,5,3,"Yes",0,0,2,3
"8241","2017-10-21",1,5,3,8,8,"No",1,2,3,2
"8242","2017-10-21",3,11,9,20,20,"No",3,6,4,7
"8243","2017-10-21",1,2,4,6,5,"No",1,3,1,1
"8244","2017-10-21",3,8,10,18,13,"Yes",1,9,3,5
"8245","2017-10-21",4,8,4,12,13,"Yes",2,2,5,3
"8246","2017-10-21",1,1,6,7,7,"Yes",2,4,0,1
"8247","2017-10-21",1,3,4,7,7,"Yes",1,3,1,2
"8248","2017-10-21",1,0,1,1,3,"No",1,0,NA,NA
"8249","2017-10-21",3,6,0,6,6,"Yes",0,0,3,3
"8250","2017-10-21",2,2,6,8,9,"Yes",3,3,1,1
"8251","2017-10-21",3,6,10,16,15,"Yes",6,4,3,3
"8252","2017-10-21",2,5,4,9,9,"No",NA,4,2,3
"8253","2017-10-21",2,6,3,9,9,"Yes",2,1,2,4
"8254","2017-10-21",2,6,3,9,11,"Yes",2,1,2,4
"8255","2017-10-21",4,12,9,21,21,"Yes",2,7,6,6
"8256","2017-10-21",3,9,2,11,9,"Yes",2,0,4,5
"8257","2017-10-21",1,2,3,5,5,"Yes",0,3,1,1
"8258","2017-10-21",1,2,3,5,5,"No",2,1,1,1
"8259","2017-10-21",4,7,7,14,14,"No",2,5,3,4
"8260","2017-10-21",1,8,4,12,12,"No",1,3,4,4
"8261","2017-10-21",1,2,3,5,5,"Yes",2,1,1,1
"8262","2017-10-21",6,11,4,15,28,"No",2,2,5,6
"8263","2017-10-27",5,9,13,22,20,"No",3,10,3,6
"8264","2017-10-21",1,2,2,4,4,"Yes",0,2,1,1
"8265","2017-10-21",1,1,7,8,8,"Yes",3,4,0,1
"8266","2017-10-21",3,6,7,13,13,"Yes",3,4,3,3
"8267","2017-10-21",1,2,3,5,5,"Yes",1,2,1,1
"8268","2017-10-21",4,11,4,15,19,"Yes",3,1,4,7
"8269","2017-10-21",1,5,4,9,9,"No",1,3,2,3
"8270","2017-10-21",3,7,6,13,13,"No",NA,6,4,3
"8271","2017-10-21",6,9,6,15,15,"Yes",5,1,5,4
"8272","2017-10-21",1,1,2,3,3,"Yes",1,1,0,1
"8273","2017-10-21",2,2,7,9,9,"No",4,3,1,1
"8274","2017-10-21",8,13,3,16,16,"Yes",2,1,6,7
"8275","2017-10-21",1,2,3,5,4,"Yes",0,3,1,1
"8276","2017-10-21",5,11,6,17,18,"Yes",4,2,4,7
"8277","2017-10-21",4,9,2,11,11,"Yes",1,1,8,1
"8278","2017-10-21",4,8,6,14,17,"Yes",1,5,5,3
"8279","2017-10-21",1,5,3,8,8,"No",2,1,2,3
"8280","2017-10-21",1,6,2,8,8,"Yes",0,2,4,2
"8281","2017-10-21",5,5,13,18,18,"No",5,8,2,3
"8282","2017-10-21",3,6,2,8,8,"Yes",0,2,4,2
"8283","2017-10-21",3,20,17,37,8,"No",12,5,8,12
"8284","2017-10-21",NA,60,30,90,NA,"No",10,20,20,40
"8285","2017-10-21",10,17,13,30,32,"Yes",7,6,9,8
"8286","2017-10-21",1,7,5,12,12,"Yes",3,2,2,5
"8287","2017-10-28",3,4,4,8,9,"Yes",3,1,2,2
"8288","2017-10-21",5,16,4,20,22,"Yes",1,3,9,7
"8289","2017-10-21",7,14,9,23,23,"Yes",2,7,7,7
"8290","2017-10-21",2,5,6,11,11,"No",3,3,3,2
"8291","2017-10-21",1,4,4,8,8,"Yes",1,3,2,2
"8292","2017-10-21",3,7,4,11,8,"Yes",3,1,5,2
"8293","2017-10-21",1,2,5,7,7,"Yes",2,3,1,1
"8294","2017-10-21",3,10,3,13,12,"Yes",1,2,4,6
"8295",NA,2,3,8,11,11,"Yes",1,7,1,2
"8296","2017-10-21",1,4,1,5,5,"No",0,1,2,2
"8297","2017-10-21",3,5,4,9,8,"Yes",3,1,3,2
"8298","2017-10-21",4,12,6,18,18,"Yes",3,3,8,4
"8299","2017-10-21",1,28,4,32,8,"Yes",NA,4,20,8
"8300","2017-10-21",2,3,3,6,6,"Yes",1,2,2,1
"8301","2017-10-21",1,2,1,3,3,"Yes",0,1,1,1
"8302","2017-10-21",3,4,5,9,9,"Yes",3,2,1,3
"8303","2017-10-21",5,10,9,19,19,"Yes",5,4,5,5
"8304","2017-10-20",1,2,3,5,5,"Yes",1,2,1,1
"8305","2017-10-21",1,4,2,6,6,"Yes",1,1,2,2
"8306","2017-10-28",4,7,7,14,21,"Yes",3,4,3,4
"8307","2017-10-21",1,2,6,8,8,"Yes",2,4,1,1
"8308","2017-10-21",1,2,5,7,7,"Yes",4,1,1,1
"8309","2017-10-21",2,4,5,9,8,"No",1,4,3,1
"8310","2017-10-21",2,6,0,6,4,"Yes",0,0,4,2
"8311","2017-10-21",1,2,4,6,6,"No",2,2,1,1
"8312","2017-10-21",2,4,3,7,7,"Yes",1,2,2,2
"8313","2017-10-21",3,8,3,11,14,"No",2,1,4,4
"8314","2017-10-28",2,4,1,5,6,"Yes",1,0,3,1
"8315","2017-10-21",1,4,2,6,6,"Yes",1,1,2,2
"8316","2017-10-21",1,2,4,6,5,"No",2,2,1,1
"8317","2017-10-21",3,5,11,16,16,"Yes",4,7,3,2
"8318","2017-10-21",4,8,9,17,13,"Yes",5,4,4,4
"8319","2017-10-21",1,4,4,8,7,"Yes",1,3,2,2
"8320","2017-10-21",4,8,8,16,16,"No",6,2,4,4
"8321","2017-10-21",3,6,9,15,16,"Yes",4,5,3,3
"8322","2017-10-21",1,11,7,18,18,"Yes",4,3,5,6
"8323","2017-10-21",1,4,2,6,5,"Yes",1,1,2,2
"8324","2017-10-21",2,7,1,8,10,"Yes",0,1,3,4
"8325","2017-10-21",5,12,6,18,18,"No",1,5,5,7
"8326","2017-10-21",5,10,6,16,16,"No",0,6,5,5
"8327","2017-10-21",2,4,5,9,9,"Yes",2,3,2,2
"8328","2017-10-21",4,8,9,17,17,"Yes",4,5,4,4
"8329","2017-10-21",1,4,0,4,4,"Yes",0,0,2,2
"8330","2017-10-21",2,4,8,12,12,"No",5,3,2,2
"8331","2017-10-21",2,5,3,8,8,"Yes",2,1,3,2
"8332","2017-10-21",1,4,4,8,6,"No",1,3,1,3
"8333","2017-10-21",1,3,2,5,5,"No",1,1,1,2
"8334","2017-10-21",3,4,6,10,9,"Yes",1,5,2,2
"8335","2017-10-21",1,9,4,13,15,"Yes",2,2,2,7
"8336","2017-10-21",2,5,3,8,9,"Yes",1,2,2,3
"8337","2017-10-21",4,10,9,19,16,"No",3,6,5,5
"8338","2017-10-21",2,6,4,10,10,"No",1,3,3,3
"8339","2017-10-21",3,5,7,12,12,"Yes",2,5,2,3
"8340","2017-10-21",1,2,1,3,3,"Yes",0,1,1,1
"8341","2017-10-21",1,7,1,8,8,"No",0,1,2,5
"8342","2017-10-21",1,6,4,10,10,"Yes",1,3,4,2
"8343","2017-10-21",4,8,7,15,15,"Yes",2,5,3,5
"8344","2017-10-21",3,6,4,10,9,"Yes",0,4,5,1
"8345","2017-10-21",1,3,4,7,7,"Yes",1,3,1,2
"8346","2017-10-21",NA,24,0,24,NA,"Yes",NA,NA,15,9
"8347","2017-10-21",2,7,4,11,12,"Yes",3,1,4,3
"8348","2017-10-21",1,2,1,3,3,"No",0,1,1,1
"8349","2017-10-21",1,11,5,16,9,"Yes",2,3,7,4
"8350","2017-10-21",1,2,1,3,3,"Yes",1,0,1,1
"8351",NA,10,15,11,26,26,"No",6,5,8,7
"8352","2017-10-21",4,8,7,15,15,"Yes",3,4,4,4
"8353","2017-10-20",1,34,0,34,25,"Yes",NA,NA,16,18
"8354","2017-10-21",1,5,10,15,15,"No",4,6,2,3
"8355","2017-10-21",2,8,4,12,12,"Yes",1,3,4,4
"8356","2017-10-21",4,5,3,8,16,"No",1,2,1,4
"8357","2017-10-21",3,6,4,10,10,"No",1,3,4,2
"8358","2017-10-21",3,6,4,10,10,"No",2,2,3,3
"8359","2017-10-21",1,1,2,3,3,"Yes",1,1,0,1
"8360","2017-10-21",1,3,4,7,8,"Yes",3,1,2,1
"8361","2017-10-21",3,9,6,15,14,"Yes",2,4,2,7
"8362","2017-10-21",4,12,6,18,19,"No",3,3,4,8
"8363","2017-10-21",2,9,14,23,23,"Yes",8,6,5,4
"8364","2017-10-21",4,10,2,12,13,"Yes",1,1,5,5
"8365","2017-10-21",NA,25,0,25,NA,"Yes",NA,NA,7,18
"8366","2017-10-21",1,2,5,7,7,"No",3,2,1,1
"8367","2017-10-21",3,6,5,11,12,"No",2,3,4,2
"8368","2017-10-21",4,5,15,20,20,"No",6,9,3,2
"8369","2017-10-21",1,2,3,5,4,"Yes",2,1,1,1
"8370","2017-10-21",2,4,4,8,7,"No",2,2,3,1
"8371","2017-10-21",6,13,2,15,15,"Yes",1,1,4,9
"8372","2017-10-21",2,4,5,9,9,"No",2,3,2,2
"8373","2017-10-21",3,6,13,19,19,"Yes",7,6,2,4
"8374","2017-10-21",4,7,5,12,12,"No",2,3,3,4
"8375","2017-10-21",4,8,4,12,12,"No",3,1,4,4
"8376","2017-10-21",2,8,1,9,9,"Yes",0,1,5,3
"8377","2017-10-21",3,10,2,12,6,"No",0,2,6,4
"8378","2017-10-21",12,15,11,26,27,"Yes",5,6,6,9
"8379","2017-10-21",1,2,1,3,4,"No",1,0,1,1
"8380","2017-10-23",3,4,8,12,12,"Yes",3,5,2,2
"8381","2017-10-23",NA,10,0,10,NA,"Yes",NA,NA,9,1
"8382","2017-10-23",NA,40,0,40,NA,"Yes",0,0,20,20
"8383","2017-10-23",NA,40,0,40,NA,"No",0,0,20,20
"8384","2017-10-23",NA,9,0,9,NA,"Yes",NA,NA,8,1
"8385","2017-10-23",NA,2000,0,2000,NA,"No",NA,NA,1000,1000
"8386",NA,NA,0,0,0,NA,NA,NA,NA,NA,NA
"8387","2017-10-23",2,8,6,14,14,"Yes",1,5,4,4
"8388","2017-10-23",NA,30,0,30,NA,"No",0,0,30,0
"8389","2017-10-23",NA,15,0,15,NA,"No",0,0,8,7
"8390","2017-10-23",NA,8,0,8,NA,"No",NA,NA,4,4
"8391","2017-10-23",NA,8,0,8,NA,"No",NA,NA,4,4
"8392","2017-10-23",NA,25,0,25,NA,"Yes",NA,NA,15,10
"8393","2017-10-23",5,9,1,10,10,"Yes",0,1,6,3
"8394","2017-10-23",NA,50,0,50,NA,NA,0,0,50,0
"8395","2017-10-23",4,12,5,17,17,"No",2,3,7,5
"8396","2017-10-23",3,7,5,12,14,"Yes",5,0,4,3
"8397","2017-10-23",2,5,4,9,9,"Yes",2,2,2,3
"8398","2017-10-23",4,8,7,15,15,"No",4,3,4,4
"8399","2017-10-19",5,27,3,30,23,"Yes",1,2,19,8
"8400","2017-10-23",3,7,9,16,16,"No",5,4,0,7
"8401","2017-10-23",2,5,0,5,8,"Yes",0,0,3,2
"8402","2017-10-23",3,4,4,8,8,"No",1,3,2,2
"8403","2017-10-23",1,9,6,15,15,"Yes",3,3,5,4
"8404","2017-10-23",NA,4,4,8,NA,"Yes",3,1,2,2
"8405","2017-10-23",NA,208,0,208,NA,"Yes",NA,NA,208,NA
"8406","2017-10-23",NA,50,0,50,NA,"No",0,0,50,0
"8407","2017-10-23",3,5,5,10,10,"Yes",2,3,2,3
"8408","2017-10-23",2,4,3,7,6,"Yes",1,2,2,2
"8409","2017-10-23",1,3,4,7,7,"Yes",1,3,2,1
"8410","2017-10-23",1,5,4,9,9,"No",1,3,3,2
"8411","2017-10-23",3,6,8,14,14,"Yes",6,2,3,3
"8412","2017-10-23",4,9,4,13,13,"No",2,2,4,5
"8413","2017-10-23",4,6,1,7,9,"No",0,1,2,4
"8414","2017-10-23",1,2,4,6,6,"Yes",1,3,1,1
"8415","2017-10-23",NA,4,6,10,NA,"Yes",2,4,2,2
"8416","2017-10-23",4,7,12,19,19,"Yes",7,5,3,4
"8417","2017-10-23",NA,6,130,136,NA,"No",55,75,3,3
"8418","2017-10-23",3,9,5,14,13,"No",1,4,1,8
"8419","2017-10-23",NA,140,0,140,NA,"No",NA,NA,60,80
"8420","2017-10-23",3,6,2,8,6,"Yes",1,1,3,3
"8421","2017-10-23",NA,2,25,27,NA,"No",10,15,0,2
"8422","2017-10-23",3,7,8,15,15,"No",3,5,3,4
"8423","2017-10-23",1,2,2,4,4,"No",2,NA,1,1
"8424","2017-10-23",1,2,6,8,8,"No",3,3,1,1
"8425","2017-10-23",NA,4,4,8,NA,"Yes",2,2,1,3
"8426","2017-10-23",2,5,3,8,8,"Yes",1,2,2,3
"8427","2017-10-23",7,14,8,22,15,"Yes",5,3,4,10
"8428","2017-10-23",2,4,4,8,8,"Yes",1,3,2,2
"8429","2017-10-23",1,2,3,5,5,"Yes",2,1,1,1
"8430","2017-10-23",4,5,6,11,11,"No",4,2,3,2
"8431","2017-10-23",1,4,3,7,6,"No",NA,3,1,3
"8432","2017-10-23",2,7,10,17,14,"No",3,7,3,4
"8433","2017-10-23",3,6,6,12,12,"Yes",4,2,3,3
"8434","2017-10-23",1,2,2,4,4,"Yes",0,2,1,1
"8435","2017-10-23",1,4,2,6,6,"Yes",1,1,2,2
"8436","2017-10-23",2,4,3,7,7,"No",1,2,2,2
"8437","2017-10-23",2,4,2,6,6,"No",1,1,2,2
"8438","2017-10-23",2,8,4,12,12,"Yes",0,4,3,5
"8439","2017-10-23",3,6,10,16,16,"Yes",3,7,3,3
"8440","2017-10-23",3,6,4,10,10,"Yes",2,2,3,3
"8441","2017-10-23",13,13,10,23,36,"Yes",4,6,8,5
"8442","2017-10-23",1,4,2,6,6,"No",1,1,2,2
"8443","2017-10-23",1,2,3,5,5,"No",1,2,1,1
"8444","2017-10-23",1,2,5,7,7,"Yes",2,3,1,1
"8445","2017-10-23",2,4,3,7,12,"Yes",3,0,2,2
"8446","2017-10-23",1,4,4,8,7,"Yes",1,3,2,2
"8447","2017-10-23",1,2,4,6,6,"Yes",2,2,1,1
"8448","2017-10-23",NA,8,90,98,NA,"Yes",30,60,5,3
"8449","2017-10-23",2,4,1,5,5,"Yes",1,0,1,3
"8450","2017-10-23",5,10,10,20,20,"No",6,4,5,5
"8451","2017-10-23",1,2,3,5,6,"Yes",1,2,1,1
"8452","2017-10-23",3,6,5,11,11,"No",2,3,3,3
"8453","2017-10-23",1,8,2,10,9,"Yes",2,0,3,5
"8454","2017-10-23",4,9,2,11,16,"Yes",1,1,4,5
"8455","2017-10-23",7,14,8,22,22,"Yes",2,6,7,7
"8456","2017-10-23",NA,11,0,11,NA,"Yes",0,0,7,4
"8457","2017-10-23",1,5,7,12,12,"Yes",4,3,4,1
"8458","2017-10-23",1,2,3,5,5,"Yes",1,2,1,1
"8459","2017-10-23",1,4,4,8,7,"Yes",2,2,2,2
"8460","2017-10-23",2,5,5,10,10,"Yes",2,3,2,3
"8461","2017-10-23",1,8,6,14,13,"Yes",2,4,3,5
"8462","2017-10-23",NA,250,250,500,NA,"No",100,150,100,150
"8463","2017-10-23",1,4,4,8,8,"Yes",1,3,2,2
"8464","2017-10-23",1,2,4,6,6,"Yes",3,1,1,1
"8465","2017-10-23",1,2,2,4,4,"Yes",1,1,1,1
"8466","2017-10-23",2,4,2,6,6,"Yes",1,1,2,2
"8467","2017-10-23",1,3,4,7,7,"Yes",3,1,2,1
"8468","2017-10-23",6,9,8,17,23,"Yes",7,1,3,6
"8469","2017-10-23",1,4,5,9,8,"Yes",2,3,2,2
"8470","2017-10-23",NA,1,0,1,NA,"Yes",NA,NA,1,NA
"8471","2017-10-23",1,2,4,6,6,"Yes",2,2,1,1
"8472","2017-10-23",2,5,8,13,13,"No",3,5,2,3
"8473","2017-10-23",2,8,2,10,10,"Yes",0,2,2,6
"8474","2017-10-23",2,4,4,8,8,"Yes",2,2,2,2
"8475","2017-10-23",3,7,9,16,16,"Yes",5,4,3,4
"8476","2017-10-23",3,7,8,15,15,"Yes",3,5,3,4
"8477","2017-10-23",3,10,5,15,12,"No",2,3,5,5
"8478","2017-10-23",4,8,7,15,15,"Yes",3,4,4,4
"8479",NA,NA,402,52,454,NA,"No",22,30,102,300
"8480","2017-10-23",3,2,11,13,13,NA,6,5,1,1
"8481","2017-10-23",7,14,9,23,25,"Yes",7,2,6,8
"8482","2017-10-23",4,10,8,18,18,"Yes",5,3,4,6
"8483","2017-10-23",2,7,4,11,11,"No",3,1,3,4
"8484","2017-10-23",2,7,5,12,12,"Yes",2,3,3,4
"8485","2017-10-23",1,1,6,7,6,"Yes",3,3,NA,1
"8486","2017-10-23",2,5,5,10,10,"Yes",3,2,2,3
"8487","2017-10-23",2,8,3,11,10,"Yes",1,2,4,4
"8488","2017-10-23",4,3,4,7,7,"Yes",1,3,1,2
"8489","2017-10-23",NA,11,0,11,NA,"No",NA,NA,2,9
"8490","2017-10-23",1,2,1,3,3,"Yes",0,1,1,1
"8491","2017-10-23",2,5,4,9,9,"Yes",1,3,2,3
"8492","2017-10-23",1,4,4,8,8,"Yes",1,3,2,2
"8493","2017-10-23",4,8,7,15,15,"Yes",3,4,4,4
"8494","2017-10-23",1,4,1,5,5,"No",1,0,2,2
"8495","2017-10-23",NA,6,0,6,NA,NA,NA,NA,NA,6
"8496","2017-10-23",1,2,4,6,6,"Yes",1,3,1,1
"8497","2017-10-23",1,1,1,2,2,"No",0,1,0,1
"8498","2017-10-23",3,7,1,8,8,"Yes",0,1,4,3
"8499","2017-10-23",6,12,7,19,19,"Yes",3,4,6,6
"8500","2017-10-23",9,20,22,42,42,"Yes",10,12,10,10
"8501","2017-10-23",3,6,5,11,11,"No",2,3,3,3
"8502","2017-10-23",NA,0,0,0,NA,"No",NA,NA,NA,NA
"8503","2017-10-23",5,10,7,17,17,"Yes",3,4,5,5
"8504","2017-10-23",1,2,5,7,6,"Yes",2,3,1,1
"8505","2017-10-23",2,10,2,12,13,"No",2,0,4,6
"8506","2017-10-23",4,8,8,16,16,"Yes",3,5,4,4
"8507","2017-10-23",1,3,1,4,4,"Yes",0,1,2,1
"8508","2017-10-23",3,7,7,14,14,"No",4,3,3,4
"8509","2017-10-23",5,8,7,15,22,NA,1,6,4,4
"8510","2017-10-23",4,9,8,17,17,"No",6,2,6,3
"8511","2017-10-23",1,2,4,6,6,"Yes",1,3,1,1
"8512","2017-10-23",4,5,9,14,14,"Yes",4,5,3,2
"8513","2017-10-23",1,7,6,13,13,"Yes",1,5,3,4
"8514","2017-10-23",8,10,10,20,22,"Yes",4,6,6,4
"8515","2017-10-23",2,3,5,8,8,"Yes",2,3,1,2
"8516","2017-10-23",2,4,3,7,7,"Yes",1,2,2,2
"8517","2017-10-23",1,3,1,4,4,"No",0,1,1,2
"8518","2017-10-23",1,2,2,4,4,"Yes",1,1,1,1
"8519","2017-10-23",4,10,10,20,20,"No",4,6,7,3
"8520","2017-10-23",1,4,3,7,7,"Yes",2,1,1,3
"8521","2017-10-23",2,5,4,9,9,"Yes",1,3,2,3
"8522","2017-10-23",NA,110,55,165,NA,"No",25,30,40,70
"8523","2017-10-23",1,2,2,4,4,"Yes",2,0,1,1
"8524","2017-10-23",1,2,5,7,7,"Yes",2,3,1,1
"8525","2017-10-23",1,6,4,10,10,"Yes",3,1,4,2
"8526","2017-10-23",1,2,0,2,2,"Yes",0,0,1,1
"8527","2017-10-23",4,13,5,18,18,"No",2,3,4,9
"8528","2017-10-23",2,7,1,8,10,"No",0,1,2,5
"8529","2017-10-23",3,4,5,9,9,"Yes",2,3,2,2
"8530","2017-10-23",1,5,2,7,7,"No",2,0,2,3
"8531","2017-10-23",1,2,1,3,3,"No",1,0,1,1
"8532","2017-10-23",2,4,8,12,12,"Yes",4,4,2,2
"8533","2017-10-23",1,3,6,9,9,"No",3,3,2,1
"8534","2017-10-23",4,8,6,14,14,"No",4,2,4,4
"8535","2017-10-23",5,10,9,19,20,"No",4,5,4,6
"8536","2017-10-23",11,23,7,30,30,"No",3,4,11,12
"8537","2017-10-23",3,9,6,15,15,"Yes",4,2,5,4
"8538","2017-10-23",1,4,2,6,6,"Yes",1,1,2,2
"8539","2017-10-23",1,2,2,4,4,"Yes",2,NA,1,1
"8540","2017-10-23",3,2,7,9,9,"Yes",3,4,1,1
"8541","2017-10-23",1,4,2,6,6,"Yes",0,2,2,2
"8542","2017-10-23",4,10,3,13,20,"No",2,1,5,5
"8543","2017-10-23",NA,11,150,161,NA,"No",70,80,5,6
"8544","2017-10-23",2,3,1,4,4,"Yes",1,NA,2,1
"8545","2017-10-23",1,1,2,3,3,"Yes",1,1,0,1
"8546","2017-10-23",2,4,4,8,8,"No",2,2,2,2
"8547","2017-10-23",5,17,8,25,20,"Yes",3,5,8,9
"8548","2017-10-23",5,10,15,25,25,"No",5,10,5,5
"8549","2017-10-23",7,14,6,20,20,"Yes",2,4,7,7
"8550","2017-10-23",1,4,4,8,8,"Yes",1,3,2,2
"8551","2017-10-23",3,6,12,18,18,"Yes",9,3,4,2
"8552","2017-10-23",1,3,0,3,3,"Yes",0,0,3,0
"8553","2017-10-23",2,8,3,11,7,"Yes",3,0,5,3
"8554","2017-10-23",4,7,0,7,7,"Yes",0,0,3,4
"8555","2017-10-23",1,2,1,3,3,"No",0,1,1,1
"8556","2017-10-23",1,3,2,5,5,"Yes",1,1,2,1
"8557","2017-10-23",NA,102,0,102,NA,"Yes",NA,NA,42,60
"8558","2017-10-23",2,7,5,12,12,"Yes",3,2,3,4
"8559","2017-10-23",3,5,9,14,14,"Yes",4,5,2,3
"8560","2017-10-23",1,3,5,8,7,NA,1,4,2,1
"8561","2017-10-23",7,10,2,12,12,"Yes",1,1,5,5
"8562","2017-10-23",6,15,12,27,26,"Yes",8,4,8,7
"8563","2017-10-23",7,14,16,30,30,"Yes",10,6,7,7
"8564","2017-10-23",1,4,8,12,12,"Yes",3,5,1,3
"8565","2017-10-23",NA,0,0,0,NA,"No",NA,NA,NA,NA
"8566","2017-10-23",2,6,2,8,8,"No",0,2,2,4
"8567","2017-10-23",2,4,5,9,9,"Yes",2,3,2,2
"8568","2017-10-23",1,2,4,6,6,"Yes",1,3,1,1
"8569","2017-10-23",3,6,4,10,10,"Yes",2,2,3,3
"8570","2017-10-23",2,4,6,10,10,"Yes",2,4,2,2
"8571","2017-10-25",2,2,4,6,6,"No",1,3,1,1
"8572","2017-10-23",1,1,2,3,3,"Yes",1,1,1,0
"8573","2017-10-23",2,7,3,10,10,"Yes",1,2,3,4
"8574","2017-10-23",2,4,5,9,9,"No",2,3,2,2
"8575","2017-10-23",2,2,0,2,2,"Yes",0,0,2,0
"8576","2017-10-23",3,9,9,18,18,"Yes",4,5,3,6
"8577","2017-10-23",1,3,4,7,7,"Yes",3,1,1,2
"8578","2017-10-23",3,7,10,17,17,"Yes",5,5,4,3
"8579","2017-10-23",3,6,5,11,11,"Yes",2,3,3,3
"8580","2017-10-23",4,10,13,23,23,"Yes",6,7,4,6
"8581","2017-10-20",1,3,3,6,5,"Yes",0,3,1,2
"8582","2017-10-20",1,1,0,1,1,"Yes",0,0,1,0
"8583","2017-10-20",1,6,4,10,10,"Yes",2,2,3,3
"8584","2017-10-20",2,3,5,8,8,"Yes",2,3,1,2
"8585","2017-10-20",3,8,6,14,14,"Yes",3,3,4,4
"8586","2017-10-20",5,11,5,16,16,"Yes",1,4,5,6
"8587","2017-10-20",5,10,7,17,17,"No",1,6,5,5
"8588","2017-10-20",1,5,1,6,6,"Yes",1,0,2,3
"8589","2017-10-20",2,4,6,10,10,"No",3,3,2,2
"8590","2017-10-20",1,2,3,5,5,"Yes",1,2,1,1
"8591","2017-10-20",4,7,10,17,17,"Yes",6,4,2,5
"8592","2017-10-25",5,7,3,10,12,"No",3,0,4,3
"8593","2017-10-25",1,2,3,5,5,"No",1,2,1,1
"8594","2017-10-25",1,2,1,3,3,"No",1,NA,1,1
"8595","2017-10-25",NA,2,6,8,8,"Yes",4,2,1,1
"8596","2017-10-25",1,2,1,3,3,"Yes",NA,1,1,1
"8597","2017-10-25",5,9,2,11,12,"Yes",0,2,4,5
"8598","2017-10-25",2,4,4,8,8,"Yes",2,2,2,2
"8599","2017-10-25",2,4,1,5,6,"Yes",1,0,1,3
"8600","2017-10-25",1,2,2,4,4,"Yes",1,1,1,1
"8601","2017-10-25",4,7,9,16,17,"Yes",3,6,3,4
"8602","2017-10-25",3,6,3,9,9,"No",2,1,3,3
"8603","2017-10-25",6,10,4,14,15,"Yes",1,3,4,6
"8604","2017-10-25",2,5,4,9,10,"No",2,2,3,2
"8605","2017-10-25",4,8,10,18,18,"Yes",5,5,4,4
"8606","2017-10-25",4,8,12,20,20,"No",5,7,4,4
"8607","2017-10-25",4,9,19,28,28,"No",7,12,5,4
"8608","2017-10-25",2,4,2,6,6,"No",1,1,2,2
"8609","2017-10-25",2,5,1,6,6,"No",1,NA,4,1
"8610","2017-10-25",2,4,4,8,8,"Yes",1,3,2,2
"8611","2017-10-25",2,3,1,4,3,"Yes",0,1,1,2
"8612",NA,3,11,12,23,23,"Yes",6,6,4,7
"8613","2017-10-25",3,8,2,10,10,"No",0,2,4,4
"8614","2017-10-25",1,2,2,4,4,"No",1,1,1,1
"8615","2017-10-25",4,8,3,11,14,"No",0,3,4,4
"8616","2017-10-25",4,9,5,14,16,"Yes",3,2,4,5
"8617","2017-10-25",9,18,12,30,30,"Yes",8,4,9,9
"8618","2017-10-25",2,4,2,6,6,"No",1,1,2,2
"8619","2017-10-25",2,5,3,8,8,"No",2,1,2,3
"8620","2017-10-25",4,4,7,11,9,"Yes",3,4,3,1
"8621","2017-10-25",1,2,4,6,6,"Yes",1,3,1,1
"8622","2017-10-25",1,3,5,8,8,"No",3,2,1,2
"8623","2017-10-25",4,8,6,14,15,"No",2,4,4,4
"8624","2017-10-25",17,10,4,14,17,"Yes",2,2,5,5
"8625","2017-10-25",1,2,3,5,5,"Yes",2,1,1,1
"8626","2017-10-25",1,4,5,9,9,"No",2,3,1,3
"8627","2017-10-25",3,6,3,9,9,"No",1,2,3,3
"8628","2017-10-25",3,6,5,11,11,NA,NA,5,3,3
"8629","2017-10-25",1,3,4,7,7,"Yes",3,1,1,2
"8630","2017-10-25",5,8,7,15,15,"Yes",4,3,4,4
"8631","2017-10-25",3,5,6,11,12,"Yes",3,3,2,3
"8632","2017-10-25",1,4,3,7,7,"Yes",2,1,3,1
"8633","2017-10-25",6,10,8,18,18,"Yes",2,6,4,6
"8634","2017-10-25",1,3,2,5,5,"No",1,1,2,1
"8635","2017-10-25",7,12,7,19,23,"Yes",3,4,4,8
"8636","2017-10-25",6,12,0,12,12,"No",0,0,6,6
"8637","2017-10-25",4,5,4,9,9,"Yes",3,1,2,3
"8638","2017-10-25",6,12,10,22,23,"Yes",5,5,6,6
"8639","2017-10-20",9,17,19,36,36,"No",11,8,6,11
"8640","2017-10-25",1,6,3,9,10,"Yes",2,1,4,2
"8641","2017-10-25",9,15,13,28,29,"No",5,8,8,7
"8642","2017-10-26",3,9,6,15,15,"No",3,3,4,5
"8643","2017-10-23",3,8,8,16,16,"Yes",2,6,4,4
"8644","2017-10-25",1,2,4,6,5,"Yes",1,3,1,1
"8645","2017-10-25",2,4,2,6,6,"Yes",1,1,2,2
"8646","2017-10-25",4,8,5,13,17,"Yes",3,2,5,3
"8647","2017-10-25",9,15,7,22,2,"No",4,3,9,6
"8648","2017-10-25",2,7,5,12,12,"No",2,3,4,3
"8649","2017-10-25",1,2,4,6,6,"Yes",1,3,1,1
"8650","2017-10-25",2,5,3,8,8,"Yes",1,2,2,3
"8651","2017-10-25",2,4,4,8,8,"Yes",2,2,2,2
"8652","2017-10-25",6,12,8,20,20,"Yes",2,6,7,5
"8653","2017-10-25",1,5,2,7,7,"Yes",2,0,2,3
"8654","2017-10-25",3,8,7,15,15,"No",4,3,3,5
"8655","2017-10-25",6,16,5,21,23,"Yes",3,2,6,10
"8656","2017-10-25",1,3,1,4,4,"Yes",1,0,1,2
"8657","2017-10-25",6,13,5,18,18,"Yes",2,3,6,7
"8658","2017-10-25",5,10,10,20,20,"Yes",4,6,5,5
"8659","2017-10-25",2,3,5,8,8,"No",0,5,1,2
"8660","2017-10-25",4,6,3,9,11,"No",3,0,2,4
"8661","2017-10-25",4,8,8,16,16,"No",5,3,4,4
"8662","2017-10-25",2,4,2,6,8,"Yes",1,1,2,2
"8663","2017-10-25",5,10,5,15,12,"No",0,5,5,5
"8664","2017-10-25",4,9,6,15,15,"Yes",3,3,5,4
"8665","2017-10-25",4,9,9,18,18,"Yes",6,3,4,5
"8666","2017-10-25",1,2,3,5,5,"Yes",2,1,1,1
"8667","2017-10-25",2,4,4,8,8,"No",1,3,2,2
"8668","2017-10-25",4,7,7,14,14,"No",2,5,4,3
"8669","2017-10-25",2,4,7,11,8,"No",3,4,2,2
"8670","2017-10-25",1,3,2,5,5,"No",1,1,1,2
"8671","2017-10-25",5,9,9,18,19,"Yes",4,5,3,6
"8672","2017-10-25",3,9,8,17,17,"No",5,3,4,5
"8673","2017-10-25",1,3,4,7,8,"Yes",2,2,1,2
"8674","2017-10-25",6,16,8,24,24,"Yes",4,4,9,7
"8675","2017-10-25",3,5,1,6,6,"No",0,1,2,3
"8676","2017-10-25",3,7,8,15,15,"No",4,4,3,4
"8677","2017-10-25",1,2,2,4,4,"Yes",1,1,1,1
"8678","2017-10-25",4,7,13,20,25,"Yes",5,8,3,4
"8679","2017-10-25",4,12,13,25,25,"Yes",8,5,5,7
"8680","2017-10-25",1,5,2,7,7,"Yes",1,1,2,3
"8681","2017-10-25",3,9,5,14,14,"Yes",3,2,5,4
"8682","2017-10-25",2,4,6,10,10,"Yes",2,4,2,2
"8683","2017-10-25",3,8,9,17,17,"Yes",5,4,3,5
"8684","2017-10-25",4,8,6,14,14,"No",4,2,4,4
"8685","2017-10-25",5,13,14,27,27,"No",6,8,8,5
"8686","2017-10-25",1,2,4,6,6,"Yes",1,3,NA,2
"8687","2017-10-25",1,2,6,8,8,"No",2,4,1,1
"8688","2017-10-25",6,10,10,20,20,"Yes",6,4,5,5
"8689","2017-10-25",1,2,4,6,6,"Yes",2,2,1,1
"8690","2017-10-25",2,4,7,11,11,"Yes",3,4,2,2
"8691","2017-10-25",3,6,3,9,9,"Yes",1,2,4,2
"8692","2017-10-25",1,2,5,7,7,"Yes",0,5,1,1
"8693","2017-10-25",1,2,3,5,5,"No",1,2,1,1
"8694","2017-10-25",3,6,3,9,9,"No",1,2,3,3
"8695","2017-10-25",1,2,1,3,3,"No",0,1,1,1
"8696","2017-10-25",3,5,3,8,8,"No",2,1,2,3
"8697","2017-10-25",6,8,9,17,20,"No",6,3,3,5
"8698","2017-10-25",1,2,6,8,6,"Yes",2,4,0,2
"8699","2017-10-25",1,4,4,8,8,"Yes",3,1,2,2
"8700","2017-10-25",8,16,16,32,32,"Yes",5,11,8,8
"8701","2017-10-25",5,10,2,12,12,"Yes",0,2,5,5
"8702","2017-10-25",3,6,10,16,16,"Yes",4,6,2,4
"8703","2017-10-25",4,13,3,16,16,"Yes",0,3,7,6
"8704","2017-10-25",2,4,11,15,15,"No",5,6,2,2
"8705","2017-10-25",1,4,4,8,8,"Yes",3,1,2,2
"8706","2017-10-25",3,6,6,12,12,"No",2,4,3,3
"8707","2017-10-25",3,9,5,14,12,"Yes",1,4,5,4
"8708","2017-10-25",3,6,6,12,12,"No",2,4,3,3
"8709","2017-10-25",4,8,12,20,20,"Yes",5,7,4,4
"8710","2017-10-25",1,2,4,6,6,"No",1,3,1,1
"8711","2017-10-25",1,3,4,7,7,"No",1,3,1,2
"8712","2017-10-25",3,10,8,18,18,"Yes",2,6,3,7
"8713","2017-10-25",1,3,2,5,5,"Yes",1,1,1,2
"8714","2017-10-25",3,9,4,13,13,"Yes",1,3,3,6
"8715","2017-10-25",3,4,6,10,10,"No",2,4,3,1
"8716","2017-10-25",3,5,1,6,6,"Yes",1,0,2,3
"8717","2017-10-25",5,10,7,17,18,"No",3,4,5,5
"8718","2017-10-25",2,6,9,15,15,"No",5,4,3,3
"8719","2017-10-25",8,13,12,25,25,"Yes",5,7,5,8
"8720","2017-10-25",2,6,5,11,11,"Yes",2,3,3,3
"8721","2017-10-25",3,8,6,14,14,"Yes",4,2,5,3
"8722","2017-10-25",4,11,9,20,19,"Yes",5,4,5,6
"8723","2017-10-25",1,11,4,15,15,"Yes",2,2,5,6
"8724","2017-10-25",4,5,7,12,15,"Yes",1,6,1,4
"8725",NA,4,8,6,14,14,"No",2,4,4,4
"8726","2017-10-25",2,5,5,10,10,"Yes",4,1,2,3
"8727","2017-10-25",NA,6,99,105,NA,"No",38,61,2,4
"8728","2017-10-25",3,8,0,8,15,"Yes",0,0,4,4
"8729","2017-10-25",4,6,4,10,10,"Yes",2,2,3,3
"8730","2017-10-25",1,2,1,3,3,"No",1,0,1,1
"8731","2017-10-25",3,5,10,15,15,"Yes",5,5,2,3
"8732","2017-10-25",4,7,1,8,8,"No",1,0,3,4
"8733","2017-10-25",NA,9,200,209,NA,"Yes",75,125,2,7
"8734","2017-10-25",2,4,4,8,8,"Yes",1,3,2,2
"8735","2017-10-25",10,20,8,28,28,"No",3,5,10,10
"8736","2017-10-25",5,9,9,18,21,"Yes",5,4,5,4
"8737","2017-10-25",3,6,2,8,8,"No",1,1,3,3
"8738","2017-10-25",2,4,3,7,7,"Yes",0,3,2,2
"8739","2017-10-25",3,9,3,12,12,"No",2,1,6,3
"8740","2017-10-25",3,9,11,20,20,"Yes",4,7,5,4
"8741","2017-10-25",2,4,7,11,10,"No",5,2,2,2
"8742","2017-10-25",3,6,5,11,11,"Yes",2,3,3,3
"8743","2017-10-25",3,7,7,14,11,"Yes",4,3,3,4
"8744","2017-10-25",2,4,2,6,6,"No",0,2,2,2
"8745","2017-10-25",NA,11,410,421,NA,"Yes",200,210,6,5
"8746","2017-10-25",5,10,13,23,23,"Yes",7,6,5,5
"8747","2017-10-25",4,8,5,13,13,"Yes",1,4,4,4
"8748","2017-10-25",7,15,10,25,25,"No",4,6,7,8
"8749","2017-10-25",2,8,4,12,12,"No",2,2,4,4
"8750","2017-10-25",2,4,5,9,9,"Yes",2,3,2,2
"8751","2017-10-25",1,4,8,12,12,"Yes",4,4,1,3
"8752","2017-10-25",1,2,4,6,6,"Yes",2,2,1,1
"8753","2017-10-25",2,4,6,10,10,"Yes",3,3,2,2
"8754","2017-10-25",2,4,3,7,7,"No",2,1,2,2
"8755","2017-10-25",5,10,8,18,18,"No",2,6,6,4
"8756","2017-10-25",2,7,2,9,9,"No",1,1,4,3
"8757","2017-10-25",2,4,2,6,6,"Yes",0,2,2,2
"8758","2017-10-25",3,6,1,7,9,"Yes",NA,1,4,2
"8759","2017-10-25",2,4,0,4,4,"Yes",0,0,2,2
"8760","2017-10-25",1,3,3,6,6,"No",2,1,1,2
"8761","2017-10-25",7,20,10,30,30,"Yes",6,4,9,11
"8762","2017-10-25",2,5,5,10,10,"No",2,3,2,3
"8763","2017-10-25",10,12,14,26,39,"Yes",5,9,6,6
"8764","2017-10-25",5,8,7,15,15,"No",4,3,4,4
"8765","2017-10-25",1,3,7,10,10,"Yes",3,4,1,2
"8766","2017-10-25",1,3,1,4,4,"No",0,1,2,1
"8767","2017-10-25",2,4,4,8,8,"No",2,2,2,2
"8768","2017-10-25",1,2,1,3,3,"No",0,1,1,1
"8769","2017-10-25",7,15,12,27,27,"Yes",5,7,9,6
"8770","2017-10-25",7,15,7,22,22,"Yes",4,3,8,7
"8771","2017-10-17",5,11,13,24,25,"No",7,6,6,5
"8772","2017-10-25",6,12,8,20,20,"Yes",3,5,6,6
"8773","2017-10-25",6,8,18,26,26,"Yes",6,12,2,6
"8774","2017-10-25",1,3,3,6,5,"Yes",1,2,1,2
"8775","2017-10-25",5,12,24,36,36,"No",21,3,6,6
"8776","2017-10-25",3,7,5,12,12,"Yes",2,3,4,3
"8777","2017-10-23",3,8,4,12,12,"No",1,3,4,4
"8778","2017-10-25",5,6,9,15,15,"Yes",5,4,3,3
"8779","2017-10-25",8,15,9,24,27,"Yes",6,3,7,8
"8780","2017-10-25",2,6,6,12,12,"Yes",2,4,1,5
"8781",NA,NA,3,256,259,NA,"Yes",150,106,2,1
"8782","2017-10-25",2,4,1,5,9,"No",0,1,2,2
"8783","2017-10-25",3,7,8,15,15,"Yes",4,4,4,3
"8784","2017-10-25",2,4,6,10,10,"Yes",3,3,2,2
"8785","2017-10-23",1,2,4,6,6,"No",2,2,1,1
"8786","2017-10-25",7,14,16,30,30,"No",7,9,7,7
"8787","2017-10-25",5,10,6,16,16,"Yes",3,3,5,5
"8788","2017-10-25",4,6,6,12,12,"No",2,4,3,3
"8789","2017-10-25",2,6,3,9,8,"Yes",2,1,3,3
"8790","2017-10-25",2,8,0,8,8,"Yes",0,0,4,4
"8791","2017-10-23",1,3,5,8,8,"Yes",3,2,2,1
"8792","2017-10-25",4,8,8,16,15,"Yes",3,5,4,4
"8793","2017-10-25",2,5,5,10,10,"Yes",2,3,2,3
"8794","2017-10-25",1,3,3,6,6,"No",NA,3,2,1
"8795","2017-10-25",2,6,4,10,10,"Yes",0,4,3,3
"8796","2017-10-25",6,12,12,24,24,"No",7,5,6,6
"8797","2017-10-25",6,6,9,15,15,"No",4,5,3,3
"8798","2017-10-25",5,14,12,26,27,"Yes",5,7,9,5
"8799","2017-10-23",5,16,9,25,25,"Yes",5,4,6,10
"8800","2017-10-25",4,8,9,17,17,"Yes",3,6,4,4
"8801","2017-10-25",2,8,6,14,14,"Yes",2,4,4,4
"8802","2017-10-25",3,13,7,20,19,"Yes",4,3,7,6
"8803","2017-10-25",3,7,3,10,10,"No",2,1,3,4
"8804","2017-10-25",1,5,2,7,7,"Yes",1,1,3,2
"8805","2017-10-25",1,2,4,6,6,"No",2,2,1,1
"8806","2017-10-25",2,8,2,10,10,"No",1,1,5,3
"8807","2017-10-25",1,2,5,7,7,"Yes",2,3,1,1
"8808","2017-10-25",2,4,1,5,5,"No",0,1,2,2
"8809","2017-10-25",4,8,7,15,15,"Yes",4,3,4,4
"8810","2017-10-25",1,2,2,4,4,"Yes",2,0,1,1
"8811","2017-10-25",2,4,7,11,11,"Yes",4,3,2,2
"8812","2017-10-25",3,10,2,12,16,"Yes",1,1,7,3
"8813","2017-10-25",3,7,7,14,14,"Yes",1,6,4,3
"8814","2017-10-25",3,8,3,11,11,"Yes",3,0,4,4
"8815","2017-10-25",1,6,5,11,11,"Yes",3,2,5,1
"8816","2017-10-25",3,7,7,14,14,"Yes",3,4,4,3
"8817","2017-10-23",4,7,5,12,11,"Yes",2,3,3,4
"8818","2017-10-25",1,3,2,5,5,"Yes",1,1,1,2
"8819","2017-10-25",4,8,9,17,17,"Yes",4,5,4,4
"8820","2017-11-01",1,8,5,13,12,"Yes",2,3,2,6
"8821","2017-10-25",4,8,2,10,10,"Yes",1,1,4,4
"8822","2017-10-25",1,3,4,7,7,"Yes",2,2,1,2
"8823","2017-10-25",3,7,3,10,10,"Yes",2,1,3,4
"8824","2017-10-25",5,10,3,13,24,"No",2,1,6,4
"8825","2017-10-25",4,8,4,12,12,"Yes",1,3,4,4
"8826","2017-10-25",8,15,15,30,30,"No",8,7,8,7
"8827","2017-10-23",2,7,5,12,12,"Yes",3,2,4,3
"8828","2017-10-25",1,3,2,5,4,"No",0,2,1,2
"8829",NA,5,8,7,15,15,"No",3,4,3,5
"8830","2017-10-25",1,5,2,7,7,"Yes",1,1,3,2
"8831","2017-10-25",4,8,8,16,16,"No",4,4,4,4
"8832","2017-10-25",NA,7,2,9,9,"Yes",NA,2,3,4
"8833","2017-10-25",1,2,3,5,5,"No",3,0,1,1
"8834","2017-10-25",4,7,6,13,13,"Yes",3,3,5,2
"8835","2017-10-25",4,8,9,17,17,"No",5,4,4,4
"8836","2017-10-25",2,4,2,6,8,"Yes",1,1,2,2
"8837","2017-10-25",5,10,15,25,25,"No",8,7,5,5
"8838","2017-10-25",2,4,8,12,13,"Yes",1,7,2,2
"8839","2017-10-25",1,2,3,5,6,"No",2,1,1,1
"8840","2017-10-25",4,10,9,19,19,"Yes",4,5,7,3
"8841",NA,1,6,1,7,6,NA,1,0,3,3
"8842","2017-10-25",5,10,0,10,10,"Yes",0,0,5,5
"8843","2017-10-25",2,9,5,14,14,"Yes",2,3,4,5
"8844","2017-10-25",2,3,1,4,4,"No",1,0,2,1
"8845","2017-10-25",4,15,11,26,26,"No",7,4,9,6
"8846","2017-10-25",4,10,13,23,23,"No",6,7,5,5
"8847","2017-10-25",3,10,2,12,10,"Yes",1,1,3,7
"8848","2017-10-25",1,2,3,5,5,"Yes",1,2,1,1
"8849","2017-10-25",NA,8,180,188,NA,"Yes",80,100,2,6
"8850","2017-10-25",3,4,8,12,12,"Yes",3,5,2,2
"8851","2017-10-25",5,15,8,23,23,"Yes",6,2,8,7
"8852","2017-10-25",1,2,4,6,6,"Yes",3,1,1,1
"8853","2017-10-25",3,6,5,11,11,"Yes",0,5,4,2
"8854","2017-10-25",1,2,2,4,4,"No",2,0,1,1
"8855","2017-10-25",5,10,8,18,18,"Yes",2,6,5,5
"8856","2017-10-25",1,6,3,9,9,"Yes",2,1,3,3
"8857","2017-10-25",2,5,7,12,14,"No",3,4,2,3
"8858","2017-10-25",1,2,3,5,4,"Yes",1,2,1,1
"8859","2017-10-25",5,10,16,26,26,"Yes",6,10,5,5
"8860","2017-10-25",1,6,2,8,8,"Yes",1,1,3,3
"8861","2017-10-25",1,5,0,5,5,"Yes",0,0,5,0
"8862","2017-10-25",1,2,5,7,7,"No",3,2,1,1
"8863","2017-10-25",5,15,5,20,20,"Yes",5,0,10,5
"8864","2017-10-25",1,2,6,8,9,"No",1,5,1,1
"8865","2017-10-25",2,3,4,7,7,"No",2,2,1,2
"8866","2017-10-25",2,5,10,15,15,"Yes",3,7,2,3
"8867","2017-10-25",1,4,4,8,8,"Yes",1,3,2,2
"8868","2017-10-25",2,5,1,6,6,"Yes",0,1,2,3
"8869","2017-10-25",1,4,6,10,10,"Yes",2,4,2,2
"8870","2017-10-25",1,5,3,8,8,"Yes",2,1,2,3
"8871","2017-10-25",1,2,0,2,2,"No",0,0,1,1
"8872","2017-10-25",5,14,11,25,25,"No",5,6,7,7
"8873","2017-10-25",1,5,1,6,6,"Yes",0,1,4,1
"8874","2017-10-25",3,7,7,14,14,"No",4,3,4,3
"8875","2017-10-25",3,7,11,18,19,"Yes",7,4,3,4
"8876","2017-10-25",1,7,2,9,9,"Yes",0,2,3,4
"8877","2017-10-14",4,7,12,19,17,"Yes",6,6,2,5
"8878","2017-10-14",3,7,4,11,11,"Yes",1,3,4,3
"8879","2017-10-14",NA,6,7,13,15,"No",3,4,2,4
"8880","2017-10-14",1,3,2,5,5,"Yes",2,NA,2,1
"8881","2017-10-14",4,11,7,18,9,"Yes",5,2,4,7
"8882","2017-10-14",8,15,11,26,24,"Yes",6,5,8,7
"8883","2017-10-25",1,3,5,8,8,"Yes",1,4,1,2
"8884","2017-10-25",5,12,15,27,27,"Yes",7,8,8,4
"8885","2017-10-25",5,10,12,22,22,"Yes",5,7,5,5
"8886","2017-10-25",3,6,6,12,12,"Yes",3,3,3,3
"8887","2017-10-25",1,2,0,2,2,"Yes",0,0,1,1
"8888","2017-10-25",1,1,0,1,1,"No",0,0,0,1
"8889","2017-10-25",2,5,2,7,7,"Yes",1,1,2,3
"8890","2017-10-25",6,13,14,27,27,"No",6,8,7,6
"8891","2017-10-25",4,11,10,21,21,"Yes",7,3,6,5
"8892","2017-10-25",1,4,1,5,5,"Yes",1,0,2,2
"8893","2017-10-25",2,4,5,9,9,"Yes",2,3,2,2
"8894","2017-10-20",4,7,6,13,13,"Yes",4,2,4,3
"8895","2017-10-20",1,2,3,5,5,"Yes",1,2,1,1
"8896","2017-10-20",3,5,6,11,11,"Yes",3,3,1,4
"8897","2017-10-20",6,9,3,12,12,"Yes",2,1,6,3
"8898","2017-10-20",5,11,8,19,19,"Yes",4,4,5,6
"8899","2017-10-20",3,9,5,14,14,"Yes",4,1,5,4
"8900","2017-10-20",3,10,3,13,13,"Yes",0,3,3,7
"8901","2017-10-20",6,11,9,20,20,"No",5,4,4,7
"8902","2017-10-20",4,5,4,9,9,"Yes",1,3,3,2
"8903","2017-10-20",3,4,6,10,10,"Yes",2,4,3,1
"8904","2017-10-20",5,13,11,24,24,"Yes",6,5,9,4
"8905","2017-10-20",6,10,6,16,16,"Yes",3,3,5,5
"8906",NA,1,4,2,6,6,"Yes",1,1,1,3
"8907","2017-10-20",1,2,3,5,6,"Yes",2,1,1,1
"8908","2017-10-20",4,9,4,13,13,"Yes",2,2,2,7
"8909","2017-10-20",4,7,4,11,NA,"No",2,2,4,3
"8910","2017-10-20",1,4,3,7,7,"Yes",2,1,1,3
"8911","2017-10-20",3,6,7,13,13,"Yes",3,4,3,3
"8912","2017-10-20",1,3,3,6,7,"Yes",0,3,2,1
"8913","2017-10-20",4,8,2,10,10,"No",1,1,4,4
"8914","2017-10-20",4,7,5,12,12,"Yes",5,0,4,3
"8915","2017-10-20",3,8,2,10,10,"Yes",1,1,5,3
"8916","2017-10-19",2,5,7,12,12,"Yes",2,5,2,3
"8917","2017-10-19",1,4,3,7,7,"No",1,2,2,2
"8918","2017-10-19",4,8,10,18,18,"Yes",3,7,4,4
"8919","2017-10-19",4,5,2,7,7,"No",1,1,3,2
"8920","2017-10-19",10,21,11,32,32,"No",7,4,11,10
"8921","2017-10-19",1,4,1,5,5,"Yes",1,0,2,2
"8922","2017-10-19",3,9,7,16,16,"Yes",2,5,5,4
"8923","2017-10-19",2,4,6,10,10,"Yes",2,4,1,3
"8924","2017-10-19",3,3,5,8,8,"No",3,2,1,2
"8925","2017-10-19",2,4,3,7,7,"Yes",1,2,0,4
"8926","2017-10-19",4,8,11,19,19,"Yes",5,6,4,4
"8927","2017-10-19",1,3,3,6,6,"Yes",1,2,1,2
"8928","2017-10-19",3,11,4,15,15,"Yes",2,2,5,6
"8929","2017-10-19",4,4,6,10,10,"Yes",2,4,1,3
"8930","2017-10-19",3,7,11,18,18,"No",4,7,3,4
"8931","2017-10-19",4,8,11,19,19,"Yes",5,6,4,4
"8932","2017-10-19",1,3,3,6,6,"Yes",2,1,1,2
"8933","2017-10-19",3,7,5,12,12,"No",4,1,4,3
"8934","2017-10-19",1,3,2,5,5,"Yes",1,1,1,2
"8935","2017-10-19",2,6,3,9,9,"Yes",1,2,4,2
"8936","2017-10-26",6,12,8,20,20,"Yes",3,5,6,6
"8937","2017-10-26",5,10,4,14,12,"Yes",1,3,5,5
"8938","2017-10-26",4,10,10,20,20,"Yes",3,7,5,5
"8939","2017-10-25",4,5,7,12,12,"Yes",2,5,2,3
"8940","2017-10-26",1,2,5,7,7,"Yes",2,3,1,1
"8941","2017-10-26",1,2,3,5,5,"No",1,2,1,1
"8942","2017-10-26",2,4,2,6,6,"Yes",0,2,3,1
"8943","2017-10-26",5,13,11,24,30,"Yes",6,5,5,8
"8944","2017-10-26",1,2,4,6,6,"Yes",1,3,1,1
"8945","2017-10-25",2,7,4,11,11,"Yes",3,1,4,3
"8946","2017-10-26",3,7,8,15,15,"No",4,4,3,4
"8947","2017-10-26",2,5,3,8,8,"No",2,1,3,2
"8948","2017-10-26",6,11,11,22,22,"No",5,6,6,5
"8949","2017-10-26",3,8,8,16,16,"Yes",3,5,6,2
"8950","2017-10-26",3,8,5,13,14,"Yes",2,3,4,4
"8951","2017-10-26",5,11,9,20,20,"Yes",5,4,5,6
"8952","2017-10-26",3,5,5,10,10,"Yes",2,3,2,3
"8953","2017-10-26",3,7,3,10,10,"No",2,1,3,4
"8954","2017-10-26",1,3,1,4,4,"Yes",1,NA,1,2
"8955","2017-10-26",2,9,8,17,14,"Yes",3,5,4,5
"8956","2017-10-26",3,7,2,9,9,"Yes",1,1,4,3
"8957","2017-10-26",2,5,2,7,7,"No",0,2,2,3
"8958","2017-10-26",1,3,2,5,5,"No",1,1,2,1
"8959","2017-10-26",2,4,6,10,10,"No",1,5,2,2
"8960","2017-10-26",2,3,5,8,8,"No",2,3,1,2
"8961","2017-10-26",NA,0,200,200,NA,"No",80,120,NA,NA
"8962","2017-10-26",8,13,19,32,32,NA,10,9,8,5
"8963","2017-10-26",2,3,5,8,8,"No",2,3,1,2
"8964","2017-10-26",2,9,5,14,16,"Yes",2,3,4,5
"8965","2017-10-26",3,9,3,12,12,"Yes",1,2,3,6
"8966","2017-10-26",2,4,7,11,11,"Yes",1,6,2,2
"8967","2017-10-26",3,6,3,9,9,"Yes",2,1,2,4
"8968","2017-10-19",14,7,7,14,14,"Yes",4,3,5,2
"8969","2017-10-26",4,6,9,15,16,"Yes",5,4,3,3
"8970","2017-10-26",4,8,10,18,18,"Yes",4,6,4,4
"8971","2017-10-26",1,2,2,4,5,"Yes",2,0,1,1
"8972","2017-10-26",1,2,2,4,4,"Yes",1,1,1,1
"8973","2017-10-26",2,9,6,15,15,"Yes",2,4,4,5
"8974",NA,NA,6,90,96,NA,"No",40,50,2,4
"8975","2017-10-26",1,9,1,10,10,"No",1,0,4,5
"8976","2017-10-26",5,11,23,34,34,"No",10,13,5,6
"8977","2017-10-26",NA,3,60,63,NA,NA,35,25,0,3
"8978","2017-10-26",1,7,6,13,15,"Yes",2,4,4,3
"8979","2017-11-02",5,9,4,13,13,"Yes",2,2,3,6
"8980","2017-10-26",2,5,7,12,12,"Yes",4,3,2,3
"8981","2017-10-26",5,10,2,12,12,"Yes",0,2,5,5
"8982","2017-10-26",5,8,6,14,12,"Yes",4,2,5,3
"8983","2017-10-26",1,4,4,8,8,"Yes",1,3,2,2
"8984","2017-10-26",3,7,8,15,16,"No",2,6,3,4
"8985","2017-10-26",2,4,4,8,6,"No",2,2,2,2
"8986","2017-10-26",4,13,8,21,21,"No",3,5,7,6
"8987","2017-10-26",8,18,0,18,22,"No",0,0,10,8
"8988","2017-10-26",2,6,5,11,11,"No",2,3,3,3
"8989","2017-10-26",2,4,3,7,7,"Yes",3,0,2,2
"8990","2017-10-26",1,3,4,7,7,"Yes",2,2,1,2
"8991","2017-10-26",1,4,3,7,7,"Yes",1,2,2,2
"8992","2017-10-25",2,2,5,7,9,"No",2,3,1,1
"8993","2017-10-26",1,4,7,11,10,"Yes",2,5,1,3
"8994","2017-10-26",6,11,19,30,30,"No",9,10,5,6
"8995","2017-10-26",2,4,9,13,13,"Yes",3,6,2,2
"8996","2017-10-26",6,13,1,14,14,"No",0,1,7,6
"8997","2017-10-26",3,8,3,11,11,"Yes",1,2,3,5
"8998","2017-10-26",5,8,6,14,16,"No",2,4,4,4
"8999",NA,3,7,5,12,13,"Yes",2,3,4,3
"9000","2017-10-26",5,21,19,40,43,"Yes",3,16,8,13
"9001","2017-10-26",4,7,3,10,10,"Yes",2,1,4,3
"9002","2017-10-26",1,4,0,4,4,"Yes",0,0,2,2
"9003","2017-10-26",2,4,4,8,7,"Yes",1,3,2,2
"9004","2017-10-26",1,2,3,5,5,"Yes",0,3,1,1
"9005","2017-10-26",1,4,1,5,5,"Yes",0,1,1,3
"9006","2017-10-26",1,2,2,4,4,"No",1,1,1,1
"9007","2017-10-26",3,7,6,13,14,"Yes",3,3,3,4
"9008","2017-10-26",1,3,3,6,6,NA,1,2,2,1
"9009","2017-10-26",5,14,4,18,23,"No",1,3,7,7
"9010","2017-10-26",6,11,4,15,15,"Yes",0,4,5,6
"9011","2017-10-26",1,2,4,6,6,"No",3,1,1,1
"9012","2017-10-26",1,6,1,7,6,"Yes",1,NA,2,4
"9013","2017-10-26",4,6,4,10,10,"Yes",1,3,4,2
"9014","2017-10-26",6,16,11,27,28,"Yes",5,6,7,9
"9015","2017-10-26",1,1,3,4,4,"Yes",1,2,NA,1
"9016","2017-10-26",4,7,13,20,20,"Yes",5,8,3,4
"9017","2017-10-26",1,3,8,11,11,"Yes",5,3,1,2
"9018","2017-10-26",8,16,3,19,24,"Yes",2,1,8,8
"9019","2017-10-26",6,12,11,23,23,"Yes",4,7,6,6
"9020","2017-10-26",1,3,1,4,4,"Yes",0,1,2,1
"9021","2017-10-26",1,2,2,4,4,"Yes",1,1,1,1
"9022","2017-10-26",1,6,6,12,14,"Yes",2,4,3,3
"9023","2017-10-26",1,2,2,4,4,"No",2,0,1,1
"9024","2017-10-26",1,3,4,7,7,"Yes",2,2,1,2
"9025","2017-10-26",1,3,1,4,4,"Yes",1,NA,2,1
"9026","2017-10-26",1,2,1,3,3,"Yes",1,NA,1,1
"9027","2017-10-26",NA,545,290,835,NA,"Yes",100,190,250,295
"9028","2017-10-26",2,6,1,7,7,"No",1,0,2,4
"9029","2017-10-26",4,13,7,20,18,"Yes",3,4,5,8
"9030","2017-10-26",5,18,7,25,25,"Yes",4,3,10,8
"9031","2017-10-26",1,2,3,5,3,"No",0,3,1,1
"9032","2017-10-26",2,6,4,10,10,"Yes",2,2,3,3
"9033","2017-10-26",4,11,3,14,15,"Yes",0,3,6,5
"9034","2017-10-26",1,2,2,4,4,"Yes",1,1,1,1
"9035","2017-10-26",1,4,1,5,5,"Yes",0,1,2,2
"9036","2017-10-26",1,3,2,5,5,"Yes",1,1,1,2
"9037","2017-10-26",2,7,4,11,11,"No",1,3,4,3
"9038","2017-10-26",3,8,7,15,15,"Yes",3,4,3,5
"9039","2017-10-26",1,2,3,5,5,"Yes",2,1,1,1
"9040","2017-10-26",4,8,8,16,16,"Yes",3,5,4,4
"9041","2017-10-26",5,10,4,14,14,"No",0,4,5,5
"9042","2017-10-26",NA,12,200,212,NA,"No",100,100,6,6
"9043","2017-10-26",3,6,20,26,26,"Yes",8,12,3,3
"9044","2017-10-26",1,2,1,3,3,"No",0,1,1,1
"9045","2017-10-26",5,8,12,20,18,"No",5,7,5,3
"9046","2017-10-26",NA,8,5,13,NA,"Yes",2,3,3,5
"9047","2017-10-26",3,6,4,10,10,"Yes",1,3,3,3
"9048","2017-10-26",2,4,8,12,12,"No",2,6,2,2
"9049","2017-10-26",1,4,3,7,7,"Yes",2,1,2,2
"9050","2017-10-26",4,8,17,25,25,"Yes",8,9,4,4
"9051","2017-10-26",3,8,3,11,11,"Yes",2,1,5,3
"9052","2017-10-26",3,6,5,11,11,"Yes",3,2,2,4
"9053","2017-10-26",7,12,5,17,24,"Yes",2,3,6,6
"9054","2017-10-26",1,4,2,6,6,"Yes",1,1,2,2
"9055","2017-10-26",1,6,2,8,8,"Yes",2,0,1,5
"9056","2017-10-26",1,4,3,7,7,"Yes",1,2,2,2
"9057","2017-10-26",1,2,2,4,4,"Yes",0,2,1,1
"9058","2017-10-26",1,2,5,7,7,"Yes",4,1,1,1
"9059","2017-10-26",4,9,8,17,17,"No",6,2,4,5
"9060","2017-10-26",1,2,2,4,4,"No",NA,2,1,1
"9061","2017-10-26",5,10,10,20,20,"Yes",6,4,5,5
"9062","2017-10-26",5,8,9,17,20,"Yes",3,6,4,4
"9063","2017-10-26",5,10,8,18,18,"Yes",3,5,5,5
"9064","2017-10-26",1,3,1,4,4,"No",1,0,2,1
"9065","2017-10-26",4,14,11,25,25,"Yes",5,6,5,9
"9066","2017-10-26",8,14,5,19,24,"Yes",3,2,7,7
"9067","2017-10-26",3,6,11,17,16,"Yes",6,5,3,3
"9068","2017-10-26",2,9,3,12,6,"No",1,2,5,4
"9069","2017-10-26",5,10,4,14,14,"Yes",1,3,5,5
"9070","2017-10-26",1,2,3,5,5,"No",2,1,1,1
"9071","2017-10-26",4,7,7,14,14,"No",1,6,4,3
"9072","2017-10-26",1,2,5,7,7,"Yes",1,4,1,1
"9073","2017-10-26",2,3,5,8,8,"Yes",0,5,1,2
"9074","2017-10-26",1,7,3,10,10,"Yes",2,1,4,3
"9075","2017-10-26",2,7,4,11,11,"Yes",2,2,2,5
"9076","2017-10-26",2,4,2,6,6,NA,0,2,2,2
"9077","2017-10-26",1,2,4,6,6,"Yes",1,3,1,1
"9078","2017-10-26",3,6,5,11,11,"Yes",2,3,3,3
"9079","2017-10-26",6,14,7,21,34,"Yes",4,3,6,8
"9080","2017-10-26",2,5,5,10,10,"Yes",3,2,2,3
"9081","2017-10-26",1,4,1,5,5,"Yes",0,1,2,2
"9082","2017-10-26",4,8,4,12,12,"Yes",2,2,4,4
"9083","2017-10-26",2,3,4,7,7,"No",2,2,1,2
"9084","2017-10-26",19,31,9,40,40,"Yes",4,5,19,12
"9085","2017-10-26",3,7,3,10,10,"Yes",1,2,3,4
"9086","2017-10-26",2,4,8,12,12,"Yes",3,5,2,2
"9087","2017-10-26",1,4,1,5,5,"Yes",0,1,2,2
"9088","2017-10-26",7,8,12,20,20,"Yes",5,7,5,3
"9089","2017-10-26",1,2,2,4,4,"No",2,0,1,1
"9090","2017-10-26",4,20,3,23,14,"Yes",0,3,10,10
"9091","2017-10-26",3,7,6,13,16,"Yes",4,2,3,4
"9092","2017-10-26",1,4,4,8,8,"Yes",2,2,2,2
"9093","2017-10-26",1,2,5,7,7,"Yes",3,2,1,1
"9094","2017-10-26",1,5,3,8,7,"Yes",1,2,2,3
"9095","2017-10-26",1,2,0,2,2,"No",0,0,1,1
"9096","2017-10-26",1,2,1,3,3,"Yes",0,1,1,1
"9097","2017-10-25",3,7,6,13,13,"Yes",2,4,3,4
"9098","2017-10-26",1,3,3,6,6,"Yes",1,2,2,1
"9099","2017-10-26",1,2,3,5,5,"Yes",0,3,1,1
"9100","2017-10-26",3,4,5,9,8,"Yes",0,5,2,2
"9101","2017-10-26",1,7,1,8,8,"Yes",NA,1,3,4
"9102","2017-10-26",4,8,10,18,18,"Yes",4,6,4,4
"9103","2017-10-26",NA,19,290,309,NA,"No",140,150,5,14
"9104","2017-10-26",1,2,1,3,3,"Yes",1,0,1,1
"9105","2017-10-26",1,2,6,8,8,"Yes",4,2,1,1
"9106","2017-10-26",NA,19,272,291,NA,"Yes",112,160,14,5
"9107","2017-10-26",2,3,1,4,6,"Yes",1,0,2,1
"9108","2017-10-26",6,7,9,16,15,"Yes",5,4,3,4
"9109","2017-10-26",2,5,2,7,9,"Yes",1,1,4,1
"9110","2017-10-26",1,5,3,8,8,"No",1,2,2,3
"9111","2017-10-26",4,8,8,16,16,"Yes",5,3,4,4
"9112","2017-10-26",3,6,11,17,17,"Yes",5,6,2,4
"9113","2017-10-26",3,8,7,15,15,"Yes",4,3,3,5
"9114","2017-10-26",2,7,5,12,12,"Yes",3,2,2,5
"9115","2017-10-26",3,10,2,12,13,"No",1,1,4,6
"9116","2017-10-26",3,6,9,15,15,"No",4,5,3,3
"9117","2017-10-26",5,16,5,21,21,"Yes",2,3,9,7
"9118","2017-10-26",1,2,2,4,4,"Yes",1,1,1,1
"9119","2017-10-26",2,3,7,10,10,"Yes",1,6,2,1
"9120","2017-10-25",2,3,3,6,6,"Yes",2,1,2,1
"9121","2017-10-26",NA,10,145,155,NA,"Yes",65,80,5,5
"9122","2017-10-26",2,6,3,9,9,"No",2,1,3,3
"9123","2017-10-26",1,2,2,4,4,"No",0,2,1,1
"9124","2017-10-26",1,2,3,5,5,"No",2,1,1,1
"9125","2017-10-26",NA,10,130,140,NA,"No",50,80,5,5
"9126","2017-10-26",7,12,11,23,21,"No",7,4,7,5
"9127","2017-10-26",3,6,5,11,11,"No",0,5,3,3
"9128","2017-10-26",NA,5,160,165,NA,"Yes",100,60,3,2
"9129","2017-10-26",3,6,5,11,12,"Yes",3,2,3,3
"9130","2017-10-26",1,9,2,11,10,"Yes",0,2,4,5
"9131","2017-10-26",1,2,6,8,8,"Yes",5,1,1,1
"9132","2017-10-26",2,4,5,9,9,"Yes",2,3,2,2
"9133","2017-10-26",1,2,3,5,5,"Yes",1,2,1,1
"9134","2017-10-25",1,1,4,5,5,"No",2,2,0,1
"9135","2017-10-26",1,2,0,2,3,"Yes",0,0,1,1
"9136","2017-10-26",2,4,4,8,8,"Yes",1,3,2,2
"9137","2017-10-26",2,4,7,11,10,"Yes",4,3,2,2
"9138","2017-10-26",1,5,2,7,7,"Yes",2,0,3,2
"9139","2017-10-26",1,2,2,4,5,"Yes",1,1,1,1
"9140","2017-10-26",1,5,4,9,9,"Yes",2,2,2,3
"9141","2017-10-26",1,2,3,5,5,"Yes",1,2,1,1
"9142","2017-10-25",2,6,4,10,10,"Yes",3,1,4,2
"9143","2017-10-26",1,3,4,7,7,"Yes",2,2,2,1
"9144","2017-10-26",1,4,4,8,8,"Yes",2,2,2,2
"9145","2017-10-26",2,3,4,7,7,"Yes",1,3,1,2
"9146","2017-10-26",3,6,7,13,13,"No",3,4,3,3
"9147","2017-10-26",2,4,2,6,6,"Yes",1,1,2,2
"9148","2017-10-26",1,2,4,6,6,"Yes",3,1,1,1
"9149","2017-10-26",2,4,3,7,7,"Yes",1,2,2,2
"9150","2017-10-26",1,3,4,7,7,"Yes",4,0,2,1
"9151","2017-10-26",2,10,5,15,10,"Yes",3,2,5,5
"9152","2017-10-26",2,4,6,10,10,"No",3,3,2,2
"9153","2017-10-26",1,3,1,4,4,"Yes",0,1,1,2
"9154","2017-10-26",1,2,5,7,7,"Yes",4,1,1,1
"9155","2017-10-26",1,4,4,8,8,"Yes",2,2,2,2
"9156","2017-10-25",1,4,3,7,7,"Yes",2,1,3,1
"9157","2017-10-26",1,5,5,10,10,"Yes",2,3,4,1
"9158","2017-10-26",1,2,5,7,7,"Yes",2,3,1,1
"9159",NA,4,6,6,12,12,"Yes",3,3,3,3
"9160","2017-11-02",1,3,3,6,6,"No",2,1,2,1
"9161","2017-10-26",1,2,10,12,12,"Yes",4,6,1,1
"9162","2017-10-26",1,13,0,13,4,"Yes",NA,NA,1,12
"9163","2017-10-26",1,2,4,6,6,"Yes",4,0,1,1
"9164","2017-10-26",1,5,5,10,12,"Yes",2,3,1,4
"9165","2017-10-26",3,6,8,14,17,"Yes",3,5,2,4
"9166","2017-10-26",1,2,3,5,7,"Yes",3,0,1,1
"9167","2017-10-26",2,6,9,15,13,"Yes",4,5,3,3
"9168","2017-10-26",1,2,7,9,9,"Yes",4,3,1,1
"9169","2017-10-26",2,4,2,6,6,"Yes",1,1,2,2
"9170","2017-10-26",1,2,7,9,8,"Yes",5,2,1,1
"9171","2017-10-26",2,4,4,8,8,"Yes",2,2,2,2
"9172","2017-10-26",1,2,3,5,5,"Yes",2,1,1,1
"9173","2017-10-26",2,4,4,8,8,"No",2,2,2,2
"9174","2017-10-26",4,9,6,15,8,"Yes",4,2,6,3
"9175","2017-10-26",1,2,2,4,4,"No",NA,2,1,1
"9176","2017-10-26",2,4,5,9,9,"Yes",2,3,2,2
"9177","2017-10-26",1,1,4,5,5,"Yes",3,1,1,0
"9178","2017-10-26",4,8,14,22,23,"Yes",5,9,4,4
"9179","2017-10-26",1,5,0,5,8,"Yes",0,0,2,3
"9180","2017-10-26",2,4,4,8,12,"Yes",1,3,2,2
"9181","2017-10-26",1,1,0,1,1,"Yes",0,0,0,1
"9182","2017-10-26",5,14,9,23,25,"Yes",6,3,6,8
"9183","2017-10-26",1,4,8,12,6,"No",4,4,2,2
"9184","2017-10-26",2,7,5,12,12,"No",2,3,4,3
"9185","2017-10-26",3,7,7,14,13,"No",5,2,4,3
"9186","2017-10-26",1,4,4,8,8,"Yes",1,3,1,3
"9187","2017-10-26",2,5,3,8,8,"Yes",1,2,2,3
"9188","2017-10-25",1,3,4,7,6,"Yes",1,3,1,2
"9189","2017-10-26",1,2,3,5,5,"Yes",NA,3,1,1
"9190","2017-10-26",1,3,6,9,9,"Yes",2,4,1,2
"9191","2017-10-26",4,8,12,20,20,"Yes",7,5,4,4
"9192","2017-10-26",3,6,4,10,15,"Yes",1,3,3,3
"9193","2017-10-26",4,6,4,10,10,"Yes",1,3,3,3
"9194","2017-10-26",3,6,2,8,10,"Yes",1,1,2,4
"9195","2017-10-26",3,6,4,10,10,"No",2,2,3,3
"9196","2017-10-26",1,4,3,7,7,"Yes",0,3,3,1
"9197","2017-10-26",1,2,4,6,6,"Yes",2,2,1,1
"9198","2017-10-26",1,2,5,7,7,"Yes",2,3,1,1
"9199","2017-10-26",2,8,2,10,10,"Yes",0,2,3,5
"9200","2017-10-26",1,2,6,8,5,"Yes",3,3,1,1
"9201","2017-10-26",1,2,4,6,6,"Yes",1,3,1,1
"9202","2017-10-26",3,6,9,15,15,"Yes",4,5,3,3
"9203","2017-10-26",1,2,4,6,6,"Yes",1,3,1,1
"9204","2017-10-26",10,15,10,25,45,"Yes",5,5,7,8
"9205","2017-10-26",2,8,2,10,10,"Yes",1,1,5,3
"9206","2017-10-26",1,2,2,4,4,"Yes",NA,2,1,1
"9207","2017-10-26",2,4,5,9,9,"Yes",1,4,2,2
"9208","2017-10-26",1,2,3,5,5,"No",1,2,1,1
"9209","2017-10-26",2,4,7,11,11,"No",2,5,2,2
"9210","2017-10-26",2,5,3,8,8,"Yes",2,1,2,3
"9211","2017-10-26",2,4,3,7,8,"Yes",2,1,2,2
"9212","2017-10-25",2,2,5,7,7,"Yes",3,2,1,1
"9213","2017-10-26",5,8,8,16,16,"Yes",3,5,5,3
"9214","2017-10-25",3,5,7,12,12,"Yes",2,5,2,3
"9215","2017-10-26",1,2,3,5,5,"Yes",1,2,1,1
"9216","2017-10-26",5,11,6,17,17,"Yes",3,3,7,4
"9217","2017-10-26",1,2,2,4,4,"No",1,1,1,1
"9218","2017-10-26",2,6,4,10,10,"Yes",3,1,2,4
"9219","2017-10-26",1,7,2,9,9,"Yes",1,1,3,4
"9220","2017-10-26",2,4,2,6,8,"Yes",1,1,2,2
"9221","2017-10-26",3,6,7,13,13,"Yes",4,3,3,3
"9222","2017-10-26",2,4,6,10,10,"No",3,3,2,2
"9223","2017-10-26",2,8,4,12,12,"Yes",1,3,4,4
"9224","2017-10-26",1,1,1,2,2,"Yes",0,1,0,1
"9225","2017-10-26",2,4,8,12,12,"Yes",5,3,2,2
"9226","2017-10-26",1,3,2,5,5,"Yes",1,1,1,2
"9227","2017-10-26",3,6,3,9,9,"Yes",2,1,3,3
"9228",NA,1,9,3,12,13,"Yes",2,1,5,4
"9229","2017-10-26",2,5,2,7,7,"Yes",1,1,2,3
"9230","2017-10-26",1,2,2,4,4,"No",1,1,1,1
"9231","2017-10-26",2,4,7,11,11,"No",4,3,1,3
"9232","2017-10-26",1,2,3,5,5,"Yes",1,2,1,1
"9233","2017-10-26",3,7,6,13,13,"No",1,5,3,4
"9234","2017-10-26",1,2,5,7,7,"Yes",3,2,1,1
"9235","2017-10-26",2,5,4,9,9,"No",1,3,2,3
"9236","2017-10-26",1,4,0,4,4,"No",0,0,2,2
"9237","2017-10-26",3,6,6,12,13,"Yes",2,4,3,3
"9238","2017-10-26",1,6,4,10,10,"Yes",1,3,2,4
"9239","2017-10-26",4,11,13,24,24,"Yes",7,6,5,6
"9240","2017-10-26",1,2,2,4,4,"Yes",2,NA,1,1
"9241","2017-10-26",1,2,5,7,7,"No",4,1,1,1
"9242","2017-10-25",1,2,6,8,9,"Yes",4,2,1,1
"9243","2017-10-26",1,3,3,6,6,"No",1,2,2,1
"9244","2017-10-26",2,4,1,5,5,"Yes",0,1,2,2
"9245","2017-10-26",4,7,10,17,17,"Yes",6,4,3,4
"9246","2017-10-26",3,7,6,13,16,"Yes",3,3,3,4
"9247","2017-10-26",2,4,4,8,8,"No",3,1,2,2
"9248","2017-10-26",1,2,6,8,8,"Yes",2,4,1,1
"9249","2017-10-26",8,13,8,21,38,"No",3,5,6,7
"9250","2017-10-26",1,5,4,9,8,"Yes",1,3,3,2
"9251","2017-10-26",1,5,1,6,6,"Yes",0,1,3,2
"9252","2017-10-26",3,7,5,12,12,"Yes",3,2,4,3
"9253","2017-10-26",1,2,5,7,7,"Yes",2,3,1,1
"9254","2017-10-26",1,4,3,7,7,"Yes",1,2,2,2
"9255","2017-10-26",3,5,7,12,13,"Yes",2,5,3,2
"9256","2017-10-26",1,4,0,4,4,"Yes",0,0,2,2
"9257","2017-10-26",1,3,3,6,6,"No",1,2,1,2
"9258","2017-10-26",2,8,0,8,8,"Yes",0,0,4,4
"9259","2017-10-26",1,2,0,2,2,"Yes",0,0,1,1
"9260","2017-10-26",1,2,1,3,3,"Yes",0,1,1,1
"9261","2017-10-26",NA,1,20,21,NA,"Yes",10,10,1,0
"9262","2017-10-26",1,2,2,4,4,"Yes",NA,2,1,1
"9263","2017-10-26",1,5,0,5,5,"Yes",0,0,2,3
"9264","2017-10-26",6,16,16,32,32,"Yes",6,10,6,10
"9265","2017-10-26",3,6,2,8,8,"Yes",0,2,3,3
"9266","2017-10-26",5,10,12,22,22,"No",5,7,5,5
"9267","2017-10-26",3,5,9,14,14,"Yes",3,6,2,3
"9268","2017-10-26",6,9,9,18,18,"No",5,4,5,4
"9269","2017-10-26",5,10,15,25,25,"No",7,8,5,5
"9270","2017-10-26",4,8,7,15,15,"Yes",3,4,4,4
"9271","2017-10-26",1,4,1,5,5,"Yes",1,NA,1,3
"9272","2017-10-26",4,10,6,16,16,"Yes",2,4,3,7
"9273","2017-10-26",3,5,5,10,10,"Yes",3,2,4,1
"9274",NA,3,9,6,15,15,"Yes",4,2,4,5
"9275","2017-10-26",1,2,3,5,5,"No",1,2,1,1
"9276","2017-10-26",2,9,3,12,11,"No",0,3,4,5
"9277","2017-10-26",1,2,4,6,6,"Yes",2,2,1,1
"9278","2017-10-26",4,11,9,20,22,"No",4,5,5,6
"9279","2017-10-26",1,1,2,3,3,"No",0,2,0,1
"9280","2017-10-26",5,10,10,20,20,"No",5,5,5,5
"9281","2017-10-26",3,5,7,12,12,"Yes",3,4,3,2
"9282","2017-10-26",4,11,6,17,17,"Yes",2,4,4,7
"9283","2017-10-26",1,5,3,8,8,"Yes",1,2,2,3
"9284","2017-10-26",1,3,3,6,6,"Yes",1,2,2,1
"9285","2017-10-26",4,12,5,17,17,"No",2,3,5,7
"9286","2017-10-26",1,2,4,6,6,"Yes",2,2,1,1
"9287","2017-10-26",3,7,9,16,18,"Yes",6,3,5,2
"9288","2017-10-26",2,4,9,13,13,"No",3,6,2,2
"9289","2017-10-26",1,2,3,5,5,"Yes",2,1,1,1
"9290","2017-10-26",2,7,9,16,14,"Yes",6,3,4,3
"9291","2017-10-26",2,4,14,18,18,"No",5,9,2,2
"9292","2017-10-26",3,8,4,12,12,"Yes",1,3,4,4
"9293","2017-10-26",2,2,3,5,5,"Yes",1,2,1,1
"9294","2017-10-26",1,5,1,6,6,"Yes",0,1,2,3
"9295","2017-10-26",1,2,4,6,6,"Yes",2,2,1,1
"9296","2017-10-26",2,4,0,4,4,"Yes",0,0,2,2
"9297","2017-10-26",NA,1,16,17,NA,"No",6,10,1,0
"9298","2017-10-26",1,2,3,5,5,"Yes",NA,3,1,1
"9299","2017-10-26",10,12,7,19,26,"No",3,4,6,6
"9300","2017-10-26",1,8,3,11,11,"Yes",2,1,5,3
"9301","2017-10-26",2,3,4,7,7,"Yes",2,2,1,2
"9302","2017-10-26",8,16,11,27,46,"No",4,7,7,9
"9303","2017-10-26",NA,300,45,345,NA,"Yes",15,30,120,180
"9304","2017-10-26",3,6,5,11,11,"No",5,NA,3,3
"9305","2017-10-26",1,1,2,3,3,"Yes",1,1,NA,1
"9306","2017-10-26",3,7,8,15,15,"Yes",3,5,4,3
"9307","2017-10-26",10,20,10,30,32,"No",3,7,12,8
"9308","2017-10-26",2,2,5,7,7,"Yes",2,3,1,1
"9309","2017-10-26",4,9,4,13,13,"Yes",0,4,5,4
"9310","2017-10-26",7,15,8,23,23,"Yes",3,5,8,7
"9311","2017-10-26",3,6,6,12,12,"Yes",3,3,3,3
"9312","2017-10-26",2,6,7,13,13,"Yes",5,2,2,4
"9313","2017-10-26",2,5,4,9,9,"Yes",2,2,2,3
"9314","2017-10-26",2,12,0,12,11,"No",0,0,8,4
"9315","2017-10-26",1,2,1,3,3,"Yes",NA,1,1,1
"9316","2017-10-26",5,10,21,31,31,"Yes",16,5,5,5
"9317","2017-10-26",3,8,7,15,14,"Yes",3,4,3,5
"9318","2017-10-26",6,13,13,26,27,"Yes",4,9,6,7
"9319","2017-10-26",7,11,0,11,11,"Yes",0,0,4,7
"9320","2017-10-26",1,2,4,6,6,"No",1,3,1,1
"9321","2017-10-26",1,4,4,8,8,"Yes",3,1,1,3
"9322","2017-10-26",1,11,1,12,12,"Yes",1,0,9,2
"9323","2017-10-26",3,11,7,18,18,"No",4,3,6,5
"9324","2017-10-26",2,4,4,8,8,"Yes",3,1,2,2
"9325","2017-10-26",3,6,6,12,12,"No",2,4,3,3
"9326","2017-10-26",4,11,10,21,21,"No",6,4,4,7
"9327","2017-10-26",2,4,9,13,13,"Yes",4,5,2,2
"9328","2017-10-26",2,4,3,7,7,"Yes",3,0,2,2
"9329","2017-10-26",3,6,3,9,9,"No",2,1,3,3
"9330","2017-10-26",3,6,2,8,8,"Yes",2,NA,1,5
"9331","2017-10-26",1,2,6,8,8,"Yes",3,3,1,1
"9332","2017-10-26",3,4,6,10,10,"Yes",2,4,2,2
"9333","2017-10-26",1,3,4,7,7,"No",1,3,2,1
"9334","2017-10-26",2,8,4,12,11,"No",2,2,4,4
"9335","2017-10-26",1,2,7,9,9,"Yes",4,3,1,1
"9336","2017-10-26",1,2,5,7,7,"Yes",1,4,1,1
"9337","2017-10-26",7,10,10,20,20,"Yes",1,9,5,5
"9338","2017-10-26",1,5,4,9,8,"Yes",3,1,3,2
"9339","2017-10-26",4,7,3,10,10,"No",2,1,4,3
"9340","2017-10-26",1,2,1,3,3,"No",0,1,1,1
"9341","2017-11-02",1,2,3,5,5,"Yes",2,1,1,1
"9342","2017-10-26",1,4,2,6,7,"Yes",0,2,1,3
"9343","2017-10-26",5,10,9,19,20,"Yes",2,7,5,5
"9344","2017-10-26",9,27,22,49,38,"Yes",9,13,15,12
"9345","2017-10-26",5,9,6,15,19,"Yes",3,3,4,5
"9346","2017-10-26",1,5,2,7,6,"Yes",0,2,3,2
"9347","2017-10-26",1,2,1,3,3,"Yes",1,0,0,2
"9348","2017-10-26",1,5,1,6,6,"Yes",1,0,2,3
"9349","2017-10-26",2,6,4,10,10,"Yes",2,2,4,2
"9350","2017-10-26",5,8,14,22,28,"Yes",6,8,3,5
"9351","2017-10-26",9,24,18,42,42,"No",7,11,9,15
"9352","2017-10-26",2,2,3,5,6,"No",1,2,1,1
"9353","2017-10-27",4,13,7,20,22,"Yes",4,3,4,9
"9354","2017-10-27",1,7,4,11,11,"Yes",2,2,3,4
"9355","2017-10-27",1,1,1,2,2,"Yes",1,NA,NA,1
"9356","2017-10-27",1,2,1,3,3,"Yes",1,0,1,1
"9357","2017-10-27",5,8,9,17,17,"No",4,5,4,4
"9358","2017-10-27",1,2,1,3,3,"No",0,1,1,1
"9359","2017-10-27",5,14,8,22,23,"Yes",3,5,9,5
"9360","2017-10-27",1,3,7,10,10,"Yes",4,3,1,2
"9361","2017-10-27",3,6,5,11,15,"Yes",3,2,3,3
"9362","2017-10-27",2,3,5,8,8,"Yes",2,3,1,2
"9363","2017-10-27",2,8,2,10,10,"Yes",1,1,3,5
"9364","2017-10-27",3,6,6,12,12,"Yes",1,5,3,3
"9365","2017-10-27",1,2,2,4,4,"No",1,1,1,1
"9366","2017-10-27",4,8,12,20,20,"No",5,7,4,4
"9367","2017-10-27",1,4,3,7,7,"Yes",0,3,3,1
"9368","2017-10-27",2,8,8,16,16,"Yes",3,5,4,4
"9369","2017-10-27",2,5,4,9,9,"Yes",2,2,2,3
"9370","2017-10-27",1,3,5,8,8,"Yes",3,2,2,1
"9371","2017-10-27",3,6,5,11,11,"Yes",3,2,3,3
"9372","2017-10-27",3,8,4,12,12,"Yes",2,2,4,4
"9373","2017-10-27",3,5,3,8,8,"Yes",2,1,3,2
"9374","2017-10-27",2,3,6,9,9,"No",2,4,1,2
"9375","2017-10-27",5,10,14,24,24,"No",6,8,5,5
"9376","2017-10-26",4,13,10,23,22,"No",4,6,6,7
"9377","2017-10-27",1,3,1,4,4,"Yes",1,0,1,2
"9378","2017-10-27",2,7,3,10,10,"Yes",3,0,6,1
"9379","2017-10-27",1,4,1,5,5,"Yes",1,0,2,2
"9380","2017-10-27",8,15,11,26,28,"No",3,8,10,5
"9381","2017-10-27",4,7,5,12,12,"Yes",2,3,5,2
"9382","2017-10-27",1,4,4,8,8,"Yes",1,3,2,2
"9383","2017-10-27",4,8,14,22,22,"No",5,9,4,4
"9384","2017-10-27",2,5,3,8,8,"No",1,2,2,3
"9385","2017-10-27",1,2,3,5,5,"No",1,2,1,1
"9386","2017-10-27",3,6,8,14,14,"Yes",4,4,3,3
"9387","2017-10-27",2,4,11,15,15,"Yes",8,3,2,2
"9388","2017-10-27",2,7,5,12,12,"Yes",2,3,2,5
"9389","2017-10-26",3,6,13,19,19,"Yes",6,7,3,3
"9390","2017-10-27",7,13,10,23,23,"Yes",6,4,6,7
"9391","2017-10-27",4,8,15,23,23,"No",7,8,4,4
"9392","2017-10-27",9,13,5,18,36,"Yes",2,3,7,6
"9393","2017-10-27",1,5,3,8,9,"Yes",2,1,3,2
"9394","2017-10-27",1,5,1,6,6,"Yes",0,1,1,4
"9395","2017-10-27",1,2,6,8,8,"Yes",4,2,1,1
"9396","2017-10-27",1,5,3,8,6,"Yes",2,1,2,3
"9397","2017-10-27",1,3,4,7,8,"Yes",2,2,2,1
"9398","2017-10-27",3,7,5,12,12,"Yes",2,3,3,4
"9399","2017-10-27",2,4,0,4,9,"No",NA,NA,2,2
"9400","2017-10-27",5,19,9,28,29,"Yes",4,5,9,10
"9401","2017-10-27",10,19,14,33,32,"Yes",9,5,10,9
"9402","2017-10-27",7,14,19,33,40,"Yes",9,10,7,7
"9403","2017-10-27",1,2,5,7,7,"Yes",2,3,1,1
"9404","2017-10-27",2,5,5,10,10,"Yes",2,3,3,2
"9405","2017-10-27",4,8,9,17,13,"Yes",1,8,4,4
"9406","2017-10-27",1,4,5,9,6,"Yes",4,1,2,2
"9407","2017-10-27",3,6,2,8,8,"Yes",2,0,3,3
"9408","2017-10-27",6,7,8,15,15,"Yes",3,5,3,4
"9409","2017-10-27",NA,7,310,317,NA,"Yes",130,180,4,3
"9410","2017-10-27",1,2,8,10,10,"Yes",4,4,1,1
"9411","2017-10-27",3,8,10,18,17,"Yes",3,7,4,4
"9412","2017-10-27",4,13,5,18,18,"No",2,3,4,9
"9413","2017-10-27",5,10,8,18,18,"Yes",4,4,5,5
"9414","2017-10-27",4,7,10,17,17,"No",5,5,4,3
"9415","2017-10-27",4,10,7,17,18,"No",2,5,6,4
"9416","2017-10-27",4,6,4,10,12,"Yes",1,3,3,3
"9417","2017-10-27",1,4,2,6,6,"Yes",1,1,3,1
"9418","2017-10-27",3,8,14,22,22,"No",6,8,3,5
"9419","2017-10-27",4,8,7,15,15,"Yes",4,3,4,4
"9420","2017-10-27",3,5,6,11,11,"Yes",4,2,1,4
"9421","2017-10-27",4,5,4,9,10,"Yes",1,3,4,1
"9422","2017-10-27",2,4,5,9,9,"Yes",3,2,2,2
"9423","2017-10-27",7,15,7,22,28,"Yes",3,4,7,8
"9424","2017-10-27",1,2,5,7,7,NA,2,3,1,1
"9425","2017-10-27",3,5,6,11,11,"No",3,3,2,3
"9426","2017-10-27",3,8,7,15,15,"Yes",5,2,4,4
"9427","2017-10-27",4,9,11,20,20,"Yes",5,6,4,5
"9428","2017-10-27",4,38,5,43,17,"No",2,3,34,4
"9429","2017-10-27",2,6,6,12,12,"Yes",2,4,3,3
"9430","2017-10-27",3,6,9,15,15,"Yes",5,4,3,3
"9431","2017-10-27",1,5,6,11,11,"Yes",3,3,3,2
"9432","2017-10-27",4,7,7,14,14,"Yes",4,3,4,3
"9433","2017-10-27",3,8,5,13,12,"Yes",4,1,3,5
"9434","2017-10-27",5,10,16,26,26,"No",9,7,5,5
"9435","2017-10-27",3,6,8,14,14,"Yes",4,4,3,3
"9436","2017-10-27",1,4,2,6,7,"Yes",2,0,2,2
"9437","2017-10-27",4,6,7,13,13,"Yes",2,5,3,3
"9438","2017-10-27",3,8,0,8,15,"Yes",0,0,4,4
"9439","2017-10-27",3,10,8,18,19,"Yes",6,2,5,5
"9440","2017-10-27",3,9,11,20,20,"Yes",5,6,4,5
"9441","2017-10-27",1,4,2,6,6,"Yes",2,0,2,2
"9442","2017-10-27",1,3,0,3,3,"No",0,0,2,1
"9443","2017-10-27",3,6,5,11,13,"Yes",2,3,3,3
"9444","2017-10-27",3,7,7,14,14,"Yes",3,4,5,2
"9445","2017-10-27",1,7,2,9,8,"Yes",1,1,4,3
"9446","2017-10-27",3,5,5,10,10,"Yes",2,3,3,2
"9447","2017-10-27",1,5,2,7,7,"No",2,0,3,2
"9448","2017-10-27",3,6,6,12,12,"No",3,3,3,3
"9449","2017-10-27",2,1,0,1,1,"Yes",0,0,1,0
"9450","2017-10-27",2,7,6,13,14,"Yes",3,3,2,5
"9451","2017-10-27",6,12,16,28,28,"No",13,3,6,6
"9452","2017-10-27",7,14,9,23,23,"No",2,7,7,7
"9453","2017-10-27",1,3,5,8,8,"Yes",3,2,1,2
"9454","2017-10-27",1,2,2,4,4,"Yes",1,1,0,2
"9455","2017-10-27",2,6,6,12,12,"No",2,4,2,4
"9456","2017-10-27",1,6,3,9,9,"Yes",2,1,4,2
"9457","2017-10-27",1,2,3,5,5,"Yes",1,2,1,1
"9458","2017-10-27",3,8,4,12,15,"Yes",2,2,4,4
"9459","2017-10-27",1,2,2,4,4,"Yes",1,1,1,1
"9460","2017-10-27",2,3,5,8,8,"No",2,3,2,1
"9461","2017-10-27",1,2,3,5,5,"Yes",1,2,1,1
"9462","2017-10-27",4,9,7,16,16,"Yes",3,4,4,5
"9463","2017-10-27",3,8,6,14,16,"Yes",2,4,3,5
"9464","2017-10-27",2,4,4,8,8,"Yes",1,3,2,2
"9465","2017-10-27",5,10,3,13,15,"Yes",3,0,5,5
"9466","2017-10-27",4,9,4,13,13,"Yes",1,3,4,5
"9467","2017-10-27",7,12,20,32,32,"Yes",10,10,7,5
"9468","2017-10-27",4,15,12,27,27,"No",5,7,5,10
"9469","2017-10-27",3,8,5,13,13,"Yes",3,2,5,3
"9470","2017-10-27",5,11,11,22,22,"Yes",7,4,5,6
"9471","2017-10-27",5,9,5,14,16,"Yes",3,2,5,4
"9472","2017-10-27",2,4,5,9,9,"Yes",2,3,2,2
"9473","2017-10-27",4,10,2,12,12,"Yes",0,2,5,5
"9474","2017-10-27",1,5,4,9,9,"Yes",2,2,3,2
"9475","2017-10-27",1,3,5,8,8,"Yes",2,3,1,2
"9476","2017-10-27",1,4,2,6,6,"Yes",2,0,1,3
"9477","2017-10-27",1,3,2,5,5,"Yes",1,1,1,2
"9478","2017-10-27",4,7,5,12,12,"Yes",3,2,4,3
"9479","2017-10-27",6,12,16,28,28,"Yes",7,9,6,6
"9480","2017-10-27",1,5,0,5,5,"Yes",0,0,4,1
"9481","2017-10-27",5,10,10,20,20,"No",1,9,5,5
"9482","2017-10-27",1,4,2,6,6,"Yes",0,2,1,3
"9483","2017-10-27",1,3,5,8,8,"Yes",3,2,1,2
"9484","2017-10-27",6,12,16,28,28,"Yes",9,7,6,6
"9485","2017-10-27",3,7,3,10,10,"Yes",2,1,3,4
"9486","2017-11-03",1,76,0,76,6,"Yes",0,0,68,8
"9487","2017-10-27",1,2,3,5,5,"No",1,2,1,1
"9488","2017-10-27",2,4,9,13,13,"Yes",4,5,2,2
"9489","2017-10-27",1,2,3,5,5,"Yes",2,1,1,1
"9490","2017-10-27",1,1,0,1,1,"Yes",0,0,1,0
"9491","2017-10-27",1,2,5,7,7,"No",2,3,1,1
"9492","2017-10-27",1,2,1,3,3,"Yes",1,NA,1,1
"9493","2017-10-27",2,5,1,6,6,"Yes",0,1,3,2
"9494","2017-10-27",3,5,7,12,12,"Yes",2,5,3,2
"9495","2017-10-27",2,5,8,13,13,"Yes",4,4,2,3
"9496","2017-10-27",NA,17,150,167,NA,"No",70,80,16,1
"9497","2017-10-27",2,7,5,12,10,"No",2,3,4,3
"9498","2017-10-27",1,4,3,7,7,"No",2,1,1,3
"9499","2017-10-27",4,14,8,22,23,"Yes",6,2,8,6
"9500","2017-10-26",1,2,0,2,2,"No",0,0,1,1
"9501","2017-10-27",4,7,12,19,19,"Yes",3,9,4,3
"9502","2017-10-27",4,8,9,17,17,"Yes",5,4,4,4
"9503","2017-10-27",4,8,1,9,9,"Yes",0,1,4,4
"9504","2017-10-27",2,4,5,9,9,"Yes",1,4,2,2
"9505","2017-10-27",5,10,8,18,18,"No",4,4,6,4
"9506","2017-10-27",4,5,7,12,12,"Yes",4,3,2,3
"9507","2017-10-27",2,8,2,10,9,"Yes",0,2,3,5
"9508",NA,6,12,2,14,16,"No",1,1,6,6
"9509","2017-10-27",2,4,8,12,12,"Yes",4,4,2,2
"9510","2017-10-27",1,3,2,5,5,"Yes",0,2,2,1
"9511","2017-10-27",3,6,3,9,9,"Yes",0,3,1,5
"9512","2017-10-27",2,7,5,12,12,"No",2,3,4,3
"9513","2017-10-27",1,2,6,8,8,"Yes",5,1,1,1
"9514","2017-10-27",3,7,2,9,12,"Yes",2,NA,3,4
"9515","2017-10-27",3,10,9,19,19,"Yes",3,6,5,5
"9516","2017-10-27",5,14,11,25,25,"No",6,5,5,9
"9517","2017-10-27",4,11,10,21,21,"Yes",4,6,5,6
"9518","2017-10-27",4,7,3,10,10,"Yes",2,1,4,3
"9519","2017-10-27",6,10,9,19,18,"Yes",4,5,5,5
"9520","2017-10-27",1,3,3,6,6,"Yes",1,2,2,1
"9521","2017-10-27",1,4,5,9,9,"Yes",1,4,2,2
"9522","2017-10-27",2,7,5,12,12,"Yes",2,3,4,3
"9523","2017-10-27",3,7,3,10,11,"Yes",2,1,3,4
"9524","2017-10-27",6,11,9,20,20,"Yes",4,5,6,5
"9525","2017-10-27",6,10,13,23,23,NA,6,7,5,5
"9526","2017-10-27",4,8,4,12,12,"Yes",1,3,4,4
"9527","2017-10-27",115,5,7,12,12,"No",3,4,3,2
"9528","2017-10-27",3,6,12,18,18,"Yes",4,8,3,3
"9529","2017-10-27",2,5,3,8,8,"Yes",0,3,2,3
"9530","2017-10-27",1,4,1,5,5,"Yes",1,0,2,2
"9531","2017-10-27",4,7,5,12,12,"No",2,3,4,3
"9532","2017-10-27",1,6,2,8,6,"Yes",1,1,3,3
"9533","2017-10-27",2,6,4,10,10,"Yes",3,1,3,3
"9534","2017-10-27",3,5,7,12,12,"No",4,3,2,3
"9535","2017-10-27",1,4,3,7,7,"Yes",NA,3,2,2
"9536","2017-10-27",2,6,4,10,10,"Yes",2,2,2,4
"9537","2017-10-27",3,8,8,16,16,"Yes",5,3,4,4
"9538","2017-10-27",4,8,7,15,15,"No",3,4,3,5
"9539","2017-10-27",2,8,2,10,10,"No",0,2,3,5
"9540","2017-10-27",3,3,6,9,9,"Yes",0,6,0,3
"9541","2017-10-27",1,2,1,3,3,"Yes",1,NA,1,1
"9542","2017-10-27",1,2,3,5,5,"Yes",1,2,1,1
"9543","2017-10-27",5,11,7,18,18,"Yes",5,2,7,4
"9544","2017-10-27",3,6,10,16,15,"No",3,7,3,3
"9545","2017-10-27",5,10,11,21,21,"No",7,4,5,5
"9546","2017-10-27",3,9,6,15,15,"No",2,4,3,6
"9547","2017-10-27",6,11,17,28,28,"No",10,7,6,5
"9548","2017-10-27",3,7,6,13,13,"Yes",2,4,4,3
"9549","2017-10-27",1,5,4,9,9,"Yes",1,3,2,3
"9550","2017-10-27",1,3,4,7,7,"Yes",2,2,1,2
"9551","2017-10-27",1,2,4,6,6,"Yes",1,3,1,1
"9552","2017-10-27",1,2,5,7,7,"Yes",2,3,1,1
"9553","2017-10-27",5,10,5,15,20,"No",2,3,5,5
"9554","2017-10-27",1,4,3,7,7,"No",1,2,2,2
"9555","2017-10-27",1,4,7,11,11,"Yes",4,3,2,2
"9556","2017-10-27",5,9,12,21,21,"No",7,5,5,4
"9557","2017-10-27",4,8,10,18,18,"No",6,4,4,4
"9558","2017-10-27",2,6,2,8,8,"No",1,1,3,3
"9559","2017-10-27",1,4,2,6,5,"Yes",0,2,0,4
"9560","2017-10-27",1,3,5,8,8,"Yes",2,3,2,1
"9561","2017-10-27",1,3,3,6,6,"Yes",2,1,1,2
"9562","2017-10-27",1,2,3,5,6,"Yes",0,3,1,1
"9563","2017-10-27",2,12,6,18,15,"Yes",0,6,3,9
"9564","2017-10-27",2,4,5,9,9,"Yes",3,2,2,2
"9565","2017-10-27",2,7,8,15,15,"No",4,4,3,4
"9566","2017-10-27",2,4,5,9,9,"Yes",1,4,2,2
"9567","2017-10-27",10,9,11,20,22,"No",7,4,4,5
"9568","2017-10-27",4,6,0,6,7,"Yes",0,0,4,2
"9569","2017-10-27",3,6,6,12,12,"Yes",3,3,2,4
"9570","2017-10-27",7,14,16,30,35,"Yes",6,10,7,7
"9571","2017-10-27",2,3,5,8,8,"No",1,4,1,2
"9572","2017-10-27",5,15,7,22,27,"Yes",4,3,6,9
"9573","2017-10-27",6,10,8,18,18,"Yes",3,5,6,4
"9574","2017-10-27",1,5,6,11,11,"Yes",3,3,3,2
"9575","2017-10-27",1,3,8,11,11,"Yes",3,5,2,1
"9576","2017-10-27",2,4,5,9,9,"Yes",2,3,2,2
"9577","2017-10-27",1,3,3,6,6,"No",NA,3,1,2
"9578","2017-10-27",2,4,5,9,9,"Yes",2,3,2,2
"9579","2017-10-27",2,5,10,15,14,"Yes",5,5,1,4
"9580","2017-10-27",1,2,7,9,9,"Yes",3,4,1,1
"9581","2017-10-27",3,8,6,14,14,"No",4,2,3,5
"9582","2017-10-27",1,1,5,6,6,"Yes",3,2,0,1
"9583","2017-10-27",NA,4,125,129,NA,"Yes",50,75,1,3
"9584","2017-10-27",3,8,7,15,15,"No",3,4,4,4
"9585","2017-10-27",5,13,10,23,22,"Yes",3,7,7,6
"9586","2017-10-27",1,2,3,5,5,"No",2,1,1,1
"9587","2017-10-27",1,2,6,8,8,"Yes",5,1,1,1
"9588","2017-10-27",5,15,14,29,29,"Yes",6,8,6,9
"9589","2017-10-27",1,2,2,4,4,"No",1,1,1,1
"9590","2017-10-27",2,5,6,11,11,"No",3,3,2,3
"9591","2017-10-27",1,2,3,5,5,"No",0,3,1,1
"9592","2017-10-27",3,8,5,13,13,"No",2,3,5,3
"9593","2017-10-27",1,3,0,3,3,"No",0,0,3,0
"9594","2017-10-27",4,8,4,12,12,"No",2,2,4,4
"9595","2017-10-27",4,4,8,12,12,"Yes",3,5,2,2
"9596","2017-10-27",1,2,4,6,7,"Yes",1,3,0,2
"9597","2017-10-27",1,2,3,5,5,"Yes",0,3,1,1
"9598","2017-10-27",5,11,9,20,20,"Yes",3,6,6,5
"9599","2017-10-27",1,4,4,8,8,"Yes",1,3,2,2
"9600","2017-10-27",3,6,9,15,15,"Yes",4,5,3,3
"9601","2017-11-03",3,4,5,9,15,"Yes",2,3,2,2
"9602","2017-10-27",2,4,6,10,19,"Yes",2,4,2,2
"9603","2017-10-27",1,4,2,6,5,"No",1,1,2,2
"9604","2017-10-27",4,8,7,15,15,"Yes",2,5,4,4
"9605","2017-10-27",2,9,10,19,19,"No",4,6,3,6
"9606","2017-10-27",1,2,4,6,6,"Yes",1,3,1,1
"9607","2017-10-27",1,3,0,3,3,"Yes",0,0,2,1
"9608","2017-10-27",1,5,2,7,7,"No",1,1,2,3
"9609","2017-10-27",1,3,4,7,7,"Yes",2,2,1,2
"9610","2017-10-27",4,10,10,20,20,"Yes",4,6,4,6
"9611",NA,3,8,3,11,12,"Yes",2,1,2,6
"9612","2017-10-27",5,9,11,20,20,"Yes",8,3,5,4
"9613","2017-10-27",1,4,4,8,8,"Yes",1,3,2,2
"9614","2017-10-27",1,2,2,4,4,"No",NA,2,1,1
"9615","2017-10-27",1,3,3,6,6,"Yes",1,2,2,1
"9616","2017-10-27",2,3,5,8,8,"No",4,1,1,2
"9617","2017-10-27",4,8,7,15,17,"Yes",1,6,4,4
"9618","2017-10-27",2,5,7,12,12,"No",3,4,2,3
"9619","2017-10-27",3,6,3,9,9,"Yes",0,3,3,3
"9620",NA,4,7,5,12,12,"No",3,2,4,3
"9621","2017-10-27",3,9,8,17,17,"No",4,4,4,5
"9622","2017-10-27",2,4,4,8,8,"No",1,3,2,2
"9623","2017-10-27",1,3,4,7,8,"No",2,2,1,2
"9624","2017-10-27",3,5,6,11,11,"No",2,4,3,2
"9625","2017-10-27",7,16,5,21,25,"Yes",2,3,7,9
"9626","2017-10-27",4,8,7,15,15,"Yes",2,5,4,4
"9627","2017-10-27",3,6,14,20,20,"No",7,7,3,3
"9628","2017-10-27",3,5,0,5,5,"No",0,0,0,5
"9629","2017-10-27",1,1,3,4,4,"Yes",2,1,0,1
"9630","2017-10-27",1,4,2,6,6,"Yes",1,1,1,3
"9631","2017-10-27",5,13,9,22,21,"Yes",4,5,6,7
"9632","2017-10-27",2,5,4,9,9,"Yes",0,4,2,3
"9633","2017-10-27",1,4,4,8,8,"Yes",2,2,1,3
"9634","2017-10-27",NA,8,0,8,8,"No",0,0,4,4
"9635","2017-10-27",1,4,0,4,4,"Yes",0,0,1,3
"9636","2017-10-27",1,8,0,8,7,"Yes",0,0,1,7
"9637","2017-10-27",2,5,3,8,8,"Yes",1,2,2,3
"9638","2017-10-27",NA,17,0,17,NA,"Yes",0,0,15,2
"9639","2017-10-27",2,4,4,8,8,"No",1,3,2,2
"9640","2017-10-27",1,3,5,8,8,"Yes",2,3,2,1
"9641","2017-10-27",2,4,3,7,7,"Yes",3,0,2,2
"9642","2017-10-27",4,13,14,27,27,"Yes",10,4,6,7
"9643","2017-10-27",1,2,6,8,8,"Yes",1,5,1,1
"9644","2017-10-27",3,6,8,14,14,"No",5,3,3,3
"9645","2017-10-27",1,2,3,5,5,"Yes",1,2,1,1
"9646","2017-10-27",2,5,0,5,5,"Yes",0,0,3,2
"9647","2017-10-27",2,6,2,8,12,"Yes",1,1,3,3
"9648","2017-10-27",1,5,5,10,10,"Yes",3,2,2,3
"9649","2017-10-27",4,7,3,10,10,"No",0,3,4,3
"9650","2017-10-27",NA,3,4,7,7,"Yes",2,2,2,1
"9651","2017-10-27",2,2,6,8,8,"Yes",1,5,1,1
"9652","2017-10-27",2,4,8,12,12,"Yes",3,5,2,2
"9653","2017-10-27",3,9,8,17,17,"Yes",4,4,5,4
"9654","2017-10-27",1,3,2,5,5,"No",1,1,1,2
"9655","2017-10-27",4,8,10,18,18,"Yes",4,6,4,4
"9656","2017-10-27",4,11,11,22,22,"No",5,6,5,6
"9657","2017-10-27",1,3,2,5,5,"No",1,1,2,1
"9658","2017-10-27",3,10,3,13,13,"No",2,1,3,7
"9659","2017-10-27",1,5,4,9,9,"No",1,3,2,3
"9660","2017-10-27",1,1,11,12,3,"Yes",8,3,0,1
"9661","2017-10-27",1,3,3,6,6,"No",2,1,1,2
"9662","2017-10-27",9,16,8,24,37,"Yes",3,5,7,9
"9663","2017-10-27",1,5,2,7,7,"Yes",0,2,2,3
"9664","2017-10-27",1,6,5,11,7,"Yes",2,3,2,4
"9665","2017-10-27",2,4,6,10,10,"Yes",2,4,2,2
"9666","2017-10-27",1,3,2,5,5,"Yes",1,1,1,2
"9667","2017-10-27",NA,6,99,105,NA,"No",45,54,3,3
"9668","2017-10-27",1,6,2,8,8,"No",1,1,4,2
"9669","2017-10-27",2,5,7,12,10,"No",3,4,2,3
"9670","2017-10-27",1,2,5,7,7,"No",2,3,1,1
"9671","2017-10-27",1,2,4,6,6,"No",1,3,1,1
"9672","2017-10-27",2,4,7,11,11,"No",2,5,2,2
"9673","2017-10-27",2,6,3,9,9,"No",1,2,3,3
"9674","2017-10-27",7,11,9,20,20,"No",5,4,5,6
"9675","2017-10-27",3,10,9,19,19,"Yes",4,5,4,6
"9676","2017-10-27",1,8,2,10,11,"Yes",1,1,5,3
"9677","2017-10-27",3,5,7,12,12,"No",4,3,3,2
"9678","2017-10-27",1,2,1,3,3,"Yes",NA,1,1,1
"9679","2017-10-27",2,7,4,11,11,"Yes",2,2,3,4
"9680","2017-10-27",2,5,4,9,9,"Yes",2,2,2,3
"9681","2017-10-27",4,8,7,15,15,"Yes",5,2,4,4
"9682","2017-10-27",4,11,9,20,20,"No",4,5,4,7
"9683","2017-10-27",NA,195,0,195,NA,"No",NA,NA,100,95
"9684","2017-10-27",1,3,5,8,8,"Yes",3,2,1,2
"9685","2017-10-27",6,13,11,24,24,"No",6,5,7,6
"9686","2017-10-27",5,10,16,26,26,"No",9,7,5,5
"9687","2017-10-27",3,10,11,21,21,"Yes",6,5,4,6
"9688","2017-10-27",3,8,7,15,15,"No",3,4,4,4
"9689","2017-10-27",1,3,6,9,9,"Yes",2,4,2,1
"9690","2017-10-26",2,5,3,8,8,"No",0,3,3,2
"9691","2017-10-27",4,8,3,11,13,"Yes",3,0,4,4
"9692","2017-10-27",1,3,3,6,6,"No",2,1,2,1
"9693","2017-10-27",3,7,11,18,19,"Yes",6,5,4,3
"9694","2017-10-19",2,7,7,14,14,"No",2,5,4,3
"9695","2017-10-30",1,5,3,8,8,"Yes",2,1,3,2
"9696","2017-10-30",1,2,3,5,5,"No",2,1,1,1
"9697","2017-10-30",3,8,6,14,14,"Yes",2,4,4,4
"9698","2017-10-30",4,10,1,11,7,"Yes",0,1,5,5
"9699","2017-10-30",NA,6,8,14,14,"Yes",1,7,3,3
"9700","2017-10-30",1,7,1,8,7,"Yes",0,1,3,4
"9701","2017-10-30",3,7,3,10,10,"Yes",3,0,3,4
"9702","2017-10-30",3,6,1,7,9,"Yes",0,1,3,3
"9703","2017-10-28",3,8,7,15,15,"No",3,4,5,3
"9704","2017-10-30",3,6,6,12,12,"No",1,5,3,3
"9705","2017-10-30",6,13,17,30,31,"Yes",4,13,4,9
"9706","2017-10-29",3,8,6,14,15,"Yes",3,3,4,4
"9707","2017-10-30",3,5,10,15,12,"Yes",3,7,2,3
"9708",NA,NA,0,0,0,NA,NA,NA,NA,NA,NA
"9709","2017-10-23",1,4,1,5,5,"No",1,0,2,2
"9710","2017-10-30",1,9,1,10,9,"Yes",0,1,3,6
"9711","2017-10-30",1,3,2,5,5,"Yes",1,1,2,1
"9712","2017-10-30",4,10,10,20,20,"Yes",3,7,5,5
"9713","2017-10-30",1,6,0,6,6,"Yes",0,0,4,2
"9714","2017-10-30",2,5,4,9,9,"Yes",3,1,2,3
"9715","2017-10-30",2,4,6,10,10,"Yes",2,4,2,2
"9716","2017-10-30",1,2,4,6,6,"Yes",1,3,1,1
"9717","2017-10-28",1,6,0,6,6,"Yes",0,0,3,3
"9718","2017-10-30",1,2,4,6,6,"Yes",3,1,1,1
"9719","2017-10-30",2,4,4,8,8,"Yes",1,3,2,2
"9720","2017-10-30",NA,6,6,12,3,"No",2,4,3,3
"9721","2017-10-30",2,7,3,10,8,NA,1,2,4,3
"9722","2017-10-30",1,5,6,11,11,"Yes",2,4,2,3
"9723","2017-10-30",1,4,5,9,9,"Yes",2,3,2,2
"9724","2017-10-30",2,2,6,8,8,"Yes",2,4,1,1
"9725","2017-10-30",1,3,2,5,5,"Yes",1,1,1,2
"9726","2017-10-30",3,6,4,10,10,"Yes",1,3,3,3
"9727","2017-10-30",2,4,4,8,7,"No",1,3,2,2
"9728","2017-10-30",3,7,3,10,10,"Yes",2,1,4,3
"9729","2017-10-30",1,4,4,8,8,"Yes",1,3,1,3
"9730","2017-10-30",2,4,4,8,7,"No",3,1,2,2
"9731","2017-10-28",3,6,3,9,12,"Yes",1,2,3,3
"9732","2017-10-30",2,4,1,5,5,"No",1,0,2,2
"9733","2017-10-30",3,8,3,11,11,"Yes",2,1,3,5
"9734","2017-10-30",4,9,3,12,12,"Yes",2,1,5,4
"9735","2017-10-30",1,3,5,8,8,"No",NA,5,2,1
"9736","2017-10-30",1,3,3,6,6,"No",2,1,1,2
"9737","2017-10-30",1,4,2,6,6,"No",2,0,1,3
"9738","2017-10-30",NA,5,53,58,NA,"Yes",25,28,2,3
"9739","2017-10-30",1,3,4,7,7,"Yes",3,1,1,2
"9740","2017-10-28",2,5,8,13,14,"No",6,2,3,2
"9741","2017-10-28",4,9,5,14,20,"No",4,1,3,6
"9742","2017-10-30",1,4,3,7,7,"Yes",2,1,2,2
"9743","2017-10-30",1,7,1,8,8,"Yes",NA,1,5,2
"9744","2017-10-30",2,5,9,14,13,"No",4,5,2,3
"9745","2017-10-31",3,7,5,12,15,"Yes",3,2,3,4
"9746","2017-10-30",1,1,3,4,5,"No",1,2,0,1
"9747","2017-10-30",1,3,4,7,7,"Yes",0,4,1,2
"9748","2017-10-30",3,4,5,9,9,"Yes",2,3,1,3
"9749","2017-10-28",1,2,4,6,6,"Yes",2,2,1,1
"9750","2017-10-30",2,6,6,12,12,"No",2,4,3,3
"9751","2017-10-30",4,9,6,15,14,"No",2,4,4,5
"9752","2017-10-30",1,5,5,10,10,"Yes",3,2,1,4
"9753","2017-10-30",2,8,3,11,14,"Yes",1,2,5,3
"9754","2017-10-30",1,2,3,5,5,"Yes",2,1,1,1
"9755","2017-10-30",2,4,2,6,6,"Yes",0,2,2,2
"9756","2017-10-30",3,8,11,19,19,"Yes",7,4,5,3
"9757","2017-10-30",4,12,6,18,18,"Yes",4,2,4,8
"9758","2017-10-28",1,12,7,19,8,"No",3,4,6,6
"9759","2017-10-30",1,2,3,5,5,"Yes",1,2,1,1
"9760","2017-10-30",1,6,2,8,6,"Yes",0,2,2,4
"9761","2017-10-30",1,2,2,4,4,"Yes",NA,2,1,1
"9762","2017-10-30",NA,1,50,51,NA,"No",20,30,1,NA
"9763","2017-10-30",1,5,0,5,5,"Yes",NA,NA,3,2
"9764","2017-10-30",2,4,7,11,11,"Yes",1,6,2,2
"9765","2017-10-30",2,5,3,8,8,"Yes",1,2,3,2
"9766","2017-10-30",1,6,3,9,9,"Yes",2,1,2,4
"9767","2017-10-30",1,2,4,6,6,"Yes",1,3,1,1
"9768","2017-10-30",1,10,6,16,8,"No",2,4,3,7
"9769","2017-10-30",3,6,7,13,13,"No",4,3,3,3
"9770","2017-10-23",4,15,5,20,20,"No",2,3,8,7
"9771","2017-10-30",3,6,3,9,9,"Yes",2,1,3,3
"9772","2017-10-30",4,10,3,13,13,"Yes",2,1,5,5
"9773","2017-10-30",1,3,4,7,7,"Yes",3,1,1,2
"9774","2017-10-28",2,3,8,11,15,"Yes",4,4,1,2
"9775","2017-10-30",2,4,6,10,10,"No",3,3,2,2
"9776","2017-10-30",3,10,10,20,20,"Yes",4,6,3,7
"9777","2017-10-30",1,5,0,5,5,"Yes",NA,NA,3,2
"9778","2017-10-27",1,4,1,5,5,"No",NA,1,2,2
"9779","2017-10-30",1,4,2,6,6,"Yes",2,0,1,3
"9780","2017-10-30",3,6,4,10,10,"No",3,1,4,2
"9781","2017-10-30",2,7,1,8,8,"No",0,1,3,4
"9782","2017-10-30",1,5,0,5,5,"Yes",0,0,2,3
"9783","2017-10-30",3,6,5,11,11,"Yes",1,4,3,3
"9784","2017-10-28",2,4,4,8,8,"No",1,3,2,2
"9785","2017-10-30",3,7,10,17,17,"Yes",5,5,5,2
"9786","2017-10-30",2,4,3,7,7,"Yes",1,2,1,3
"9787","2017-10-30",2,5,5,10,10,"Yes",2,3,3,2
"9788","2017-10-30",3,5,8,13,13,"Yes",3,5,3,2
"9789","2017-10-30",2,7,4,11,11,"No",2,2,3,4
"9790","2017-10-28",3,4,1,5,8,"Yes",1,NA,2,2
"9791","2017-10-28",1,2,10,12,12,"Yes",2,8,1,1
"9792","2017-10-30",1,5,3,8,8,"Yes",1,2,2,3
"9793",NA,NA,22,0,22,NA,"No",0,0,10,12
"9794","2017-10-30",4,9,3,12,13,"No",2,1,4,5
"9795","2017-10-30",1,2,8,10,10,"No",2,6,1,1
"9796","2017-10-30",2,4,6,10,10,"Yes",2,4,2,2
"9797","2017-10-30",1,2,1,3,3,"Yes",1,0,1,1
"9798","2017-10-30",3,9,7,16,16,"Yes",3,4,4,5
"9799","2017-10-30",1,2,2,4,4,"Yes",1,1,1,1
"9800","2017-10-30",5,11,9,20,20,"No",6,3,7,4
"9801","2017-10-30",4,5,10,15,15,"No",5,5,2,3
"9802","2017-10-30",3,9,7,16,16,"No",4,3,3,6
"9803","2017-10-28",1,4,0,4,5,"No",0,0,2,2
"9804","2017-10-30",2,4,7,11,11,"Yes",4,3,2,2
"9805","2017-10-30",1,37,0,37,36,"Yes",NA,NA,25,12
"9806","2017-10-30",1,5,2,7,7,"No",2,0,2,3
"9807","2017-10-30",1,2,6,8,8,"Yes",2,4,1,1
"9808","2017-10-30",3,10,10,20,20,"Yes",5,5,6,4
"9809","2017-10-30",2,4,2,6,6,"No",1,1,2,2
"9810","2017-10-26",2,2,6,8,8,"No",2,4,1,1
"9811","2017-10-30",1,3,0,3,3,"Yes",0,0,2,1
"9812","2017-10-30",4,14,9,23,22,NA,3,6,5,9
"9813","2017-10-30",1,4,2,6,6,"Yes",0,2,2,2
"9814","2017-10-30",1,5,1,6,6,"Yes",0,1,3,2
"9815","2017-10-30",2,4,11,15,15,"Yes",5,6,2,2
"9816","2017-10-30",1,2,2,4,4,"Yes",1,1,1,1
"9817","2017-10-30",2,3,8,11,11,"Yes",2,6,2,1
"9818","2017-10-23",2,5,4,9,9,"No",2,2,3,2
"9819","2017-10-30",1,3,2,5,5,"Yes",1,1,2,1
"9820","2017-10-30",1,5,3,8,9,"Yes",2,1,2,3
"9821","2017-10-28",1,2,4,6,6,"Yes",1,3,1,1
"9822","2017-10-28",1,5,0,5,5,"Yes",0,0,2,3
"9823","2017-10-30",1,4,1,5,5,"No",0,1,2,2
"9824","2017-10-30",3,5,7,12,12,"No",3,4,3,2
"9825","2017-10-30",2,4,6,10,10,"Yes",4,2,2,2
"9826","2017-10-30",4,8,5,13,15,"No",2,3,5,3
"9827","2017-10-30",2,4,7,11,11,"Yes",3,4,2,2
"9828","2017-10-30",3,6,3,9,9,"Yes",0,3,3,3
"9829","2017-10-30",2,6,1,7,7,"No",1,0,2,4
"9830","2017-10-30",1,2,6,8,8,"Yes",4,2,1,1
"9831","2017-10-30",2,4,2,6,6,"No",1,1,2,2
"9832","2017-10-30",2,7,6,13,12,"Yes",3,3,4,3
"9833","2017-10-30",1,2,1,3,3,"Yes",0,1,1,1
"9834","2017-10-30",1,5,1,6,6,"Yes",1,0,3,2
"9835","2017-10-30",1,3,4,7,7,"Yes",4,0,2,1
"9836","2017-10-30",4,5,9,14,14,"No",5,4,2,3
"9837","2017-10-30",1,4,1,5,5,"Yes",0,1,1,3
"9838","2017-10-30",5,10,3,13,15,"No",1,2,5,5
"9839","2017-10-30",1,2,2,4,4,"Yes",1,1,0,2
"9840","2017-10-30",4,7,4,11,13,"No",2,2,3,4
"9841","2017-10-30",2,6,4,10,9,"No",1,3,3,3
"9842","2017-10-30",1,3,1,4,4,"Yes",1,NA,NA,3
"9843","2017-10-30",1,2,3,5,5,"Yes",2,1,1,1
"9844","2017-10-30",3,7,3,10,11,"Yes",2,1,4,3
"9845","2017-10-30",NA,4,55,59,NA,"Yes",25,30,1,3
"9846","2017-10-30",1,2,5,7,7,"Yes",3,2,1,1
"9847","2017-10-30",3,4,7,11,11,"Yes",3,4,1,3
"9848","2017-10-30",4,11,6,17,17,"Yes",3,3,4,7
"9849","2017-10-30",2,4,3,7,7,"No",1,2,2,2
"9850","2017-10-30",3,8,3,11,11,"Yes",1,2,5,3
"9851","2017-10-23",1,5,4,9,9,"No",1,3,2,3
"9852","2017-10-30",3,6,4,10,18,"Yes",3,1,3,3
"9853","2017-10-30",2,5,8,13,13,"Yes",3,5,2,3
"9854","2017-10-30",1,2,5,7,7,"Yes",1,4,1,1
"9855","2017-10-30",1,2,2,4,4,"Yes",1,1,1,1
"9856","2017-10-30",1,9,1,10,10,"Yes",0,1,4,5
"9857","2017-10-30",2,5,4,9,9,"Yes",3,1,2,3
"9858","2017-10-30",1,4,4,8,8,"Yes",2,2,1,3
"9859","2017-10-30",1,4,5,9,9,"Yes",4,1,2,2
"9860","2017-10-30",2,8,7,15,15,"No",2,5,4,4
"9861","2017-10-30",2,4,3,7,8,"Yes",1,2,2,2
"9862","2017-10-30",4,9,6,15,16,"Yes",2,4,4,5
"9863","2017-10-30",2,6,7,13,13,"Yes",2,5,3,3
"9864","2017-10-30",3,8,4,12,12,"No",2,2,4,4
"9865","2017-10-30",1,4,3,7,6,"Yes",1,2,2,2
"9866","2017-10-30",3,10,2,12,17,"No",2,0,4,6
"9867","2017-10-30",2,5,6,11,11,"No",3,3,2,3
"9868","2017-10-30",1,3,4,7,7,"No",1,3,2,1
"9869","2017-10-30",1,2,5,7,7,"Yes",2,3,1,1
"9870","2017-10-30",3,5,5,10,10,"No",2,3,3,2
"9871","2017-10-30",NA,2,3,5,NA,NA,1,2,1,1
"9872","2017-10-30",3,5,2,7,8,"Yes",1,1,3,2
"9873","2017-10-30",4,9,4,13,13,"Yes",3,1,5,4
"9874","2017-10-30",2,6,5,11,11,"Yes",2,3,3,3
"9875","2017-10-30",3,6,3,9,10,"No",1,2,3,3
"9876","2017-10-30",2,8,4,12,12,"Yes",0,4,3,5
"9877","2017-10-30",1,5,2,7,7,"Yes",1,1,2,3
"9878","2017-10-30",1,2,5,7,7,"Yes",2,3,1,1
"9879","2017-10-30",1,2,2,4,4,"Yes",1,1,1,1
"9880",NA,1,4,4,8,8,"Yes",2,2,2,2
"9881","2017-10-30",2,5,3,8,7,"Yes",1,2,1,4
"9882","2017-10-30",3,7,4,11,11,"Yes",2,2,3,4
"9883","2017-10-30",2,5,3,8,9,"Yes",2,1,2,3
"9884","2017-10-30",5,10,3,13,13,"Yes",3,0,6,4
"9885","2017-10-30",1,2,1,3,3,"No",NA,1,1,1
"9886","2017-10-30",4,12,7,19,19,"Yes",4,3,5,7
"9887","2017-10-28",3,9,5,14,14,"No",1,4,5,4
"9888",NA,1,6,1,7,7,NA,1,NA,3,3
"9889","2017-10-30",NA,6,1,7,NA,"Yes",1,0,3,3
"9890","2017-10-30",2,4,3,7,7,"Yes",2,1,1,3
"9891","2017-10-30",2,5,3,8,6,"Yes",1,2,3,2
"9892","2017-10-30",4,9,6,15,15,"Yes",2,4,5,4
"9893","2017-10-30",4,8,2,10,10,"No",0,2,3,5
"9894",NA,4,7,3,10,10,"Yes",2,1,3,4
"9895","2017-10-30",1,1,3,4,5,NA,2,1,0,1
"9896","2017-10-30",3,5,1,6,6,NA,1,NA,3,2
"9897","2017-10-30",4,9,7,16,16,"Yes",3,4,4,5
"9898","2017-10-30",2,4,7,11,11,"Yes",3,4,2,2
"9899","2017-10-30",2,8,6,14,14,"Yes",3,3,5,3
"9900","2017-10-30",1,6,0,6,6,"Yes",0,0,4,2
"9901","2017-10-30",1,4,2,6,6,"No",1,1,2,2
"9902","2017-10-30",2,5,3,8,8,"No",1,2,2,3
"9903","2017-10-30",1,3,2,5,5,"Yes",1,1,1,2
"9904","2017-10-30",1,2,3,5,5,"Yes",NA,3,1,1
"9905","2017-10-30",4,7,9,16,14,"No",4,5,5,2
"9906",NA,3,5,5,10,10,"Yes",3,2,2,3
"9907","2017-10-30",1,1,2,3,3,"Yes",2,NA,0,1
"9908","2017-10-30",1,3,2,5,3,"Yes",2,0,1,2
"9909","2017-10-30",1,2,2,4,4,"No",1,1,1,1
"9910","2017-10-30",4,8,12,20,20,"No",5,7,4,4
"9911","2017-10-30",1,3,3,6,6,"No",0,3,2,1
"9912","2017-10-30",1,2,4,6,6,"No",3,1,1,1
"9913","2017-10-30",1,2,0,2,2,"Yes",0,0,1,1
"9914","2017-10-30",4,8,17,25,25,"No",5,12,4,4
"9915","2017-10-30",6,12,3,15,15,"No",1,2,6,6
"9916","2017-10-30",6,12,10,22,22,"Yes",5,5,6,6
"9917","2017-10-30",1,4,4,8,8,"Yes",2,2,2,2
"9918","2017-10-30",2,6,3,9,9,"Yes",2,1,3,3
"9919","2017-10-30",1,5,9,14,13,"Yes",5,4,2,3
"9920","2017-10-30",5,10,14,24,24,"Yes",6,8,5,5
"9921","2017-10-30",2,5,1,6,6,"Yes",0,1,1,4
"9922","2017-10-30",1,2,0,2,2,"Yes",0,0,1,1
"9923","2017-10-30",1,2,7,9,9,"No",4,3,1,1
"9924","2017-10-30",1,3,1,4,4,"Yes",0,1,2,1
"9925","2017-10-30",3,6,9,15,15,"No",4,5,3,3
"9926","2017-10-30",2,5,4,9,9,"No",1,3,3,2
"9927","2017-10-30",1,2,2,4,4,"Yes",2,0,1,1
"9928","2017-10-30",1,3,2,5,5,NA,1,1,1,2
"9929","2017-10-30",1,4,2,6,6,"Yes",0,2,2,2
"9930","2017-10-30",1,4,4,8,8,"No",2,2,2,2
"9931","2017-10-30",2,6,4,10,10,"Yes",2,2,2,4
"9932","2017-10-30",1,2,1,3,3,"Yes",0,1,1,1
"9933","2017-10-30",1,2,3,5,5,"Yes",1,2,1,1
"9934","2017-10-30",1,4,7,11,11,"Yes",4,3,2,2
"9935","2017-10-30",2,6,6,12,12,"Yes",4,2,2,4
"9936","2017-10-30",1,2,2,4,4,"Yes",1,1,1,1
"9937","2017-10-30",1,5,1,6,6,"Yes",0,1,2,3
"9938","2017-10-30",2,7,11,18,18,"Yes",3,8,2,5
"9939","2017-10-30",3,6,9,15,15,"Yes",4,5,3,3
"9940","2017-10-30",10,16,26,42,42,"Yes",8,18,10,6
"9941","2017-10-30",3,6,12,18,18,"No",5,7,3,3
"9942","2017-10-30",1,3,8,11,11,"Yes",5,3,2,1
"9943","2017-10-30",1,5,3,8,8,"Yes",2,1,3,2
"9944","2017-10-30",2,5,6,11,10,"Yes",4,2,1,4
"9945","2017-10-30",7,14,12,26,28,"No",5,7,6,8
"9946","2017-10-30",3,11,3,14,15,"Yes",2,1,5,6
"9947","2017-10-30",2,4,2,6,6,"Yes",2,0,1,3
"9948","2017-10-30",1,4,4,8,8,"Yes",2,2,2,2
"9949","2017-10-30",3,6,9,15,15,"No",4,5,3,3
"9950","2017-10-30",3,8,6,14,15,"Yes",3,3,4,4
"9951","2017-10-31",3,6,6,12,12,"Yes",5,1,3,3
"9952","2017-10-31",1,4,4,8,8,"Yes",1,3,2,2
"9953","2017-10-31",1,3,5,8,7,"Yes",2,3,1,2
"9954","2017-10-31",1,6,4,10,10,"Yes",2,2,3,3
"9955","2017-10-31",1,2,3,5,5,"Yes",3,0,1,1
"9956","2017-10-31",1,1,0,1,1,"Yes",0,0,0,1
"9957","2017-10-31",3,9,6,15,15,"Yes",3,3,4,5
"9958","2017-10-31",1,2,2,4,4,"No",1,1,1,1
"9959","2017-10-31",1,4,3,7,7,"Yes",1,2,2,2
"9960","2017-10-31",1,2,3,5,5,"Yes",0,3,1,1
"9961","2017-10-25",5,8,7,15,11,"No",3,4,3,5
"9962","2017-10-31",1,2,0,2,2,"Yes",0,0,0,2
"9963","2017-10-31",1,4,1,5,5,"No",0,1,2,2
"9964","2017-10-31",4,8,7,15,15,"Yes",3,4,4,4
"9965","2017-10-31",2,4,7,11,11,"Yes",2,5,2,2
"9966","2017-10-31",3,7,7,14,14,"No",3,4,3,4
"9967","2017-10-31",1,1,2,3,3,"Yes",1,1,0,1
"9968","2017-10-31",1,2,3,5,5,"Yes",2,1,1,1
"9969","2017-10-31",1,2,2,4,4,"Yes",0,2,1,1
"9970","2017-10-31",2,4,4,8,8,"Yes",1,3,2,2
"9971","2017-10-31",4,10,10,20,20,"Yes",4,6,5,5
"9972","2017-10-31",5,8,0,8,8,"Yes",0,0,3,5
"9973","2017-10-31",1,2,2,4,4,"Yes",NA,2,1,1
"9974","2017-10-31",1,7,3,10,10,"Yes",2,1,4,3
"9975","2017-10-31",5,10,12,22,22,"No",3,9,5,5
"9976","2017-10-27",2,4,2,6,6,NA,1,1,2,2
"9977","2017-10-31",1,3,1,4,4,"Yes",0,1,2,1
"9978","2017-10-31",1,2,4,6,6,"Yes",4,0,1,1
"9979","2017-10-31",1,2,3,5,5,"Yes",2,1,1,1
"9980","2017-10-31",2,6,4,10,10,"No",3,1,3,3
"9981","2017-10-31",1,5,1,6,6,"Yes",0,1,3,2
"9982","2017-10-31",4,8,2,10,12,"No",0,2,4,4
"9983",NA,1,7,0,7,7,"Yes",0,NA,5,2
"9984","2017-10-30",2,5,3,8,8,"Yes",2,1,3,2
"9985","2017-10-31",2,5,5,10,10,"Yes",2,3,2,3
"9986","2017-10-27",2,4,2,6,6,"Yes",1,1,2,2
"9987","2017-10-31",2,4,12,16,16,"Yes",7,5,2,2
"9988","2017-10-31",1,2,2,4,4,"No",1,1,1,1
"9989","2017-10-31",5,10,10,20,20,"Yes",5,5,5,5
"9990","2017-10-31",1,5,2,7,7,"Yes",1,1,3,2
"9991","2017-10-31",1,2,4,6,6,"No",2,2,1,1
"9992","2017-10-31",NA,300,305,605,NA,"Yes",205,100,100,200
"9993","2017-10-31",2,5,3,8,8,"No",2,1,2,3
"9994","2017-10-31",2,2,4,6,6,"Yes",2,2,1,1
"9995","2017-10-31",1,5,1,6,6,"No",0,1,2,3
"9996","2017-10-31",4,7,5,12,12,"No",2,3,3,4
"9997","2017-10-31",1,3,4,7,7,"No",3,1,1,2
"9998","2017-10-31",1,2,5,7,6,"Yes",1,4,1,1
"9999","2017-10-31",1,2,5,7,72,"Yes",3,2,1,1
"10000","2017-10-31",1,6,4,10,8,NA,2,2,3,3
"10001","2017-10-31",1,3,3,6,6,"Yes",1,2,2,1
"10002","2017-10-31",1,2,5,7,7,"Yes",3,2,1,1
"10003","2017-10-31",1,5,1,6,6,"Yes",1,0,2,3
"10004","2017-10-31",1,2,1,3,3,"Yes",0,1,1,1
"10005","2017-10-31",1,2,1,3,3,"No",NA,1,1,1
"10006","2017-10-31",3,14,11,25,28,"No",5,6,6,8
"10007","2017-10-31",3,7,5,12,12,"No",3,2,3,4
"10008","2017-10-31",2,4,9,13,13,"Yes",3,6,2,2
"10009","2017-10-30",3,6,11,17,19,"Yes",5,6,3,3
"10010","2017-10-31",1,2,3,5,5,"No",1,2,1,1
"10011","2017-10-31",NA,356,0,356,NA,"No",NA,NA,156,200
"10012","2017-10-31",5,11,12,23,23,"No",6,6,4,7
"10013","2017-10-31",2,4,11,15,15,"No",4,7,2,2
"10014","2017-10-31",1,3,3,6,6,"No",0,3,1,2
"10015","2017-10-31",1,4,3,7,5,"Yes",1,2,1,3
"10016","2017-10-31",1,3,4,7,7,"Yes",2,2,1,2
"10017","2017-10-31",NA,117,42,159,NA,"No",19,23,50,67
"10018","2017-10-31",2,0,0,0,6,"No",NA,NA,NA,NA
"10019","2017-10-31",1,2,4,6,6,"Yes",2,2,1,1
"10020","2017-10-31",1,3,2,5,5,"Yes",1,1,1,2
"10021","2017-10-31",1,2,5,7,7,"Yes",2,3,1,1
"10022","2017-10-31",2,4,4,8,8,"No",1,3,2,2
"10023","2017-10-31",2,434,8,442,16,"Yes",4,4,4,430
"10024","2017-10-31",NA,120,110,230,NA,"No",42,68,34,86
"10025","2017-10-31",12,20,23,43,42,"Yes",9,14,10,10
"10026","2017-10-31",1,4,3,7,7,"Yes",1,2,2,2
"10027","2017-10-31",1,4,2,6,7,"Yes",NA,2,1,3
"10028","2017-10-31",5,10,13,23,23,"No",7,6,5,5
"10029","2017-10-31",1,3,3,6,6,NA,0,3,2,1
"10030","2017-10-31",2,3,2,5,5,"Yes",1,1,1,2
"10031","2017-10-31",1,2,3,5,5,"No",2,1,1,1
"10032","2017-10-31",2,5,4,9,9,"No",2,2,2,3
"10033","2017-10-31",1,3,0,3,3,"Yes",NA,NA,1,2
"10034","2017-10-31",4,10,8,18,18,"Yes",3,5,5,5
"10035","2017-10-31",1,6,2,8,8,"Yes",1,1,2,4
"10036","2017-10-31",5,8,5,13,13,"No",2,3,3,5
"10037","2017-10-31",1,2,4,6,6,"No",2,2,1,1
"10038","2017-10-31",NA,150,0,150,NA,"Yes",0,0,100,50
"10039","2017-10-31",1,4,3,7,7,"No",0,3,2,2
"10040","2017-10-31",2,4,3,7,7,"Yes",0,3,2,2
"10041","2017-10-31",3,12,12,24,18,"Yes",5,7,5,7
"10042","2017-10-31",1,1,6,7,7,"Yes",3,3,0,1
"10043","2017-10-31",1,2,4,6,6,"Yes",2,2,1,1
"10044","2017-10-31",1,23,4,27,9,"Yes",2,2,23,NA
"10045","2017-10-31",1,2,3,5,5,"Yes",0,3,1,1
"10046","2017-10-31",1,2,5,7,7,"Yes",2,3,1,1
"10047","2017-10-31",1,2,4,6,6,"Yes",1,3,1,1
"10048","2017-10-31",2,4,2,6,6,"No",1,1,2,2
"10049","2017-10-31",1,2,3,5,5,"No",1,2,1,1
"10050","2017-10-31",NA,5,33,38,NA,"No",15,18,3,2
"10051","2017-10-31",1,4,2,6,6,"Yes",1,1,1,3
"10052","2017-10-31",1,2,3,5,5,"No",2,1,1,1
"10053","2017-10-31",1,4,4,8,8,"Yes",2,2,2,2
"10054","2017-10-31",1,2,2,4,4,"Yes",1,1,1,1
"10055","2017-10-31",1,2,3,5,5,"Yes",1,2,1,1
"10056","2017-10-31",1,1,6,7,7,"Yes",2,4,1,0
"10057","2017-10-31",1,4,2,6,6,"Yes",1,1,1,3
"10058","2017-10-31",1,2,0,2,2,"Yes",0,0,1,1
"10059","2017-10-31",6,8,8,16,16,"No",4,4,4,4
"10060","2017-10-31",1,4,1,5,5,"Yes",0,1,2,2
"10061","2017-10-31",1,4,2,6,6,"Yes",0,2,2,2
"10062","2017-10-31",2,5,4,9,9,"Yes",2,2,2,3
"10063","2017-10-31",1,2,4,6,6,"Yes",1,3,1,1
"10064","2017-10-31",1,3,2,5,5,"Yes",1,1,1,2
"10065","2017-10-31",1,4,2,6,6,"No",1,1,2,2
"10066","2017-10-31",2,6,3,9,9,"No",1,2,3,3
"10067","2017-10-31",2,5,7,12,12,"Yes",3,4,2,3
"10068","2017-10-31",2,5,4,9,9,"No",3,1,3,2
"10069","2017-10-31",1,3,2,5,5,"No",1,1,2,1
"10070","2017-10-31",1,2,4,6,6,"Yes",2,2,1,1
"10071","2017-10-31",1,4,3,7,7,"Yes",1,2,2,2
"10072","2017-10-31",3,4,4,8,8,"No",2,2,3,1
"10073","2017-10-31",2,5,4,9,9,"Yes",2,2,3,2
"10074","2017-10-31",1,2,4,6,6,"Yes",2,2,1,1
"10075","2017-10-31",1,2,5,7,7,"Yes",3,2,1,1
"10076","2017-10-29",4,7,14,21,21,"Yes",9,5,3,4
"10077","2017-10-31",1,5,1,6,6,"Yes",1,0,2,3
"10078","2017-10-31",1,3,4,7,7,"Yes",1,3,2,1
"10079","2017-10-31",1,3,2,5,5,"Yes",0,2,2,1
"10080","2017-10-31",2,6,4,10,12,"Yes",1,3,4,2
"10081","2017-10-31",2,6,5,11,11,"Yes",3,2,4,2
"10082","2017-10-31",1,4,4,8,8,"Yes",2,2,1,3
"10083","2017-10-31",2,6,1,7,7,"Yes",0,1,2,4
"10084","2017-10-31",2,7,3,10,10,"No",1,2,3,4
"10085","2017-10-31",2,11,7,18,18,"Yes",2,5,7,4
"10086","2017-10-31",1,5,3,8,8,"Yes",1,2,3,2
"10087","2017-10-31",2,4,4,8,7,"Yes",1,3,2,2
"10088","2017-10-31",2,4,2,6,6,"Yes",1,1,2,2
"10089","2017-10-31",3,8,8,16,16,"No",5,3,4,4
"10090","2017-10-31",1,2,0,2,2,"No",0,0,1,1
"10091","2017-10-31",7,15,8,23,23,"No",3,5,9,6
"10092","2017-10-31",3,7,6,13,11,"No",1,5,4,3
"10093","2017-10-31",3,7,3,10,10,"Yes",3,0,4,3
"10094","2017-10-31",2,5,1,6,6,"No",1,0,2,3
"10095","2017-11-01",1,3,3,6,6,"Yes",2,1,1,2
"10096","2017-11-01",2,4,3,7,7,"Yes",1,2,2,2
"10097","2017-11-01",2,7,4,11,11,"Yes",3,1,4,3
"10098","2017-11-01",1,5,2,7,7,"No",1,1,4,1
"10099","2017-11-01",2,3,1,4,4,"No",0,1,2,1
"10100","2017-11-01",1,3,3,6,5,"No",2,1,1,2
"10101","2017-11-01",1,1,1,2,3,"No",1,NA,NA,1
"10102","2017-11-01",1,1,4,5,5,"Yes",2,2,NA,1
"10103","2017-11-01",1,7,1,8,8,"Yes",0,1,3,4
"10104","2017-11-01",1,2,8,10,10,"Yes",4,4,1,1
"10105","2017-11-01",1,2,1,3,3,"No",1,0,1,1
"10106","2017-11-01",1,5,3,8,9,"Yes",1,2,2,3
"10107","2017-11-01",4,8,2,10,10,"No",2,0,5,3
"10108","2017-11-01",1,3,6,9,9,"Yes",3,3,1,2
"10109","2017-11-01",1,2,4,6,6,"No",3,1,1,1
"10110","2017-11-01",1,4,0,4,4,"Yes",0,0,2,2
"10111","2017-11-01",1,3,3,6,6,"Yes",1,2,1,2
"10112","2017-11-01",2,5,2,7,7,"Yes",1,1,1,4
"10113","2017-11-01",2,3,2,5,5,"No",1,1,2,1
"10114","2017-11-01",1,2,3,5,5,"Yes",1,2,1,1
"10115","2017-11-01",1,3,1,4,4,"Yes",1,NA,2,1
"10116","2017-11-01",2,4,9,13,13,"No",6,3,2,2
"10117","2017-11-01",1,2,4,6,6,"Yes",1,3,1,1
"10118","2017-11-01",2,4,10,14,6,"Yes",8,2,2,2
"10119","2017-11-01",5,5,5,10,12,"No",2,3,3,2
"10120","2017-11-01",NA,2,7,9,NA,"Yes",3,4,1,1
"10121","2017-11-01",10,15,1,16,16,"No",1,0,10,5
"10122","2017-11-01",NA,3,7,10,NA,"Yes",3,4,1,2
"10123",NA,1,4,1,5,5,"No",1,0,2,2
"10124","2017-11-01",1,2,3,5,5,"Yes",3,0,1,1
"10125","2017-11-01",1,2,3,5,5,"No",1,2,1,1
"10126","2017-11-01",5,10,17,27,28,"Yes",4,13,5,5
"10127","2017-11-01",3,5,3,8,12,"Yes",2,1,4,1
"10128","2017-11-01",1,3,0,3,3,"Yes",0,0,2,1
"10129","2017-11-01",1,5,3,8,8,"Yes",2,1,2,3
"10130","2017-11-01",1,2,3,5,5,"Yes",1,2,1,1
"10131","2017-11-01",2,2,7,9,7,"No",3,4,1,1
"10132","2017-11-01",2,5,3,8,8,"No",1,2,2,3
"10133","2017-11-01",1,4,5,9,9,"Yes",3,2,3,1
"10134","2017-11-01",1,2,6,8,8,"Yes",2,4,1,1
"10135","2017-11-01",1,3,7,10,10,"Yes",2,5,1,2
"10136","2017-11-01",1,2,4,6,6,"Yes",2,2,1,1
"10137","2017-11-01",3,6,8,14,14,"Yes",3,5,3,3
"10138","2017-11-01",2,4,5,9,9,"Yes",1,4,2,2
"10139","2017-11-01",2,5,3,8,8,"No",2,1,4,1
"10140","2017-11-01",1,13,9,22,22,"No",3,6,6,7
"10141","2017-11-01",1,5,3,8,8,"Yes",2,1,1,4
"10142","2017-11-01",1,2,2,4,4,"Yes",1,1,1,1
"10143","2017-11-01",1,4,3,7,7,"Yes",0,3,2,2
"10144","2017-11-01",NA,110,0,110,NA,"Yes",NA,NA,50,60
"10145","2017-11-01",1,4,1,5,5,"Yes",1,0,1,3
"10146","2017-11-01",1,4,6,10,10,"Yes",2,4,2,2
"10147","2017-11-01",1,3,5,8,8,"Yes",3,2,1,2
"10148","2017-11-01",2,10,5,15,15,"No",2,3,7,3
"10149","2017-11-01",1,4,0,4,4,"Yes",0,0,4,0
"10150","2017-11-01",1,2,4,6,6,"Yes",3,1,1,1
"10151","2017-11-01",6,9,7,16,16,"No",3,4,4,5
"10152","2017-11-01",1,2,4,6,6,"Yes",0,4,1,1
"10153","2017-11-01",3,10,6,16,16,"Yes",2,4,7,3
"10154","2017-11-01",2,9,5,14,14,"No",3,2,6,3
"10155","2017-11-01",3,5,3,8,8,"Yes",0,3,2,3
"10156","2017-11-01",1,5,3,8,8,"Yes",2,1,2,3
"10157","2017-11-01",2,4,7,11,11,"No",4,3,2,2
"10158",NA,1,5,5,10,10,"No",3,2,2,3
"10159","2017-11-01",2,3,2,5,5,"No",1,1,2,1
"10160","2017-11-01",6,11,9,20,20,"No",5,4,5,6
"10161","2017-11-01",2,6,3,9,9,NA,2,1,4,2
"10162","2017-11-01",2,6,7,13,13,"Yes",3,4,2,4
"10163","2017-11-01",3,5,8,13,13,"No",5,3,3,2
"10164","2017-11-01",3,13,11,24,24,"No",5,6,7,6
"10165","2017-11-01",1,5,3,8,8,"Yes",0,3,4,1
"10166","2017-11-01",4,8,5,13,13,"No",2,3,3,5
"10167","2017-11-01",2,4,1,5,5,"No",0,1,2,2
"10168","2017-11-01",1,6,1,7,7,"Yes",1,NA,2,4
"10169","2017-11-01",1,3,3,6,6,"Yes",1,2,1,2
"10170","2017-11-01",NA,170,0,170,NA,"No",0,0,150,20
"10171","2017-11-01",1,2,6,8,8,NA,2,4,1,1
"10172","2017-11-01",1,6,1,7,7,"Yes",1,NA,2,4
"10173","2017-11-01",2,5,4,9,9,"Yes",1,3,3,2
"10174","2017-11-01",4,8,5,13,13,"Yes",4,1,3,5
"10175","2017-11-01",1,2,1,3,3,"Yes",0,1,1,1
"10176","2017-11-01",1,2,2,4,4,"No",NA,2,1,1
"10177","2017-10-31",3,6,3,9,9,"Yes",2,1,4,2
"10178","2017-11-01",1,3,2,5,5,"Yes",1,1,2,1
"10179","2017-11-01",1,2,5,7,7,"No",2,3,1,1
"10180","2017-11-01",1,2,5,7,7,"Yes",3,2,1,1
"10181","2017-11-01",1,3,2,5,5,"Yes",1,1,2,1
"10182","2017-11-01",1,3,3,6,6,"Yes",2,1,2,1
"10183","2017-11-01",3,9,3,12,12,"No",2,1,4,5
"10184","2017-11-01",1,1,2,3,3,"No",2,0,1,0
"10185","2017-11-01",1,2,0,2,2,"No",0,0,1,1
"10186","2017-11-01",1,2,4,6,6,"Yes",1,3,1,1
"10187","2017-11-01",1,2,3,5,4,"No",2,1,1,1
"10188","2017-11-01",2,2,1,3,3,"No",NA,1,1,1
"10189","2017-11-01",1,2,4,6,6,"No",3,1,1,1
"10190","2017-11-01",NA,10,360,370,NA,"No",160,200,4,6
"10191","2017-11-01",1,4,1,5,5,"Yes",0,1,2,2
"10192","2017-11-01",NA,0,0,0,12,"Yes",NA,NA,NA,NA
"10193","2017-11-01",1,6,1,7,7,"Yes",1,0,2,4
"10194","2017-11-01",3,12,4,16,16,"Yes",2,2,5,7
"10195","2017-10-31",1,4,3,7,7,"Yes",1,2,2,2
"10196","2017-11-01",3,8,3,11,11,"Yes",3,0,3,5
"10197","2017-11-01",5,9,15,24,24,"Yes",7,8,4,5
"10198","2017-11-01",1,2,6,8,8,"Yes",3,3,1,1
"10199","2017-11-01",NA,15,196,211,NA,"Yes",96,100,4,11
"10200","2017-11-01",1,2,1,3,3,"No",1,0,1,1
"10201","2017-11-01",1,2,1,3,3,"Yes",1,0,1,1
"10202","2017-11-01",1,1,1,2,2,"Yes",1,0,0,1
"10203","2017-11-01",1,2,8,10,10,"Yes",4,4,1,1
"10204","2017-11-01",2,3,5,8,8,"Yes",2,3,2,1
"10205","2017-11-01",3,8,8,16,16,"No",4,4,3,5
"10206","2017-11-01",4,7,7,14,14,"No",2,5,3,4
"10207","2017-10-31",1,8,2,10,12,"Yes",2,0,4,4
"10208","2017-11-01",2,7,5,12,12,"Yes",2,3,4,3
"10209","2017-11-01",1,1,5,6,6,"Yes",3,2,0,1
"10210","2017-11-01",3,5,7,12,12,"Yes",3,4,2,3
"10211","2017-11-01",6,8,6,14,14,"No",4,2,5,3
"10212","2017-11-01",1,1,0,1,1,"Yes",0,0,1,0
"10213","2017-11-01",1,2,6,8,8,"Yes",4,2,1,1
"10214","2017-11-01",1,3,4,7,7,"Yes",2,2,1,2
"10215","2017-11-01",1,2,6,8,8,"Yes",2,4,1,1
"10216","2017-11-01",2,4,7,11,11,"No",3,4,2,2
"10217","2017-11-01",1,4,4,8,8,"Yes",2,2,2,2
"10218","2017-11-01",3,9,1,10,11,"No",0,1,5,4
"10219","2017-10-31",1,11,5,16,16,"Yes",0,5,4,7
"10220","2017-11-01",1,2,6,8,8,"Yes",3,3,1,1
"10221","2017-11-01",8,9,7,16,12,"No",2,5,3,6
"10222","2017-11-01",1,5,3,8,8,"Yes",0,3,2,3
"10223","2017-11-01",3,8,9,17,17,"Yes",5,4,3,5
"10224","2017-11-01",1,2,4,6,6,"Yes",3,1,1,1
"10225","2017-11-01",1,2,2,4,4,"Yes",0,2,1,1
"10226","2017-11-01",5,12,8,20,20,"Yes",3,5,5,7
"10227","2017-11-01",2,10,6,16,16,"No",4,2,6,4
"10228","2017-11-01",1,2,4,6,6,"No",4,0,1,1
"10229","2017-11-01",1,2,5,7,7,"Yes",2,3,1,1
"10230","2017-11-01",1,5,2,7,6,"Yes",NA,2,4,1
"10231","2017-11-01",1,3,7,10,10,"Yes",3,4,1,2
"10232","2017-11-01",1,2,4,6,6,"No",1,3,1,1
"10233","2017-11-01",6,13,5,18,18,"No",1,4,6,7
"10234","2017-11-01",1,2,4,6,6,"Yes",1,3,1,1
"10235","2017-10-31",3,7,3,10,10,"Yes",1,2,3,4
"10236","2017-11-01",2,3,3,6,6,"Yes",0,3,2,1
"10237","2017-11-01",3,6,6,12,12,"Yes",4,2,3,3
"10238","2017-11-01",2,3,3,6,6,"Yes",1,2,2,1
"10239","2017-11-01",4,8,7,15,15,"Yes",4,3,4,4
"10240","2017-11-01",2,7,1,8,8,"Yes",0,1,3,4
"10241","2017-11-01",1,3,2,5,5,"Yes",1,1,1,2
"10242","2017-11-01",1,2,2,4,4,"Yes",1,1,1,1
"10243","2017-11-01",1,2,6,8,8,"Yes",4,2,1,1
"10244","2017-11-01",2,9,6,15,15,"Yes",4,2,3,6
"10245","2017-11-01",1,2,4,6,6,"Yes",4,0,1,1
"10246","2017-11-01",3,6,7,13,13,"No",4,3,3,3
"10247","2017-11-01",2,2,3,5,5,"Yes",1,2,1,1
"10248","2017-11-01",NA,40,0,40,NA,"No",NA,NA,40,NA
"10249","2017-11-01",1,5,1,6,6,"No",0,1,2,3
"10250","2017-11-01",2,3,4,7,7,"Yes",1,3,1,2
"10251","2017-11-01",1,3,3,6,6,"Yes",1,2,1,2
"10252","2017-11-01",3,6,7,13,13,"Yes",3,4,3,3
"10253","2017-11-01",NA,100,0,100,NA,"No",NA,NA,40,60
"10254","2017-11-01",1,2,3,5,5,"Yes",3,0,1,1
"10255","2017-11-01",2,3,6,9,9,"No",3,3,2,1
"10256","2017-11-01",1,3,4,7,6,"Yes",1,3,1,2
"10257","2017-11-01",4,7,3,10,10,"Yes",2,1,4,3
"10258","2017-11-01",1,2,6,8,8,"Yes",5,1,1,1
"10259","2017-11-01",2,7,0,7,7,"Yes",0,0,5,2
"10260","2017-10-31",1,4,4,8,8,"Yes",2,2,1,3
"10261","2017-11-01",2,5,3,8,8,"No",1,2,2,3
"10262","2017-11-01",1,8,3,11,11,"No",2,1,5,3
"10263","2017-11-01",1,8,5,13,13,"No",1,4,3,5
"10264","2017-10-31",1,2,3,5,5,"Yes",0,3,1,1
"10265","2017-11-01",1,18,6,24,24,"No",4,2,14,4
"10266","2017-11-01",6,15,10,25,25,"No",3,7,7,8
"10267","2017-11-01",1,8,6,14,14,"No",2,4,3,5
"10268","2017-11-01",2,2,3,5,5,"No",3,NA,1,1
"10269","2017-11-01",1,2,3,5,5,"No",1,2,1,1
"10270","2017-11-01",1,2,6,8,8,"No",5,1,1,1
"10271","2017-11-01",1,8,4,12,12,"No",2,2,5,3
"10272","2017-11-01",2,4,7,11,11,"No",3,4,2,2
"10273","2017-11-01",1,2,6,8,8,"No",5,1,1,1
"10274","2017-11-01",7,11,9,20,20,"Yes",4,5,5,6
"10275","2017-11-01",1,3,4,7,7,"Yes",2,2,0,3
"10276","2017-11-01",1,2,1,3,3,"Yes",1,NA,1,1
"10277","2017-11-01",1,2,6,8,8,"Yes",4,2,1,1
"10278","2017-10-31",2,7,13,20,20,"Yes",4,9,5,2
"10279","2017-11-01",3,3,3,6,6,"Yes",0,3,2,1
"10280","2017-11-01",3,8,6,14,14,"Yes",3,3,5,3
"10281","2017-11-01",1,4,2,6,7,"Yes",1,1,3,1
"10282","2017-11-01",1,2,5,7,7,"Yes",2,3,1,1
"10283","2017-11-01",1,2,4,6,6,"Yes",2,2,1,1
"10284","2017-11-01",3,6,6,12,15,"No",1,5,3,3
"10285","2017-11-01",NA,12,330,342,NA,"No",150,180,5,7
"10286","2017-11-01",2,4,0,4,4,"Yes",0,0,2,2
"10287",NA,NA,3,6,9,NA,"Yes",3,3,2,1
"10288","2017-11-01",1,5,4,9,9,"Yes",1,3,2,3
"10289","2017-11-01",NA,12,290,302,NA,"No",130,160,4,8
"10290","2017-11-01",1,2,3,5,5,"Yes",2,1,1,1
"10291","2017-11-01",7,14,14,28,28,"Yes",6,8,7,7
"10292","2017-11-01",1,2,3,5,5,"Yes",0,3,1,1
"10293","2017-10-31",2,4,5,9,9,"Yes",2,3,2,2
"10294","2017-11-01",2,5,3,8,8,"Yes",1,2,4,1
"10295","2017-11-01",5,11,10,21,21,"Yes",5,5,5,6
"10296","2017-11-01",3,7,7,14,13,"Yes",2,5,3,4
"10297","2017-11-01",3,6,5,11,11,"No",3,2,3,3
"10298","2017-11-01",1,2,5,7,7,"Yes",3,2,1,1
"10299","2017-11-01",4,7,4,11,11,"Yes",1,3,4,3
"10300","2017-11-01",1,6,3,9,9,"Yes",2,1,4,2
"10301","2017-11-01",1,2,5,7,7,"Yes",3,2,1,1
"10302","2017-11-01",1,2,3,5,5,"Yes",1,2,1,1
"10303","2017-11-01",2,4,4,8,8,"No",1,3,2,2
"10304","2017-11-01",1,2,4,6,6,"Yes",2,2,1,1
"10305","2017-11-01",1,3,1,4,4,"Yes",1,NA,1,2
"10306","2017-11-01",1,3,2,5,5,"No",1,1,2,1
"10307","2017-11-01",3,6,4,10,10,"Yes",1,3,3,3
"10308","2017-11-01",1,2,8,10,8,"No",4,4,1,1
"10309","2017-11-01",1,2,1,3,3,"Yes",1,0,1,1
"10310","2017-10-31",1,3,2,5,5,"Yes",1,1,2,1
"10311","2017-11-01",11,23,17,40,40,NA,8,9,12,11
"10312","2017-11-01",12,16,11,27,27,"No",6,5,7,9
"10313","2017-11-01",1,3,4,7,7,"No",2,2,1,2
"10314","2017-11-01",4,6,3,9,9,"Yes",1,2,3,3
"10315","2017-10-31",2,4,5,9,9,"Yes",3,2,3,1
"10316","2017-11-01",1,2,3,5,5,"Yes",1,2,1,1
"10317","2017-11-01",5,12,2,14,14,"No",1,1,5,7
"10318","2017-10-31",1,2,3,5,5,"No",2,1,1,1
"10319","2017-11-01",1,2,1,3,3,"No",1,0,1,1
"10320","2017-11-01",4,6,4,10,10,"Yes",3,1,2,4
"10321","2017-11-01",3,6,7,13,13,"Yes",2,5,3,3
"10322","2017-10-31",1,3,4,7,7,"Yes",1,3,1,2
"10323","2017-11-01",1,3,7,10,10,NA,3,4,1,2
"10324","2017-10-31",3,6,7,13,13,"No",5,2,3,3
"10325","2017-11-01",3,7,5,12,12,"No",3,2,3,4
"10326","2017-11-01",1,2,3,5,5,"Yes",1,2,1,1
"10327","2017-11-01",2,4,7,11,11,"No",4,3,2,2
"10328","2017-11-01",1,2,7,9,9,"Yes",3,4,1,1
"10329","2017-11-01",3,9,3,12,10,"No",1,2,3,6
"10330","2017-11-01",3,9,5,14,15,"No",2,3,5,4
"10331","2017-11-01",1,2,4,6,6,"Yes",2,2,1,1
"10332","2017-10-31",2,2,2,4,4,"Yes",2,0,0,2
"10333","2017-11-01",1,4,3,7,7,"Yes",1,2,3,1
"10334","2017-11-01",2,3,5,8,8,"Yes",2,3,1,2
"10335","2017-11-01",1,2,6,8,8,"No",2,4,1,1
"10336","2017-11-01",3,7,6,13,13,"Yes",4,2,4,3
"10337","2017-10-31",3,7,0,7,7,"Yes",0,0,2,5
"10338","2017-11-01",1,3,1,4,4,"Yes",0,1,1,2
"10339","2017-11-01",1,6,2,8,7,"Yes",1,1,3,3
"10340","2017-11-01",1,4,3,7,7,"Yes",1,2,3,1
"10341","2017-11-01",3,16,9,25,25,"No",5,4,6,10
"10342","2017-11-01",4,4,5,9,9,"No",2,3,2,2
"10343","2017-11-01",4,9,8,17,21,"No",5,3,5,4
"10344","2017-11-01",1,2,5,7,7,"Yes",2,3,1,1
"10345","2017-11-01",3,6,7,13,13,"No",2,5,3,3
"10346","2017-11-01",1,2,4,6,6,"No",1,3,1,1
"10347","2017-11-01",1,2,5,7,7,"Yes",2,3,1,1
"10348","2017-11-01",1,2,3,5,5,"No",2,1,1,1
"10349","2017-11-01",1,2,6,8,8,"Yes",1,5,1,1
"10350","2017-11-01",1,2,2,4,4,"Yes",1,1,1,1
"10351","2017-11-01",1,14,8,22,5,"No",5,3,6,8
"10352","2017-11-01",7,7,5,12,2,"Yes",2,3,4,3
"10353","2017-11-01",4,9,4,13,13,"No",2,2,4,5
"10354","2017-11-01",4,8,9,17,17,"Yes",5,4,4,4
"10355","2017-11-01",1,2,3,5,5,"Yes",1,2,1,1
"10356","2017-11-01",2,6,2,8,8,"Yes",0,2,3,3
"10357","2017-11-01",1,5,1,6,6,"No",0,1,3,2
"10358","2017-11-01",2,7,2,9,9,"Yes",1,1,2,5
"10359","2017-11-01",1,4,4,8,8,"No",2,2,2,2
"10360","2017-11-01",1,3,2,5,5,"No",1,1,1,2
"10361","2017-10-30",4,6,0,6,6,"Yes",0,0,1,5
"10362","2017-11-01",5,10,11,21,21,"No",10,1,5,5
"10363","2017-11-01",1,2,3,5,5,"No",1,2,1,1
"10364","2017-11-01",2,3,12,15,15,"Yes",5,7,1,2
"10365","2017-11-01",4,5,10,15,15,"No",5,5,2,3
"10366","2017-10-31",2,4,2,6,6,"Yes",1,1,2,2
"10367","2017-11-01",1,2,3,5,5,"No",1,2,1,1
"10368","2017-11-01",3,6,6,12,12,"Yes",3,3,3,3
"10369","2017-11-01",2,3,2,5,5,"No",1,1,2,1
"10370","2017-11-01",3,0,0,0,17,"Yes",NA,NA,NA,NA
"10371","2017-11-01",1,4,3,7,7,"Yes",1,2,3,1
"10372","2017-11-01",5,10,15,25,20,"Yes",5,10,5,5
"10373","2017-11-01",1,2,2,4,4,"No",2,0,1,1
"10374","2017-11-01",1,4,4,8,8,"Yes",2,2,2,2
"10375",NA,1,2,5,7,7,"Yes",3,2,1,1
"10376","2017-11-01",1,14,1,15,6,"Yes",1,NA,1,13
"10377","2017-10-31",3,6,4,10,11,"Yes",3,1,3,3
"10378","2017-11-01",1,2,3,5,5,"Yes",0,3,0,2
"10379","2017-11-01",2,10,20,30,30,"Yes",10,10,5,5
"10380","2017-11-01",1,3,4,7,7,"No",2,2,2,1
"10381","2017-11-01",3,7,6,13,13,"Yes",1,5,3,4
"10382","2017-11-01",1,2,6,8,8,"Yes",4,2,1,1
"10383","2017-10-30",1,2,5,7,7,"Yes",1,4,1,1
"10384","2017-12-03",7,14,17,31,31,"Yes",9,8,7,7
"10385","2017-11-01",1,2,5,7,7,"Yes",3,2,1,1
"10386","2017-11-01",6,12,16,28,28,"Yes",8,8,6,6
"10387","2017-11-01",2,4,7,11,11,"Yes",3,4,2,2
"10388","2017-11-01",2,4,10,14,14,"No",2,8,1,3
"10389","2017-11-01",1,5,2,7,7,"Yes",1,1,2,3
"10390","2017-11-01",2,4,11,15,15,"Yes",6,5,2,2
"10391","2017-11-01",1,3,5,8,8,"Yes",2,3,1,2
"10392","2017-11-01",1,2,3,5,5,"Yes",2,1,1,1
"10393","2017-11-01",3,7,8,15,15,"Yes",4,4,3,4
"10394","2017-11-01",2,4,3,7,7,"No",0,3,2,2
"10395","2017-11-01",2,2,8,10,10,"Yes",3,5,1,1
"10396","2017-11-01",1,2,6,8,8,"No",1,5,1,1
"10397","2017-11-01",2,4,2,6,6,"Yes",2,0,2,2
"10398","2017-11-01",NA,5,2,7,NA,"Yes",0,2,2,3
"10399","2017-11-01",4,8,12,20,20,"Yes",5,7,4,4
"10400","2017-11-01",1,4,2,6,6,"Yes",1,1,2,2
"10401","2017-11-01",1,2,6,8,8,"Yes",3,3,1,1
"10402","2017-11-01",2,4,6,10,10,"Yes",3,3,2,2
"10403","2017-11-01",1,0,2,2,3,"Yes",1,1,NA,NA
"10404","2017-11-01",3,9,10,19,19,"Yes",4,6,4,5
"10405","2017-11-01",1,2,5,7,7,"Yes",1,4,1,1
"10406","2017-11-01",1,2,3,5,5,"Yes",1,2,1,1
"10407","2017-11-01",2,4,4,8,8,"No",2,2,2,2
"10408","2017-11-01",4,9,8,17,17,"Yes",3,5,7,2
"10409","2017-11-01",1,8,5,13,7,"Yes",3,2,3,5
"10410","2017-11-01",3,14,8,22,22,"Yes",5,3,9,5
"10411","2017-11-01",2,3,2,5,5,"Yes",1,1,1,2
"10412","2017-11-01",3,6,7,13,13,"Yes",5,2,2,4
"10413","2017-11-01",3,10,5,15,15,"Yes",3,2,4,6
"10414","2017-11-01",1,4,2,6,6,"Yes",0,2,2,2
"10415","2017-11-01",1,4,2,6,6,"No",1,1,2,2
"10416","2017-11-01",3,8,12,20,20,"Yes",7,5,5,3
"10417","2017-11-01",2,8,7,15,15,"Yes",4,3,5,3
"10418","2017-11-01",4,5,5,10,10,"Yes",1,4,3,2
"10419","2017-11-01",3,7,9,16,16,"No",4,5,3,4
"10420","2017-11-01",1,3,2,5,5,"Yes",1,1,1,2
"10421","2017-11-01",1,9,4,13,5,"Yes",2,2,4,5
"10422","2017-11-01",2,10,10,20,20,"Yes",4,6,5,5
"10423","2017-11-01",2,10,2,12,12,"Yes",2,0,5,5
"10424","2017-11-01",3,5,6,11,11,"No",2,4,2,3
"10425","2017-11-01",3,12,3,15,15,"No",0,3,7,5
"10426","2017-11-01",1,4,3,7,7,"No",2,1,2,2
"10427","2017-11-01",2,7,5,12,13,"Yes",3,2,4,3
"10428","2017-11-01",3,5,4,9,9,"Yes",2,2,2,3
"10429","2017-11-01",2,5,6,11,11,"Yes",4,2,3,2
"10430","2017-11-01",5,4,6,10,10,"No",2,4,2,2
"10431","2017-11-01",1,3,2,5,5,"Yes",1,1,1,2
"10432","2017-11-01",4,7,5,12,12,"No",3,2,2,5
"10433","2017-11-01",2,7,2,9,9,"No",0,2,3,4
"10434","2017-11-01",1,7,3,10,10,"Yes",2,1,3,4
"10435","2017-11-01",1,4,2,6,6,"No",2,0,2,2
"10436","2017-11-01",1,5,2,7,7,"Yes",1,1,2,3
"10437","2017-11-01",2,6,4,10,11,"Yes",2,2,2,4
"10438","2017-11-01",1,4,2,6,6,"Yes",1,1,2,2
"10439","2017-11-01",2,10,4,14,14,"Yes",2,2,4,6
"10440","2017-11-01",4,9,5,14,14,"No",1,4,4,5
"10441","2017-11-01",2,17,12,29,9,"Yes",7,5,8,9
"10442","2017-11-01",1,4,4,8,6,"Yes",3,1,2,2
"10443","2017-11-01",1,4,3,7,7,"Yes",2,1,2,2
"10444","2017-11-01",1,6,4,10,10,"No",0,4,4,2
"10445","2017-11-01",2,4,3,7,8,"Yes",2,1,1,3
"10446","2017-11-01",3,4,5,9,9,"No",4,1,2,2
"10447","2017-11-01",1,2,7,9,10,"Yes",3,4,1,1
"10448","2017-11-01",3,8,6,14,14,"No",1,5,5,3
"10449","2017-11-01",4,4,8,12,13,"Yes",3,5,2,2
"10450","2017-11-01",5,10,4,14,14,"No",3,1,5,5
"10451","2017-11-01",1,3,0,3,3,"No",0,0,3,0
"10452","2017-11-01",1,2,5,7,7,"Yes",2,3,1,1
"10453","2017-11-02",1,2,3,5,5,"No",3,0,0,2
"10454","2017-11-02",5,8,2,10,10,"No",1,1,3,5
"10455","2017-11-02",2,4,2,6,6,"Yes",0,2,2,2
"10456","2017-11-02",1,4,1,5,5,"No",1,0,2,2
"10457","2017-11-02",2,5,7,12,12,"Yes",3,4,1,4
"10458","2017-11-02",1,5,2,7,6,"No",1,1,2,3
"10459","2017-11-02",1,2,4,6,6,"Yes",2,2,1,1
"10460","2017-11-02",1,2,2,4,4,"Yes",1,1,1,1
"10461","2017-11-02",3,9,9,18,18,"Yes",4,5,3,6
"10462","2017-11-02",2,4,9,13,13,"Yes",3,6,2,2
"10463","2017-11-02",1,3,4,7,7,"No",2,2,1,2
"10464",NA,1,2,4,6,6,"Yes",2,2,1,1
"10465","2017-11-02",1,2,5,7,7,"Yes",3,2,1,1
"10466","2017-11-02",1,2,4,6,6,"No",NA,4,1,1
"10467","2017-11-02",4,8,8,16,16,"No",3,5,4,4
"10468","2017-11-02",3,18,8,26,26,"No",5,3,10,8
"10469","2017-11-02",1,3,5,8,8,"Yes",2,3,1,2
"10470","2017-11-03",2,8,5,13,13,"No",2,3,5,3
"10471","2017-11-02",2,6,5,11,11,"No",3,2,2,4
"10472","2017-11-03",2,7,4,11,11,"No",2,2,4,3
"10473","2017-11-02",1,4,0,4,4,"Yes",0,0,2,2
"10474","2017-11-02",3,7,11,18,18,"No",4,7,3,4
"10475","2017-11-02",3,13,7,20,20,"No",4,3,8,5
"10476","2017-11-02",5,10,4,14,14,"No",1,3,5,5
"10477","2017-11-02",6,12,11,23,23,"Yes",6,5,6,6
"10478","2017-11-02",3,14,9,23,23,"No",5,4,8,6
"10479","2017-11-02",1,3,1,4,2,"Yes",1,0,1,2
"10480","2017-11-02",4,11,6,17,17,"Yes",3,3,3,8
"10481","2017-11-02",1,2,3,5,5,"No",1,2,1,1
"10482","2017-11-02",3,6,3,9,8,"No",2,1,3,3
"10483","2017-11-02",1,4,5,9,9,"Yes",3,2,2,2
"10484","2017-11-02",2,14,7,21,21,"No",2,5,6,8
"10485","2017-11-03",2,12,7,19,19,"No",5,2,5,7
"10486","2017-11-02",1,2,1,3,3,"Yes",1,0,1,1
"10487","2017-11-02",1,3,0,3,3,"No",0,0,1,2
"10488","2017-11-09",2,8,3,11,14,"Yes",1,2,4,4
"10489","2017-11-02",2,8,7,15,15,"No",4,3,3,5
"10490","2017-11-02",1,3,0,3,3,"No",0,0,2,1
"10491","2017-11-02",3,16,9,25,25,"No",5,4,9,7
"10492","2017-11-02",2,4,3,7,8,"Yes",2,1,2,2
"10493","2017-11-02",1,2,3,5,5,"Yes",3,0,2,0
"10494","2017-11-03",2,2,6,8,8,"No",2,4,1,1
"10495","2017-11-02",2,7,2,9,14,"Yes",1,1,3,4
"10496","2017-11-02",4,10,5,15,16,"Yes",0,5,3,7
"10497","2017-11-02",1,4,2,6,6,"No",2,0,2,2
"10498","2017-11-02",1,3,3,6,6,"Yes",2,1,1,2
"10499","2017-11-02",1,6,2,8,8,"Yes",0,2,3,3
"10500","2017-11-03",4,15,7,22,22,"No",4,3,7,8
"10501","2017-11-02",1,3,3,6,6,"No",1,2,1,2
"10502","2017-11-02",1,4,2,6,6,"Yes",0,2,2,2
"10503","2017-11-02",2,11,5,16,16,"No",2,3,5,6
"10504","2017-11-02",2,4,5,9,9,"Yes",1,4,0,4
"10505","2017-11-02",NA,1,0,1,1,"No",0,0,1,0
"10506","2017-11-02",8,24,10,34,34,"No",5,5,8,16
"10507","2017-11-02",1,3,1,4,4,"No",1,0,1,2
"10508","2017-11-02",1,3,4,7,7,"Yes",2,2,2,1
"10509","2017-11-02",1,4,3,7,7,"No",1,2,1,3
"10510","2017-11-02",3,12,6,18,18,"No",4,2,7,5
"10511","2017-11-02",2,5,4,9,9,"Yes",2,2,0,5
"10512","2017-11-02",1,7,0,7,8,"Yes",0,0,4,3
"10513","2017-11-02",1,3,1,4,5,"Yes",0,1,1,2
"10514","2017-11-02",1,2,2,4,4,"No",NA,2,1,1
"10515","2017-11-02",1,3,0,3,3,"Yes",0,0,1,2
"10516","2017-11-02",2,6,2,8,9,"Yes",2,0,3,3
"10517","2017-11-02",1,4,0,4,4,"Yes",0,0,4,0
"10518","2017-11-02",3,11,6,17,17,"No",4,2,7,4
"10519","2017-11-02",1,2,3,5,5,"Yes",1,2,1,1
"10520","2017-11-02",1,2,5,7,7,"Yes",1,4,1,1
"10521","2017-11-02",3,9,9,18,18,"Yes",3,6,4,5
"10522","2017-11-02",1,2,3,5,5,"Yes",2,1,1,1
"10523","2017-11-02",1,3,0,3,3,"Yes",0,0,2,1
"10524","2017-11-02",1,3,0,3,3,"Yes",0,0,2,1
"10525","2017-11-02",4,15,7,22,22,"No",4,3,8,7
"10526","2017-11-02",1,2,1,3,4,"Yes",0,1,1,1
"10527","2017-11-02",1,2,7,9,9,"Yes",3,4,1,1
"10528","2017-11-02",1,2,4,6,6,"Yes",2,2,1,1
"10529","2017-11-02",3,4,5,9,9,"Yes",3,2,1,3
"10530","2017-11-02",1,2,2,4,5,"No",0,2,1,1
"10531","2017-11-02",3,4,16,20,20,"Yes",6,10,2,2
"10532","2017-11-02",2,5,4,9,9,"Yes",2,2,2,3
"10533","2017-11-02",2,4,4,8,8,"No",1,3,2,2
"10534","2017-11-02",2,13,3,16,16,"Yes",1,2,6,7
"10535","2017-11-02",1,4,2,6,6,"Yes",1,1,3,1
"10536","2017-11-02",NA,2,36,38,NA,"No",15,21,1,1
"10537","2017-11-02",2,7,1,8,9,NA,0,1,4,3
"10538","2017-11-02",2,5,4,9,9,"Yes",3,1,2,3
"10539","2017-11-02",2,5,3,8,8,"Yes",2,1,2,3
"10540","2017-11-02",4,7,7,14,14,"No",5,2,4,3
"10541","2017-11-02",NA,9,158,167,NA,"No",80,78,7,2
"10542","2017-11-02",2,7,4,11,12,"No",2,2,4,3
"10543","2017-11-02",4,16,8,24,25,"Yes",3,5,11,5
"10544","2017-11-02",1,3,4,7,7,"Yes",1,3,1,2
"10545","2017-11-02",8,16,14,30,30,"Yes",7,7,8,8
"10546","2017-11-02",1,2,0,2,2,"No",0,0,1,1
"10547","2017-11-02",1,6,0,6,4,"Yes",0,0,3,3
"10548","2017-11-02",1,4,3,7,7,"Yes",1,2,1,3
"10549","2017-11-02",2,11,6,17,17,"Yes",2,4,5,6
"10550","2017-11-02",1,2,4,6,8,"Yes",1,3,1,1
"10551","2017-11-02",1,5,4,9,9,"Yes",2,2,2,3
"10552","2017-11-02",1,3,5,8,8,"No",2,3,1,2
"10553","2017-11-02",3,5,0,5,5,"No",0,0,2,3
"10554","2017-11-02",4,6,7,13,12,"Yes",3,4,3,3
"10555","2017-12-03",2,3,8,11,12,"Yes",3,5,1,2
"10556","2017-11-02",2,5,2,7,7,"Yes",0,2,2,3
"10557","2017-11-02",1,2,6,8,8,"Yes",2,4,1,1
"10558","2017-11-02",4,8,8,16,16,"Yes",5,3,4,4
"10559","2017-11-02",3,5,9,14,14,"Yes",5,4,3,2
"10560","2017-11-02",2,4,5,9,9,"No",3,2,2,2
"10561","2017-11-02",1,5,2,7,7,"Yes",2,0,3,2
"10562","2017-11-02",1,2,6,8,9,"No",1,5,1,1
"10563","2017-11-02",1,3,2,5,5,"Yes",1,1,1,2
"10564","2017-11-02",1,2,3,5,5,"No",2,1,1,1
"10565","2017-11-02",2,4,4,8,8,"No",2,2,2,2
"10566","2017-11-02",2,3,3,6,6,"Yes",2,1,2,1
"10567","2017-11-02",2,3,5,8,10,"Yes",3,2,2,1
"10568","2017-11-02",NA,19,320,339,NA,"No",150,170,10,9
"10569","2017-11-02",1,5,2,7,7,"Yes",1,1,2,3
"10570","2017-11-02",2,3,5,8,8,"No",2,3,2,1
"10571","2017-11-02",1,4,2,6,6,"Yes",1,1,2,2
"10572","2017-11-02",1,2,2,4,4,"Yes",1,1,1,1
"10573","2017-11-02",1,2,1,3,3,"Yes",1,0,1,1
"10574","2017-11-02",3,3,5,8,8,"No",3,2,1,2
"10575","2017-11-02",2,5,4,9,9,"Yes",3,1,1,4
"10576","2017-11-02",3,8,7,15,16,"Yes",4,3,3,5
"10577","2017-11-02",2,2,4,6,6,"No",1,3,1,1
"10578","2017-11-02",2,8,6,14,14,"Yes",2,4,3,5
"10579","2017-11-02",5,8,5,13,15,"Yes",1,4,4,4
"10580","2017-11-03",1,2,5,7,7,"Yes",3,2,1,1
"10581","2017-11-03",3,6,0,6,6,"Yes",0,0,2,4
"10582","2017-11-03",2,4,3,7,9,"No",0,3,2,2
"10583","2017-11-03",1,6,0,6,6,"Yes",0,0,3,3
"10584","2017-11-03",1,2,3,5,5,"Yes",0,3,1,1
"10585","2017-11-03",3,5,3,8,8,"No",2,1,3,2
"10586","2017-11-03",3,8,9,17,17,"No",4,5,5,3
"10587","2017-11-03",1,4,3,7,7,"Yes",2,1,1,3
"10588","2017-11-03",1,3,4,7,7,"Yes",2,2,2,1
"10589","2017-11-03",1,6,3,9,9,"No",2,1,3,3
"10590","2017-11-03",1,5,1,6,7,"No",0,1,4,1
"10591","2017-11-03",1,2,6,8,8,"Yes",4,2,1,1
"10592","2017-11-03",1,2,1,3,3,"Yes",1,0,1,1
"10593","2017-11-03",2,4,3,7,7,"No",2,1,2,2
"10594","2017-11-03",4,12,5,17,17,"No",3,2,5,7
"10595","2017-11-03",1,4,2,6,6,"Yes",0,2,2,2
"10596","2017-11-04",1,5,3,8,8,"No",1,2,3,2
"10597","2017-11-03",1,5,2,7,7,"No",1,1,3,2
"10598","2017-11-03",1,2,3,5,5,"No",1,2,1,1
"10599","2017-11-03",1,5,0,5,5,"Yes",0,0,2,3
"10600","2017-11-03",1,2,4,6,6,"Yes",1,3,1,1
"10601","2017-11-03",1,1,6,7,6,"No",3,3,1,0
"10602","2017-11-03",4,9,6,15,15,"Yes",1,5,5,4
"10603","2017-11-03",1,2,4,6,6,"Yes",1,3,1,1
"10604","2017-11-03",2,7,7,14,14,"Yes",3,4,3,4
"10605","2017-11-03",1,4,1,5,5,"No",1,0,2,2
"10606","2017-11-03",NA,9,200,209,NA,"No",80,120,3,6
"10607","2017-11-03",2,9,3,12,12,"No",2,1,4,5
"10608","2017-11-04",1,5,2,7,7,"No",1,1,2,3
"10609","2017-11-04",1,2,2,4,4,"No",0,2,1,1
"10610","2017-11-03",1,5,0,5,5,"No",0,0,2,3
"10611","2017-11-03",1,2,2,4,4,"Yes",1,1,1,1
"10612","2017-11-03",1,1,6,7,7,"Yes",3,3,NA,1
"10613","2017-11-03",2,4,2,6,6,"Yes",0,2,2,2
"10614","2017-11-03",4,8,1,9,12,"No",1,0,4,4
"10615","2017-11-03",2,4,0,4,8,"Yes",0,0,2,2
"10616","2017-11-03",1,5,4,9,9,"No",1,3,3,2
"10617","2017-11-03",1,3,5,8,8,"Yes",2,3,2,1
"10618","2017-11-03",1,1,3,4,4,"Yes",1,2,0,1
"10619","2017-11-03",1,1,5,6,6,"Yes",4,1,0,1
"10620","2017-11-03",6,10,7,17,17,"Yes",1,6,7,3
"10621","2017-11-03",2,3,6,9,9,"Yes",3,3,2,1
"10622","2017-11-03",1,3,2,5,5,"Yes",1,1,1,2
"10623","2017-11-03",1,7,1,8,8,"Yes",0,1,3,4
"10624","2017-11-03",2,10,4,14,14,"No",2,2,3,7
"10625","2017-11-03",1,3,3,6,6,"Yes",2,1,2,1
"10626","2017-11-03",1,2,2,4,4,"Yes",0,2,1,1
"10627","2017-11-03",2,11,5,16,16,"No",2,3,5,6
"10628","2017-11-03",2,2,10,12,12,"Yes",4,6,1,1
"10629","2017-11-03",1,1,1,2,2,"No",0,1,0,1
"10630","2017-11-03",1,2,4,6,6,"Yes",2,2,1,1
"10631","2017-11-03",1,4,3,7,5,"Yes",0,3,1,3
"10632","2017-11-03",1,2,5,7,7,"Yes",3,2,1,1
"10633","2017-11-03",1,3,4,7,7,"No",2,2,2,1
"10634","2017-11-03",1,6,3,9,9,"No",1,2,4,2
"10635","2017-11-03",1,3,1,4,4,"Yes",1,0,0,3
"10636","2017-11-03",1,6,2,8,8,"Yes",0,2,4,2
"10637","2017-11-03",3,6,5,11,11,"Yes",3,2,3,3
"10638","2017-11-03",1,4,3,7,7,"Yes",1,2,2,2
"10639","2017-11-03",2,7,3,10,8,"No",1,2,2,5
"10640","2017-11-03",1,2,2,4,4,"Yes",1,1,1,1
"10641","2017-11-03",6,13,7,20,20,"No",4,3,6,7
"10642","2017-11-03",1,3,0,3,3,"Yes",0,0,2,1
"10643","2017-11-03",1,9,4,13,13,"No",1,3,5,4
"10644","2017-11-03",2,3,5,8,8,"Yes",3,2,1,2
"10645","2017-11-03",2,8,3,11,11,"Yes",1,2,3,5
"10646","2017-11-03",4,8,5,13,20,"No",2,3,4,4
"10647","2017-11-03",1,5,3,8,8,"No",2,1,3,2
"10648","2017-11-01",1,4,0,4,4,"No",0,0,1,3
"10649","2017-11-03",1,2,4,6,6,"No",3,1,1,1
"10650","2017-11-03",3,8,8,16,16,"Yes",4,4,3,5
"10651","2017-11-03",1,3,2,5,6,"Yes",1,1,1,2
"10652","2017-11-03",2,5,4,9,12,"Yes",2,2,2,3
"10653","2017-11-03",1,2,3,5,5,"Yes",1,2,1,1
"10654","2017-11-03",2,11,3,14,14,"Yes",2,1,5,6
"10655","2017-11-03",1,2,7,9,6,"Yes",5,2,0,2
"10656","2017-11-03",2,5,0,5,5,"Yes",0,0,3,2
"10657","2017-11-03",1,2,3,5,5,"No",2,1,1,1
"10658","2017-11-03",1,7,3,10,10,"No",1,2,3,4
"10659","2017-11-03",1,2,6,8,8,"Yes",3,3,1,1
"10660","2017-11-03",1,5,2,7,7,"Yes",1,1,2,3
"10661","2017-11-03",1,2,4,6,6,"Yes",1,3,1,1
"10662","2017-11-03",1,3,9,12,4,"Yes",1,8,1,2
"10663","2017-11-03",1,5,2,7,7,"Yes",1,1,2,3
"10664","2017-11-03",4,8,15,23,22,"Yes",8,7,4,4
"10665","2017-11-03",1,2,4,6,6,"No",1,3,1,1
"10666","2017-11-03",4,8,4,12,12,"No",2,2,4,4
"10667","2017-11-03",2,8,7,15,15,"No",3,4,2,6
"10668","2017-11-03",1,2,1,3,3,"No",NA,1,1,1
"10669","2017-11-03",3,8,9,17,17,"No",5,4,3,5
"10670","2017-11-03",1,4,4,8,8,"Yes",1,3,2,2
"10671","2017-11-03",1,2,3,5,5,"Yes",2,1,1,1
"10672","2017-11-03",1,6,0,6,6,"Yes",0,0,2,4
"10673","2017-11-03",1,3,4,7,6,"No",2,2,2,1
"10674","2017-11-03",1,2,2,4,4,"Yes",1,1,1,1
"10675","2017-11-03",3,6,7,13,13,"Yes",2,5,3,3
"10676","2017-11-03",1,2,2,4,4,"Yes",2,0,1,1
"10677","2017-11-03",1,2,4,6,7,"Yes",1,3,1,1
"10678","2017-11-03",1,3,0,3,4,"No",0,0,1,2
"10679","2017-11-02",3,8,5,13,13,"Yes",3,2,5,3
"10680","2017-11-03",1,4,5,9,9,"Yes",2,3,1,3
"10681","2017-11-03",2,5,9,14,14,"Yes",3,6,2,3
"10682","2017-11-03",2,6,0,6,7,"Yes",0,0,2,4
"10683","2017-11-02",1,2,3,5,5,"Yes",1,2,1,1
"10684","2017-11-03",1,6,3,9,9,"No",2,1,4,2
"10685","2017-11-10",2,8,0,8,8,"Yes",0,0,4,4
"10686","2017-11-03",4,9,8,17,17,"Yes",4,4,5,4
"10687","2017-11-03",1,6,2,8,8,"No",1,1,4,2
"10688","2017-11-03",2,4,4,8,8,"Yes",1,3,2,2
"10689","2017-11-03",2,9,3,12,12,"No",1,2,3,6
"10690","2017-11-03",2,7,2,9,9,"No",0,2,4,3
"10691","2017-11-03",1,3,4,7,7,"Yes",2,2,1,2
"10692","2017-11-03",1,5,2,7,7,"Yes",1,1,2,3
"10693","2017-11-03",1,2,3,5,5,"Yes",1,2,1,1
"10694","2017-11-03",1,8,0,8,8,"Yes",0,0,4,4
"10695","2017-11-03",1,5,1,6,6,"No",NA,1,3,2
"10696","2017-11-03",2,8,3,11,11,"No",2,1,5,3
"10697","2017-11-03",1,8,1,9,9,"Yes",0,1,1,7
"10698","2017-11-03",2,6,2,8,9,"Yes",1,1,3,3
"10699","2017-11-03",1,2,3,5,5,"No",2,1,1,1
"10700","2017-11-03",1,5,2,7,7,"Yes",1,1,3,2
"10701","2017-11-03",4,9,5,14,14,"Yes",1,4,5,4
"10702","2017-11-03",1,2,3,5,5,"Yes",2,1,1,1
"10703","2017-11-03",2,4,4,8,8,"Yes",2,2,2,2
"10704","2017-11-03",1,5,6,11,11,"Yes",3,3,2,3
"10705","2017-11-03",2,9,5,14,14,"No",2,3,5,4
"10706","2017-11-03",1,4,2,6,6,"No",1,1,1,3
"10707","2017-11-03",1,5,3,8,8,"No",1,2,3,2
"10708","2017-11-03",1,2,6,8,5,"Yes",2,4,1,1
"10709","2017-11-03",1,4,1,5,5,"Yes",1,0,1,3
"10710",NA,1,4,5,9,10,"No",1,4,2,2
"10711","2017-11-03",1,4,3,7,7,"Yes",2,1,1,3
"10712","2017-11-03",4,8,16,24,24,"Yes",6,10,4,4
"10713","2017-11-03",1,5,4,9,9,"No",2,2,2,3
"10714","2017-11-03",1,2,5,7,7,"Yes",1,4,1,1
"10715","2017-11-03",2,4,5,9,9,"Yes",3,2,2,2
"10716","2017-11-03",2,9,5,14,14,"No",2,3,5,4
"10717","2017-11-03",2,6,4,10,9,"No",2,2,3,3
"10718","2017-11-03",1,7,3,10,10,"No",2,1,3,4
"10719","2017-11-03",1,2,3,5,5,"Yes",1,2,1,1
"10720","2017-11-03",1,2,4,6,6,"Yes",0,4,1,1
"10721","2017-11-03",5,9,8,17,17,"Yes",2,6,4,5
"10722","2017-11-03",3,8,7,15,15,"No",4,3,4,4
"10723","2017-11-03",1,3,1,4,4,"No",0,1,1,2
"10724","2017-11-03",2,11,5,16,16,"No",2,3,7,4
"10725","2017-11-03",1,4,0,4,5,"No",0,0,2,2
"10726","2017-11-03",3,11,8,19,19,"Yes",7,1,6,5
"10727","2017-11-03",1,5,4,9,7,"No",1,3,2,3
"10728","2017-11-03",2,6,5,11,11,"Yes",3,2,2,4
"10729","2017-11-03",1,2,1,3,3,"Yes",1,0,1,1
"10730","2017-11-03",1,2,6,8,8,"Yes",2,4,1,1
"10731","2017-11-03",2,7,3,10,10,"Yes",1,2,3,4
"10732","2017-11-03",1,7,1,8,7,"No",0,1,4,3
"10733","2017-11-03",NA,6,5,11,NA,"No",3,2,3,3
"10734","2017-11-03",1,2,6,8,8,"Yes",1,5,1,1
"10735","2017-11-03",1,2,2,4,4,"No",1,1,1,1
"10736","2017-11-03",1,8,4,12,12,"No",1,3,4,4
"10737","2017-11-03",2,9,6,15,15,"No",4,2,6,3
"10738","2017-11-03",1,2,4,6,5,"Yes",1,3,1,1
"10739","2017-11-03",2,4,3,7,7,"Yes",1,2,2,2
"10740","2017-11-03",1,2,2,4,4,"Yes",0,2,1,1
"10741","2017-11-03",1,3,2,5,5,"Yes",0,2,2,1
"10742","2017-11-03",1,3,2,5,5,"Yes",1,1,2,1
"10743","2017-11-03",1,2,3,5,8,"Yes",1,2,1,1
"10744","2017-11-03",1,5,1,6,6,"Yes",1,0,2,3
"10745","2017-11-03",2,9,4,13,13,"No",2,2,3,6
"10746","2017-11-03",1,5,2,7,7,"No",1,1,2,3
"10747","2017-11-03",2,9,6,15,15,"No",4,2,6,3
"10748","2017-11-03",2,5,1,6,6,"Yes",0,1,4,1
"10749","2017-11-03",1,2,3,5,5,"Yes",2,1,1,1
"10750","2017-11-03",1,6,6,12,12,"Yes",3,3,2,4
"10751","2017-11-03",1,9,5,14,28,"No",3,2,3,6
"10752","2017-11-03",3,7,5,12,12,"No",2,3,3,4
"10753","2017-11-03",1,2,4,6,6,"No",2,2,1,1
"10754","2017-11-03",1,5,2,7,6,"Yes",0,2,2,3
"10755","2017-11-03",1,2,4,6,6,"Yes",4,0,1,1
"10756","2017-11-03",1,2,3,5,5,"Yes",0,3,1,1
"10757","2017-11-03",8,14,16,30,30,"Yes",8,8,7,7
"10758","2017-11-03",NA,80,0,80,NA,"No",NA,NA,78,2
"10759","2017-11-03",2,4,5,9,9,"No",2,3,2,2
"10760","2017-11-03",NA,8,4,12,NA,"Yes",2,2,4,4
"10761","2017-11-03",2,4,7,11,12,"Yes",1,6,1,3
"10762","2017-11-03",1,2,13,15,15,"Yes",3,10,1,1
"10763","2017-11-03",1,6,2,8,8,"Yes",1,1,2,4
"10764","2017-11-03",1,4,4,8,8,"Yes",2,2,2,2
"10765","2017-11-03",1,5,5,10,10,"No",3,2,1,4
"10766","2017-11-03",2,11,8,19,20,"Yes",5,3,4,7
"10767","2017-11-03",3,3,6,9,9,"No",1,5,1,2
"10768","2017-11-03",1,4,2,6,6,"Yes",1,1,1,3
"10769","2017-11-03",3,5,7,12,13,"Yes",5,2,3,2
"10770","2017-11-03",1,4,4,8,9,"No",0,4,2,2
"10771","2017-11-03",1,2,4,6,7,"Yes",2,2,1,1
"10772","2017-11-03",2,3,2,5,5,"Yes",1,1,1,2
"10773","2017-11-03",1,2,2,4,5,"Yes",1,1,1,1
"10774","2017-11-03",1,2,8,10,10,"Yes",2,6,1,1
"10775","2017-11-03",1,6,5,11,11,"Yes",4,1,3,3
"10776","2017-11-03",1,4,2,6,8,"Yes",2,0,2,2
"10777","2017-11-03",1,3,4,7,7,"No",1,3,1,2
"10778","2017-11-03",1,4,4,8,8,"Yes",1,3,2,2
"10779","2017-11-03",1,3,5,8,8,"Yes",1,4,2,1
"10780","2017-11-03",1,3,1,4,4,"No",1,0,1,2
"10781","2017-11-03",1,2,3,5,6,"Yes",1,2,1,1
"10782","2017-11-03",1,2,3,5,6,"No",2,1,1,1
"10783","2017-11-03",1,2,3,5,5,"Yes",0,3,1,1
"10784","2017-11-03",2,8,2,10,10,"No",2,0,4,4
"10785","2017-11-03",1,3,3,6,5,"Yes",1,2,1,2
"10786","2017-11-03",4,10,9,19,19,"Yes",4,5,4,6
"10787","2017-10-31",1,2,7,9,9,"Yes",3,4,1,1
"10788","2017-11-04",1,3,3,6,6,"Yes",2,1,2,1
"10789","2017-11-04",NA,13,8,21,NA,"Yes",2,6,8,5
"10790","2017-11-04",NA,8,2,10,NA,"No",0,2,3,5
"10791","2017-11-04",1,3,2,5,5,"Yes",1,1,1,2
"10792","2017-11-04",NA,14,15,29,NA,"Yes",12,3,8,6
"10793","2017-11-04",2,4,3,7,7,"Yes",2,1,2,2
"10794","2017-11-04",1,7,1,8,8,"Yes",0,1,4,3
"10795","2017-11-04",NA,20,16,36,NA,"Yes",4,12,11,9
"10796","2017-11-04",1,2,2,4,4,"No",2,NA,1,1
"10797","2017-11-04",NA,10,3,13,NA,"Yes",0,3,4,6
"10798","2017-11-04",1,4,0,4,4,"Yes",0,0,1,3
"10799","2017-11-04",1,3,2,5,5,"Yes",2,NA,1,2
"10800","2017-11-04",1,3,3,6,6,"Yes",2,1,1,2
"10801","2017-11-04",2,4,6,10,10,"No",2,4,2,2
"10802","2017-11-04",1,3,2,5,5,"No",1,1,2,1
"10803","2017-11-04",NA,19,5,24,NA,"Yes",0,5,14,5
"10804","2017-11-04",1,3,1,4,4,"Yes",NA,1,2,1
"10805","2017-11-04",2,6,8,14,15,"Yes",5,3,2,4
"10806","2017-11-04",1,5,5,10,10,"Yes",2,3,3,2
"10807","2017-11-04",2,5,1,6,6,"Yes",0,1,2,3
"10808","2017-11-04",1,3,5,8,7,"No",4,1,1,2
"10809","2017-11-04",1,4,4,8,8,"Yes",2,2,2,2
"10810","2017-11-04",1,2,1,3,3,"No",0,1,1,1
"10811","2017-11-04",1,3,2,5,5,"Yes",1,1,1,2
"10812","2017-11-04",4,6,4,10,10,NA,2,2,3,3
"10813","2017-11-04",1,8,1,9,8,"No",1,0,6,2
"10814","2017-11-04",2,5,9,14,10,"Yes",6,3,2,3
"10815","2017-11-04",1,3,2,5,6,"No",1,1,2,1
"10816","2017-11-04",1,2,4,6,6,"No",2,2,1,1
"10817","2017-11-04",1,4,4,8,9,"Yes",2,2,3,1
"10818","2017-11-06",1,2,1,3,3,"No",0,1,1,1
"10819","2017-11-06",1,5,3,8,8,"No",2,1,3,2
"10820","2017-11-06",7,14,8,22,22,"No",1,7,7,7
"10821","2017-11-06",1,2,3,5,5,"Yes",NA,3,1,1
"10822","2017-11-07",1,6,3,9,9,"No",2,1,4,2
"10823","2017-11-06",3,5,3,8,8,"Yes",0,3,2,3
"10824","2017-11-06",3,8,9,17,17,"Yes",6,3,4,4
"10825","2017-11-06",2,3,5,8,8,"No",3,2,2,1
"10826","2017-11-06",1,2,5,7,7,"Yes",2,3,1,1
"10827","2017-11-06",1,3,0,3,3,"Yes",0,0,2,1
"10828","2017-11-06",1,4,3,7,7,"Yes",1,2,3,1
"10829","2017-11-06",5,10,8,18,18,"No",2,6,5,5
"10830","2017-11-06",3,8,7,15,15,"Yes",5,2,5,3
"10831","2017-11-06",7,14,11,25,25,"No",5,6,7,7
"10832","2017-11-06",2,4,3,7,7,"No",2,1,2,2
"10833","2017-11-06",2,7,4,11,11,"No",2,2,4,3
"10834","2017-11-06",4,6,6,12,12,"Yes",4,2,4,2
"10835","2017-11-06",1,2,3,5,5,"Yes",3,NA,1,1
"10836","2017-11-06",2,2,4,6,6,"No",1,3,1,1
"10837","2017-11-06",1,2,4,6,6,"Yes",1,3,1,1
"10838","2017-11-06",3,6,7,13,13,"Yes",4,3,3,3
"10839","2017-11-06",1,4,2,6,6,"Yes",1,1,1,3
"10840","2017-11-06",1,2,2,4,4,"No",1,1,1,1
"10841","2017-11-06",NA,1,0,1,NA,"No",0,0,1,0
"10842","2017-11-06",4,8,6,14,23,"No",3,3,4,4
"10843","2017-11-06",1,6,4,10,10,"No",1,3,4,2
"10844","2017-11-06",2,3,3,6,5,"No",2,1,1,2
"10845","2017-11-06",1,2,5,7,7,"Yes",2,3,1,1
"10846","2017-11-06",3,0,7,7,15,"Yes",3,4,NA,NA
"10847","2017-11-06",7,12,6,18,18,"Yes",1,5,7,5
"10848","2017-11-06",1,4,3,7,7,"Yes",1,2,2,2
"10849","2017-11-06",5,10,5,15,15,"Yes",2,3,5,5
"10850","2017-11-06",5,10,8,18,36,"No",3,5,5,5
"10851","2017-11-06",1,3,1,4,4,"No",1,0,1,2
"10852","2017-11-06",2,10,3,13,13,"No",2,1,4,6
"10853","2017-11-06",2,6,3,9,9,"No",0,3,4,2
"10854","2017-11-06",1,2,0,2,3,"No",0,0,1,1
"10855","2017-11-06",1,3,4,7,7,"No",1,3,1,2
"10856","2017-11-06",3,7,3,10,10,"Yes",2,1,3,4
"10857","2017-11-06",1,2,7,9,9,"No",3,4,1,1
"10858","2017-11-06",1,2,5,7,6,"Yes",3,2,1,1
"10859","2017-11-06",1,2,1,3,3,"Yes",1,0,1,1
"10860","2017-11-06",4,8,5,13,15,"No",2,3,4,4
"10861","2017-11-06",1,5,3,8,8,"No",2,1,3,2
"10862","2017-11-06",1,5,2,7,7,"No",1,1,2,3
"10863","2017-11-06",3,6,4,10,10,"No",3,1,3,3
"10864","2017-11-06",2,4,8,12,12,"Yes",4,4,2,2
"10865","2017-11-06",1,4,3,7,7,"No",2,1,1,3
"10866","2017-11-06",1,2,7,9,9,"Yes",4,3,1,1
"10867","2017-11-06",2,6,5,11,11,"Yes",2,3,3,3
"10868","2017-11-06",3,8,8,16,16,"Yes",2,6,4,4
"10869","2017-11-06",3,4,8,12,12,"No",2,6,2,2
"10870","2017-11-06",1,2,3,5,5,"No",1,2,1,1
"10871","2017-11-06",5,10,5,15,23,"No",3,2,5,5
"10872","2017-11-06",1,6,5,11,11,"No",2,3,4,2
"10873","2017-11-06",5,12,8,20,20,"Yes",4,4,5,7
"10874","2017-11-06",3,6,3,9,9,"No",1,2,3,3
"10875","2017-11-06",1,4,1,5,5,"Yes",NA,1,2,2
"10876","2017-11-06",1,3,5,8,8,"Yes",3,2,1,2
"10877","2017-11-06",3,6,7,13,13,"Yes",3,4,3,3
"10878","2017-11-06",2,4,7,11,11,"Yes",2,5,2,2
"10879","2017-11-06",3,12,1,13,13,"Yes",0,1,5,7
"10880","2017-11-06",1,2,11,13,3,"No",0,11,2,NA
"10881","2017-11-06",2,3,3,6,6,"Yes",1,2,1,2
"10882","2017-11-06",3,6,2,8,16,"No",0,2,3,3
"10883","2017-11-06",1,6,2,8,7,"No",1,1,4,2
"10884","2017-11-06",3,7,5,12,12,"Yes",3,2,4,3
"10885","2017-11-06",1,2,4,6,6,"Yes",3,1,1,1
"10886","2017-11-06",1,2,7,9,9,"Yes",2,5,1,1
"10887","2017-11-06",1,2,5,7,7,"No",3,2,1,1
"10888","2017-11-06",2,9,3,12,12,"Yes",1,2,5,4
"10889","2017-11-06",1,2,2,4,4,"No",0,2,1,1
"10890","2017-11-06",1,7,0,7,7,"Yes",0,0,4,3
"10891","2017-11-06",4,7,8,15,15,"Yes",4,4,4,3
"10892","2017-11-06",4,7,10,17,19,"Yes",7,3,5,2
"10893","2017-11-06",3,6,6,12,12,"No",4,2,3,3
"10894","2017-11-06",2,6,4,10,9,"No",2,2,3,3
"10895","2017-11-06",2,6,5,11,11,"Yes",4,1,3,3
"10896","2017-11-06",4,8,7,15,15,"Yes",5,2,3,5
"10897","2017-11-06",1,5,4,9,9,"Yes",1,3,4,1
"10898","2017-11-06",2,7,4,11,11,"No",2,2,4,3
"10899","2017-11-06",4,15,9,24,24,"Yes",4,5,5,10
"10900","2017-11-06",2,4,6,10,10,"Yes",2,4,2,2
"10901","2017-11-06",3,6,4,10,13,"Yes",2,2,3,3
"10902","2017-11-06",1,5,3,8,8,"No",2,1,3,2
"10903","2017-11-06",2,5,3,8,8,"Yes",1,2,2,3
"10904","2017-11-06",4,5,10,15,15,"Yes",5,5,2,3
"10905","2017-11-03",1,2,2,4,4,"Yes",0,2,1,1
"10906","2017-11-06",1,5,4,9,9,"Yes",1,3,2,3
"10907","2017-11-06",3,9,8,17,17,"Yes",3,5,4,5
"10908","2017-11-06",3,6,2,8,11,"Yes",1,1,3,3
"10909","2017-11-06",3,6,6,12,12,"Yes",4,2,3,3
"10910","2017-11-13",1,2,8,10,2,"No",0,8,1,1
"10911","2017-11-06",2,9,6,15,15,"No",4,2,3,6
"10912","2017-11-06",2,5,6,11,11,"Yes",2,4,2,3
"10913","2017-11-06",2,4,6,10,10,"Yes",3,3,2,2
"10914","2017-11-06",4,8,9,17,17,"Yes",5,4,3,5
"10915","2017-11-06",5,11,11,22,22,"No",6,5,6,5
"10916","2017-11-06",1,3,6,9,9,"Yes",4,2,2,1
"10917","2017-11-06",1,2,6,8,8,"Yes",2,4,1,1
"10918","2017-11-06",1,5,2,7,7,"Yes",2,0,2,3
"10919","2017-11-06",3,8,6,14,13,"No",1,5,3,5
"10920","2017-11-06",2,6,6,12,12,"Yes",2,4,3,3
"10921","2017-11-06",6,17,8,25,25,"No",2,6,7,10
"10922","2017-11-06",1,2,6,8,8,"Yes",2,4,1,1
"10923","2017-11-06",1,6,3,9,9,"No",2,1,3,3
"10924","2017-11-06",1,3,2,5,5,"Yes",2,0,2,1
"10925","2017-11-06",1,3,2,5,5,"Yes",1,1,1,2
"10926","2017-11-06",2,6,2,8,8,"Yes",1,1,3,3
"10927","2017-11-06",4,8,6,14,14,"Yes",1,5,4,4
"10928","2017-11-06",2,3,7,10,11,"Yes",3,4,1,2
"10929","2017-11-06",4,5,4,9,9,"Yes",2,2,4,1
"10930","2017-11-06",2,5,4,9,9,"No",2,2,2,3
"10931","2017-11-06",1,2,4,6,6,"Yes",2,2,1,1
"10932","2017-11-06",3,7,6,13,13,NA,2,4,3,4
"10933","2017-11-06",1,5,3,8,9,"Yes",3,0,1,4
"10934","2017-11-06",1,4,5,9,9,"Yes",2,3,1,3
"10935","2017-11-06",1,4,4,8,8,"Yes",1,3,2,2
"10936","2017-11-06",4,8,12,20,20,"Yes",6,6,4,4
"10937","2017-11-06",2,10,3,13,13,"No",2,1,4,6
"10938","2017-11-06",1,3,1,4,4,"Yes",0,1,1,2
"10939","2017-11-06",1,2,6,8,7,"Yes",3,3,1,1
"10940","2017-11-06",3,6,4,10,10,"Yes",2,2,3,3
"10941","2017-11-06",5,10,8,18,14,"Yes",4,4,5,5
"10942","2017-11-06",1,6,3,9,9,"No",2,1,3,3
"10943","2017-11-06",7,12,2,14,14,"Yes",1,1,7,5
"10944","2017-11-06",4,9,7,16,16,"No",2,5,4,5
"10945","2017-11-06",3,9,1,10,16,"Yes",1,0,5,4
"10946","2017-11-06",2,4,3,7,7,"Yes",2,1,2,2
"10947","2017-11-06",1,3,2,5,5,"Yes",1,1,0,3
"10948","2017-11-06",1,3,2,5,5,"No",1,1,2,1
"10949","2017-11-06",1,2,5,7,7,"Yes",2,3,1,1
"10950",NA,1,2,2,4,4,"No",2,0,1,1
"10951","2017-11-06",1,9,3,12,12,"Yes",1,2,2,7
"10952","2017-11-06",2,4,11,15,15,"Yes",6,5,2,2
"10953","2017-11-06",1,3,2,5,7,"Yes",1,1,1,2
"10954","2017-11-06",1,5,3,8,8,"Yes",2,1,2,3
"10955","2017-11-06",1,3,6,9,9,"Yes",3,3,1,2
"10956","2017-11-06",2,4,6,10,10,"No",4,2,2,2
"10957","2017-11-06",1,2,4,6,6,"No",2,2,1,1
"10958","2017-11-06",NA,10,7,17,18,"Yes",4,3,4,6
"10959","2017-11-06",1,6,7,13,13,NA,1,6,2,4
"10960","2017-11-13",4,8,4,12,18,"No",1,3,4,4
"10961","2017-11-06",1,4,3,7,7,"Yes",0,3,2,2
"10962","2017-11-06",2,8,4,12,13,"No",1,3,3,5
"10963","2017-11-06",1,2,5,7,7,"Yes",2,3,1,1
"10964",NA,3,4,6,10,10,"Yes",3,3,2,2
"10965","2017-11-06",1,1,0,1,1,"Yes",0,0,1,0
"10966","2017-11-06",1,4,0,4,4,"Yes",0,0,2,2
"10967","2017-11-06",1,4,7,11,11,"Yes",3,4,1,3
"10968","2017-11-06",1,3,4,7,7,"Yes",1,3,1,2
"10969","2017-11-06",2,4,4,8,8,"Yes",1,3,2,2
"10970","2017-11-06",1,2,8,10,10,"No",5,3,1,1
"10971","2017-11-06",1,6,3,9,9,"No",1,2,3,3
"10972","2017-11-06",1,5,2,7,7,"Yes",1,1,2,3
"10973","2017-11-06",5,10,7,17,25,"Yes",3,4,5,5
"10974","2017-11-06",1,2,0,2,2,"Yes",NA,NA,1,1
"10975","2017-11-06",3,6,4,10,10,"Yes",2,2,3,3
"10976","2017-11-06",1,2,1,3,3,"No",1,0,1,1
"10977","2017-11-06",3,6,6,12,12,"No",3,3,4,2
"10978","2017-11-06",1,2,7,9,9,"Yes",5,2,1,1
"10979","2017-11-06",3,8,7,15,15,"Yes",2,5,3,5
"10980","2017-11-06",2,7,5,12,12,"No",2,3,4,3
"10981","2017-11-06",3,5,3,8,8,"No",1,2,3,2
"10982","2017-11-06",1,2,2,4,4,"No",2,NA,1,1
"10983","2017-11-13",1,6,1,7,6,"Yes",1,0,3,3
"10984","2017-11-06",1,2,11,13,13,"Yes",7,4,1,1
"10985","2017-11-06",2,5,5,10,10,"Yes",1,4,2,3
"10986","2017-11-06",6,12,4,16,13,"No",1,3,6,6
"10987","2017-11-06",1,5,2,7,7,"No",1,1,2,3
"10988","2017-11-06",1,4,3,7,7,"Yes",0,3,2,2
"10989","2017-11-06",4,11,8,19,19,"Yes",6,2,4,7
"10990","2017-11-06",1,5,2,7,7,"Yes",2,0,2,3
"10991","2017-11-06",1,5,3,8,8,"No",2,1,2,3
"10992","2017-11-06",4,9,10,19,19,"Yes",3,7,4,5
"10993","2017-11-06",1,3,6,9,9,"Yes",3,3,2,1
"10994","2017-11-06",2,9,6,15,15,"No",4,2,3,6
"10995","2017-11-06",6,12,8,20,20,"Yes",3,5,6,6
"10996","2017-11-06",1,4,3,7,7,"Yes",2,1,1,3
"10997","2017-11-06",4,8,11,19,19,"Yes",4,7,4,4
"10998","2017-11-06",1,7,0,7,7,"Yes",NA,NA,2,5
"10999","2017-11-06",1,8,0,8,8,"No",0,0,3,5
"11000","2017-11-06",NA,1,60,61,NA,"No",25,35,0,1
"11001","2017-11-06",2,10,4,14,14,"Yes",1,3,4,6
"11002","2017-11-06",1,2,3,5,5,"Yes",1,2,1,1
"11003","2017-11-06",1,2,5,7,7,"No",2,3,1,1
"11004","2017-11-06",1,5,6,11,11,"Yes",2,4,3,2
"11005","2017-11-06",1,2,5,7,7,"Yes",2,3,1,1
"11006","2017-11-06",1,4,2,6,6,"Yes",1,1,2,2
"11007","2017-11-06",2,7,3,10,10,"Yes",2,1,5,2
"11008","2017-11-06",1,2,3,5,5,"No",1,2,1,1
"11009","2017-11-06",1,4,3,7,7,"Yes",1,2,2,2
"11010","2017-11-06",2,3,4,7,11,"Yes",2,2,1,2
"11011","2017-11-06",1,7,3,10,10,"No",2,1,4,3
"11012","2017-11-06",1,4,2,6,5,"Yes",2,0,1,3
"11013","2017-11-06",1,2,5,7,7,"Yes",1,4,1,1
"11014","2017-11-06",1,5,4,9,9,"Yes",3,1,2,3
"11015","2017-11-06",1,6,0,6,6,"No",0,0,2,4
"11016","2017-11-06",2,10,5,15,15,"No",2,3,4,6
"11017","2017-11-06",3,6,5,11,11,"Yes",3,2,3,3
"11018","2017-11-06",2,5,5,10,10,"No",4,1,2,3
"11019","2017-11-06",5,10,10,20,20,"No",4,6,5,5
"11020","2017-11-06",NA,10,3,13,NA,"No",2,1,4,6
"11021","2017-11-06",1,5,9,14,6,"Yes",8,1,2,3
"11022","2017-11-06",1,3,3,6,6,"Yes",2,1,2,1
"11023","2017-11-06",1,6,3,9,9,"No",1,2,3,3
"11024","2017-11-06",2,4,4,8,8,"Yes",2,2,2,2
"11025","2017-11-06",1,3,2,5,5,"Yes",0,2,2,1
"11026","2017-11-06",1,2,2,4,4,"No",1,1,1,1
"11027","2017-11-06",1,3,3,6,6,"Yes",2,1,2,1
"11028","2017-11-06",1,4,2,6,6,"Yes",1,1,2,2
"11029","2017-11-06",2,4,6,10,10,"Yes",2,4,2,2
"11030","2017-11-06",1,8,4,12,12,"Yes",3,1,5,3
"11031","2017-11-06",1,3,5,8,8,"Yes",2,3,1,2
"11032","2017-11-06",1,5,1,6,6,"No",0,1,3,2
"11033","2017-11-06",1,10,9,19,2,"Yes",5,4,4,6
"11034","2017-11-06",2,4,3,7,7,"Yes",2,1,2,2
"11035","2017-11-06",1,1,0,1,1,NA,NA,NA,NA,1
"11036","2017-11-06",1,4,7,11,11,"No",4,3,2,2
"11037","2017-11-06",3,6,1,7,7,"Yes",0,1,3,3
"11038","2017-11-06",3,9,0,9,7,"Yes",0,0,3,6
"11039","2017-11-06",4,3,9,12,12,"No",5,4,1,2
"11040","2017-11-06",2,6,3,9,6,"Yes",1,2,4,2
"11041","2017-11-06",2,7,3,10,10,"No",2,1,4,3
"11042","2017-11-06",1,2,3,5,5,"Yes",1,2,1,1
"11043","2017-11-06",1,2,2,4,4,"Yes",1,1,1,1
"11044","2017-11-06",1,3,3,6,6,"Yes",2,1,1,2
"11045","2017-11-06",2,10,4,14,14,"Yes",2,2,4,6
"11046","2017-11-06",1,3,3,6,6,"Yes",1,2,2,1
"11047","2017-11-06",1,3,4,7,7,"Yes",2,2,2,1
"11048","2017-11-06",1,2,1,3,3,"Yes",0,1,1,1
"11049","2017-11-06",1,3,0,3,3,"Yes",0,0,2,1
"11050","2017-11-06",2,5,3,8,8,"No",2,1,3,2
"11051","2017-11-06",2,4,4,8,8,"No",1,3,2,2
"11052","2017-11-06",1,3,4,7,7,"No",2,2,1,2
"11053",NA,1,3,4,7,7,"No",2,2,2,1
"11054","2017-11-06",2,5,3,8,8,"Yes",1,2,3,2
"11055","2017-11-06",1,2,4,6,6,"Yes",2,2,1,1
"11056","2017-11-06",1,12,3,15,15,"No",1,2,5,7
"11057","2017-11-06",1,2,3,5,5,"Yes",1,2,1,1
"11058","2017-11-06",3,9,7,16,16,"Yes",4,3,4,5
"11059","2017-11-06",4,8,5,13,16,"No",2,3,4,4
"11060","2017-11-06",3,5,4,9,9,"No",3,1,3,2
"11061","2017-11-06",1,4,4,8,6,"Yes",2,2,2,2
"11062","2017-11-06",1,2,2,4,4,"Yes",0,2,1,1
"11063","2017-11-06",1,3,4,7,7,"Yes",2,2,1,2
"11064","2017-11-06",2,4,2,6,6,"Yes",1,1,2,2
"11065","2017-11-06",2,7,4,11,11,"Yes",2,2,3,4
"11066","2017-11-06",1,2,3,5,5,"No",1,2,1,1
"11067","2017-11-06",1,2,4,6,6,"No",3,1,0,2
"11068","2017-11-06",1,2,4,6,6,NA,2,2,1,1
"11069","2017-11-06",4,9,9,18,18,"Yes",6,3,5,4
"11070","2017-11-06",4,9,10,19,19,"No",4,6,4,5
"11071","2017-11-06",1,2,7,9,9,"Yes",3,4,1,1
"11072","2017-11-06",2,3,5,8,8,"Yes",2,3,2,1
"11073","2017-11-06",1,2,1,3,3,"Yes",1,0,2,0
"11074","2017-11-06",1,2,4,6,6,"Yes",2,2,1,1
"11075","2017-11-06",1,2,3,5,5,"Yes",2,1,1,1
"11076","2017-11-06",3,7,6,13,13,"Yes",3,3,3,4
"11077","2017-11-06",2,5,6,11,11,"Yes",4,2,2,3
"11078","2017-11-06",4,8,6,14,14,"Yes",3,3,4,4
"11079","2017-10-25",1,2,5,7,7,"Yes",2,3,1,1
"11080","2017-11-06",1,2,2,4,4,"Yes",0,2,1,1
"11081","2017-11-06",2,4,9,13,13,"Yes",5,4,2,2
"11082","2017-10-21",3,5,5,10,10,"Yes",2,3,3,2
"11083","2017-11-06",1,2,4,6,6,"Yes",2,2,1,1
"11084","2017-11-06",2,4,4,8,8,"No",2,2,2,2
"11085","2017-11-06",2,4,3,7,7,"Yes",1,2,2,2
"11086","2017-11-06",6,13,9,22,22,"No",7,2,6,7
"11087","2017-11-06",1,3,5,8,8,"Yes",4,1,1,2
"11088","2017-11-06",1,2,0,2,3,"No",0,0,1,1
"11089","2017-11-06",1,2,2,4,4,"Yes",1,1,1,1
"11090","2017-11-06",1,6,3,9,9,"No",2,1,3,3
"11091","2017-11-06",2,4,7,11,11,"No",3,4,2,2
"11092","2017-11-06",3,6,6,12,12,"No",1,5,3,3
"11093","2017-11-06",2,6,4,10,10,"Yes",2,2,3,3
"11094","2017-11-06",1,2,5,7,7,"Yes",2,3,1,1
"11095","2017-11-06",1,5,1,6,7,"No",0,1,2,3
"11096","2017-11-06",1,3,2,5,5,"Yes",1,1,2,1
"11097","2017-11-06",2,5,3,8,10,"No",2,1,2,3
"11098","2017-11-06",3,9,3,12,12,"Yes",2,1,3,6
"11099","2017-11-06",2,4,3,7,7,"Yes",1,2,2,2
"11100","2017-11-06",1,5,3,8,8,"Yes",1,2,2,3
"11101","2017-11-06",1,4,3,7,7,"No",2,1,2,2
"11102","2017-11-06",NA,7,2,9,NA,"No",0,2,4,3
"11103","2017-11-06",1,2,3,5,5,"No",1,2,1,1
"11104","2017-11-06",2,5,6,11,11,"Yes",4,2,2,3
"11105","2017-11-06",1,1,0,1,1,"Yes",0,0,1,0
"11106","2017-11-06",2,2,5,7,7,"No",4,1,1,1
"11107","2017-11-06",1,4,4,8,8,"No",2,2,1,3
"11108","2017-11-06",1,4,4,8,8,"No",2,2,1,3
"11109","2017-11-06",4,3,4,7,7,"Yes",1,3,2,1
"11110","2017-11-06",2,9,4,13,13,"Yes",2,2,3,6
"11111","2017-11-06",NA,0,0,0,NA,"No",NA,NA,NA,NA
"11112","2017-11-06",1,9,0,9,9,"Yes",0,0,4,5
"11113","2017-11-06",4,8,8,16,14,"Yes",5,3,4,4
"11114","2017-11-06",1,3,2,5,5,"No",1,1,1,2
"11115","2017-11-06",2,5,5,10,11,"No",2,3,2,3
"11116","2017-11-03",4,11,9,20,20,"Yes",6,3,6,5
"11117","2017-10-19",1,15,0,15,15,"Yes",0,0,13,2
"11118","2017-11-06",4,12,5,17,17,"Yes",2,3,5,7
"11119","2017-11-06",5,10,11,21,21,"Yes",6,5,4,6
"11120","2017-11-06",4,6,4,10,10,"Yes",2,2,4,2
"11121","2017-11-06",1,2,2,4,4,"Yes",1,1,0,2
"11122","2017-11-06",1,5,2,7,8,"No",1,1,3,2
"11123","2017-11-06",2,5,4,9,10,"Yes",2,2,2,3
"11124","2017-11-06",1,4,1,5,5,"Yes",0,1,2,2
"11125","2017-11-06",3,6,9,15,15,"Yes",4,5,3,3
"11126","2017-11-06",5,10,10,20,20,"Yes",6,4,5,5
"11127","2017-11-06",4,8,12,20,20,"Yes",8,4,4,4
"11128","2017-11-06",1,2,3,5,5,"No",2,1,1,1
"11129","2017-11-06",2,4,8,12,12,NA,4,4,2,2
"11130","2017-10-30",1,2,1,3,3,"Yes",0,1,1,1
"11131","2017-11-06",1,2,3,5,5,"Yes",3,NA,1,1
"11132","2017-11-06",3,6,8,14,14,"Yes",5,3,3,3
"11133","2017-11-06",2,8,0,8,8,"Yes",0,0,4,4
"11134","2017-11-06",2,4,3,7,7,"Yes",0,3,2,2
"11135","2017-11-06",1,2,4,6,6,"No",1,3,1,1
"11136","2017-11-06",4,9,6,15,15,"Yes",2,4,6,3
"11137","2017-11-06",4,9,11,20,20,"Yes",5,6,4,5
"11138","2017-11-06",1,2,4,6,6,"Yes",2,2,1,1
"11139","2017-11-06",1,3,3,6,6,"Yes",1,2,2,1
"11140","2017-11-06",2,4,4,8,6,"Yes",1,3,2,2
"11141","2017-11-06",1,4,6,10,10,"No",2,4,2,2
"11142","2017-11-06",1,2,5,7,7,"No",2,3,1,1
"11143","2017-11-06",2,8,4,12,14,"No",2,2,4,4
"11144","2017-11-06",1,2,3,5,5,"Yes",1,2,1,1
"11145","2017-11-06",3,6,6,12,12,"Yes",4,2,3,3
"11146","2017-11-06",NA,8,5,13,NA,"Yes",3,2,4,4
"11147","2017-11-06",2,11,9,20,20,"Yes",2,7,4,7
"11148","2017-11-06",2,4,5,9,9,"Yes",2,3,2,2
"11149","2017-11-06",1,4,3,7,7,"Yes",1,2,1,3
"11150","2017-11-06",2,11,5,16,16,"No",3,2,6,5
"11151","2017-11-06",4,8,10,18,18,"Yes",4,6,4,4
"11152","2017-11-06",4,9,9,18,18,"Yes",6,3,3,6
"11153","2017-11-06",2,5,5,10,10,"No",3,2,2,3
"11154","2017-11-06",1,2,6,8,8,"Yes",2,4,1,1
"11155","2017-11-06",2,4,3,7,7,"Yes",1,2,2,2
"11156","2017-11-13",2,4,3,7,7,"No",2,1,2,2
"11157","2017-11-06",3,2,4,6,6,"Yes",1,3,1,1
"11158","2017-11-06",2,6,7,13,13,"Yes",4,3,3,3
"11159","2017-11-06",1,5,2,7,7,"Yes",0,2,2,3
"11160","2017-11-06",1,3,2,5,5,"Yes",1,1,1,2
"11161","2017-11-06",3,9,8,17,18,"Yes",5,3,4,5
"11162",NA,1,4,0,4,4,"Yes",0,0,4,0
"11163","2017-11-06",1,5,3,8,8,"No",1,2,2,3
"11164","2017-11-06",3,6,7,13,13,"Yes",5,2,3,3
"11165","2017-11-06",2,4,5,9,9,"Yes",2,3,2,2
"11166","2017-11-06",3,7,8,15,15,"Yes",5,3,3,4
"11167","2017-11-06",2,9,6,15,15,"No",4,2,6,3
"11168","2017-11-06",3,6,9,15,15,"Yes",4,5,3,3
"11169","2017-11-06",1,2,3,5,5,"Yes",2,1,1,1
"11170","2017-11-06",2,4,4,8,8,"Yes",2,2,2,2
"11171","2017-11-06",1,2,2,4,4,"Yes",1,1,1,1
"11172","2017-11-06",1,4,5,9,9,"No",3,2,1,3
"11173","2017-11-06",1,5,2,7,7,"Yes",1,1,3,2
"11174","2017-11-06",1,2,3,5,5,"No",1,2,1,1
"11175","2017-11-06",1,2,2,4,4,"Yes",1,1,1,1
"11176","2017-11-06",4,8,4,12,12,"Yes",2,2,4,4
"11177","2017-11-06",1,5,3,8,8,"Yes",2,1,2,3
"11178","2017-11-06",3,6,3,9,9,"Yes",0,3,3,3
"11179","2017-11-06",1,4,0,4,4,"No",0,0,2,2
"11180","2017-11-06",2,12,5,17,17,"No",2,3,5,7
"11181","2017-11-06",1,2,7,9,9,"Yes",5,2,1,1
"11182","2017-11-06",1,2,5,7,7,"Yes",3,2,1,1
"11183","2017-11-06",1,6,3,9,9,"No",1,2,3,3
"11184","2017-11-06",4,12,11,23,23,"No",4,7,5,7
"11185","2017-11-06",1,6,3,9,9,"No",2,1,3,3
"11186","2017-11-06",1,2,4,6,5,"Yes",2,2,1,1
"11187","2017-11-06",3,5,7,12,12,"No",2,5,2,3
"11188","2017-11-06",1,2,4,6,6,"Yes",2,2,1,1
"11189","2017-11-06",5,8,7,15,15,"No",3,4,3,5
"11190","2017-11-06",1,2,4,6,6,"Yes",1,3,1,1
"11191","2017-11-06",3,6,5,11,11,"Yes",2,3,3,3
"11192","2017-11-06",1,2,3,5,5,"Yes",1,2,1,1
"11193","2017-11-06",1,2,6,8,8,"Yes",0,6,1,1
"11194","2017-11-06",3,7,5,12,12,"Yes",2,3,3,4
"11195","2017-11-06",3,5,8,13,13,"Yes",4,4,2,3
"11196","2017-11-06",3,6,9,15,15,"No",4,5,3,3
"11197","2017-11-06",1,2,5,7,7,"Yes",1,4,1,1
"11198","2017-11-06",2,3,2,5,5,"No",0,2,1,2
"11199","2017-11-06",1,2,1,3,3,"Yes",0,1,1,1
"11200","2017-11-06",3,5,6,11,11,"Yes",5,1,3,2
"11201","2017-11-06",2,4,8,12,12,"Yes",3,5,2,2
"11202","2017-11-06",3,9,7,16,16,"No",4,3,5,4
"11203","2017-11-06",1,5,3,8,8,"Yes",1,2,2,3
"11204","2017-11-06",3,7,7,14,15,"No",2,5,3,4
"11205","2017-11-06",1,2,5,7,7,"Yes",2,3,1,1
"11206","2017-11-06",3,5,4,9,9,"Yes",1,3,3,2
"11207","2017-11-06",2,6,4,10,11,"Yes",3,1,2,4
"11208","2017-11-06",1,2,3,5,5,"Yes",2,1,1,1
"11209","2017-11-06",1,4,4,8,6,"Yes",2,2,2,2
"11210","2017-11-06",2,5,2,7,7,"Yes",1,1,2,3
"11211","2017-11-06",2,8,6,14,13,"Yes",4,2,3,5
"11212","2017-11-06",1,2,4,6,7,"Yes",1,3,1,1
"11213","2017-11-06",4,10,10,20,20,"Yes",3,7,5,5
"11214","2017-11-06",3,9,7,16,17,"Yes",4,3,4,5
"11215","2017-11-06",2,4,4,8,9,"No",3,1,2,2
"11216","2017-11-06",5,9,9,18,22,"Yes",2,7,5,4
"11217","2017-11-06",4,10,6,16,16,"Yes",3,3,5,5
"11218","2017-11-06",1,4,4,8,8,"Yes",2,2,2,2
"11219","2017-11-06",2,4,5,9,9,"No",4,1,2,2
"11220","2017-11-06",1,2,2,4,5,"Yes",1,1,1,1
"11221","2017-11-06",2,6,5,11,11,"Yes",3,2,2,4
"11222","2017-11-06",3,5,6,11,12,"No",4,2,3,2
"11223","2017-11-06",1,3,3,6,6,"Yes",2,1,2,1
"11224","2017-11-06",1,2,1,3,3,"No",0,1,1,1
"11225","2017-11-06",2,4,5,9,9,"Yes",2,3,2,2
"11226","2017-11-06",3,7,5,12,14,"Yes",4,1,3,4
"11227","2017-11-06",3,7,5,12,12,"Yes",2,3,3,4
"11228","2017-11-06",1,2,2,4,4,"Yes",1,1,1,1
"11229","2017-11-06",1,4,3,7,7,"No",2,1,2,2
"11230","2017-11-06",1,2,2,4,4,"Yes",1,1,1,1
"11231","2017-11-06",1,8,5,13,5,"Yes",3,2,4,4
"11232","2017-11-06",5,9,3,12,12,"Yes",1,2,5,4
"11233","2017-11-06",1,4,5,9,9,"Yes",2,3,2,2
"11234","2017-11-06",5,9,5,14,15,"No",3,2,5,4
"11235","2017-11-06",1,3,3,6,6,"Yes",2,1,2,1
"11236","2017-11-06",2,4,5,9,9,"No",3,2,2,2
"11237","2017-11-06",1,4,4,8,8,"Yes",2,2,2,2
"11238","2017-11-06",5,8,5,13,12,"Yes",3,2,4,4
"11239","2017-11-06",1,4,6,10,10,"Yes",3,3,2,2
"11240","2017-11-06",4,8,8,16,16,"No",3,5,4,4
"11241","2017-11-06",3,8,8,16,17,"Yes",4,4,3,5
"11242","2017-11-06",2,4,4,8,8,"Yes",1,3,2,2
"11243","2017-11-06",3,7,8,15,15,"Yes",5,3,3,4
"11244","2017-11-07",2,8,1,9,9,"Yes",0,1,2,6
"11245","2017-11-07",2,3,4,7,7,"Yes",1,3,2,1
"11246","2017-11-07",2,3,0,3,3,"Yes",0,0,1,2
"11247","2017-11-07",1,3,6,9,9,"Yes",4,2,1,2
"11248","2017-11-07",1,2,2,4,4,"Yes",1,1,1,1
"11249","2017-11-07",1,2,2,4,4,"Yes",1,1,1,1
"11250","2017-11-07",1,5,1,6,6,"Yes",0,1,3,2
"11251","2017-11-07",1,6,1,7,7,"Yes",1,0,3,3
"11252","2017-11-07",1,3,7,10,10,"Yes",2,5,1,2
"11253","2017-11-07",1,3,0,3,3,"No",0,0,2,1
"11254","2017-11-06",2,4,6,10,10,"No",3,3,2,2
"11255","2017-11-07",2,4,8,12,12,"No",5,3,2,2
"11256","2017-11-07",2,4,3,7,7,"Yes",1,2,2,2
"11257","2017-11-07",1,2,8,10,10,"Yes",7,1,1,1
"11258","2017-11-07",5,6,3,9,9,"Yes",1,2,4,2
"11259","2017-11-07",3,4,2,6,6,"Yes",1,1,3,1
"11260","2017-11-07",1,3,4,7,7,"Yes",2,2,1,2
"11261","2017-11-07",1,4,3,7,7,"Yes",1,2,2,2
"11262","2017-11-07",3,5,5,10,12,"Yes",3,2,3,2
"11263","2017-11-07",2,2,7,9,9,"No",3,4,1,1
"11264","2017-11-07",1,5,4,9,8,"No",1,3,1,4
"11265","2017-11-07",2,4,8,12,12,"No",6,2,2,2
"11266","2017-11-07",1,2,5,7,7,"Yes",4,1,1,1
"11267","2017-11-07",2,3,6,9,9,"Yes",3,3,2,1
"11268","2017-11-07",3,6,9,15,15,"Yes",4,5,3,3
"11269","2017-11-07",1,3,3,6,6,"Yes",2,1,1,2
"11270","2017-11-07",1,6,3,9,9,"No",2,1,2,4
"11271",NA,1,3,2,5,5,"Yes",1,1,1,2
"11272","2017-11-07",1,2,3,5,5,"No",1,2,1,1
"11273","2017-11-07",1,2,2,4,4,"Yes",0,2,1,1
"11274","2017-11-08",2,10,3,13,13,"No",2,1,4,6
"11275","2017-11-07",1,2,4,6,6,"Yes",2,2,1,1
"11276","2017-11-07",NA,2,1,3,3,"Yes",0,1,1,1
"11277","2017-11-07",1,4,3,7,7,"Yes",1,2,2,2
"11278","2017-11-07",1,5,3,8,8,"No",2,1,3,2
"11279","2017-11-07",1,1,6,7,7,"Yes",3,3,0,1
"11280","2017-11-07",3,7,17,24,24,"Yes",11,6,3,4
"11281","2017-11-07",1,2,4,6,6,"Yes",2,2,1,1
"11282","2017-11-07",4,10,10,20,20,"Yes",5,5,4,6
"11283","2017-11-07",2,3,1,4,4,"Yes",0,1,2,1
"11284","2017-11-07",5,10,6,16,16,"Yes",1,5,5,5
"11285","2017-11-07",1,2,2,4,4,"Yes",NA,2,1,1
"11286","2017-11-08",1,5,2,7,7,"Yes",1,1,3,2
"11287","2017-11-07",1,3,1,4,4,"No",0,1,1,2
"11288","2017-11-07",6,10,7,17,17,"Yes",4,3,7,3
"11289","2017-11-07",2,10,5,15,15,"No",2,3,5,5
"11290","2017-11-07",1,2,9,11,11,"No",2,7,1,1
"11291","2017-11-08",2,9,3,12,12,"No",1,2,3,6
"11292","2017-11-07",2,4,4,8,8,"Yes",2,2,2,2
"11293","2017-11-07",2,4,1,5,5,"Yes",0,1,3,1
"11294","2017-11-07",3,9,7,16,16,"Yes",2,5,3,6
"11295","2017-11-07",4,7,13,20,20,"Yes",5,8,3,4
"11296","2017-11-07",1,2,4,6,6,"Yes",1,3,1,1
"11297","2017-11-07",1,6,3,9,8,"Yes",2,1,2,4
"11298","2017-11-07",1,2,2,4,4,"No",1,1,1,1
"11299","2017-11-07",6,10,10,20,23,"Yes",5,5,6,4
"11300","2017-11-07",1,2,4,6,6,"No",2,2,1,1
"11301","2017-11-07",6,13,14,27,26,"Yes",6,8,7,6
"11302","2017-11-06",2,5,6,11,11,"Yes",1,5,3,2
"11303","2017-11-07",2,10,5,15,15,"Yes",2,3,6,4
"11304","2017-11-07",3,7,8,15,15,"Yes",3,5,3,4
"11305","2017-11-07",1,2,3,5,5,"Yes",1,2,1,1
"11306","2017-11-07",1,5,0,5,5,"No",0,0,4,1
"11307","2017-11-07",3,2,3,5,5,"Yes",1,2,1,1
"11308","2017-11-07",1,2,4,6,5,"Yes",3,1,1,1
"11309","2017-11-07",3,4,5,9,9,"Yes",2,3,2,2
"11310","2017-11-07",1,3,4,7,7,"Yes",2,2,2,1
"11311","2017-11-07",2,7,3,10,10,"No",2,1,4,3
"11312","2017-11-07",1,4,6,10,10,"Yes",4,2,1,3
"11313","2017-11-07",1,2,2,4,4,"No",1,1,1,1
"11314","2017-11-07",1,2,5,7,7,"No",2,3,1,1
"11315","2017-11-07",5,9,11,20,20,"Yes",5,6,5,4
"11316","2017-11-07",1,2,6,8,8,"Yes",2,4,1,1
"11317","2017-11-07",1,2,12,14,6,"Yes",6,6,1,1
"11318","2017-11-07",1,4,2,6,7,"Yes",0,2,0,4
"11319","2017-11-07",NA,25,0,25,NA,"No",NA,NA,17,8
"11320","2017-11-07",5,3,6,9,9,"Yes",3,3,2,1
"11321","2017-11-07",1,3,1,4,4,NA,1,0,1,2
"11322","2017-11-07",1,2,8,10,10,"Yes",3,5,1,1
"11323","2017-11-07",3,7,3,10,10,"Yes",2,1,4,3
"11324","2017-11-03",NA,144,48,192,NA,"No",18,30,64,80
"11325","2017-11-07",1,5,2,7,7,"Yes",1,1,3,2
"11326","2017-11-07",3,5,4,9,9,"Yes",1,3,3,2
"11327","2017-11-07",1,5,1,6,6,"Yes",0,1,3,2
"11328","2017-11-07",3,6,6,12,12,"No",3,3,3,3
"11329","2017-11-07",2,9,1,10,10,"Yes",1,0,3,6
"11330","2017-11-07",1,1,2,3,3,"Yes",0,2,0,1
"11331","2017-11-07",4,9,4,13,13,"No",2,2,4,5
"11332","2017-11-07",1,2,2,4,4,"Yes",1,1,1,1
"11333","2017-11-07",2,6,2,8,7,"Yes",0,2,2,4
"11334","2017-11-07",1,2,2,4,4,"No",0,2,1,1
"11335","2017-11-07",NA,4,47,51,NA,"No",20,27,1,3
"11336","2017-11-07",2,3,0,3,3,"Yes",0,0,2,1
"11337","2017-11-07",1,2,5,7,6,"Yes",1,4,1,1
"11338","2017-11-07",5,12,10,22,22,"Yes",4,6,5,7
"11339","2017-11-06",2,6,6,12,12,"No",2,4,4,2
"11340","2017-11-07",4,10,13,23,23,"Yes",6,7,4,6
"11341","2017-11-07",3,6,4,10,12,"Yes",1,3,2,4
"11342","2017-11-07",1,2,4,6,6,"Yes",2,2,1,1
"11343","2017-11-07",4,9,1,10,10,"No",0,1,5,4
"11344","2017-11-07",1,3,0,3,3,"Yes",0,0,1,2
"11345","2017-11-07",2,4,3,7,7,"Yes",1,2,2,2
"11346","2017-11-07",3,11,7,18,18,"Yes",4,3,4,7
"11347","2017-11-07",1,3,2,5,5,"Yes",1,1,1,2
"11348","2017-11-03",3,7,3,10,10,"No",2,1,3,4
"11349","2017-11-07",1,4,1,5,5,"Yes",1,NA,1,3
"11350","2017-11-07",1,3,1,4,4,"Yes",0,1,1,2
"11351","2017-11-07",3,5,3,8,8,"Yes",2,1,3,2
"11352","2017-11-07",3,2,4,6,6,"Yes",3,1,1,1
"11353","2017-11-07",1,4,4,8,8,"Yes",3,1,1,3
"11354","2017-11-07",5,10,6,16,16,"Yes",1,5,5,5
"11355","2017-10-31",2,5,5,10,10,"Yes",3,2,2,3
"11356","2017-11-07",1,3,4,7,7,"Yes",1,3,1,2
"11357","2017-11-07",4,11,8,19,19,"Yes",5,3,5,6
"11358","2017-11-07",2,6,10,16,16,"Yes",4,6,3,3
"11359","2017-11-03",2,7,3,10,10,"No",1,2,4,3
"11360","2017-11-07",5,7,6,13,13,"Yes",3,3,3,4
"11361","2017-11-07",2,4,9,13,13,"No",3,6,2,2
"11362","2017-11-07",3,6,9,15,15,"Yes",5,4,3,3
"11363","2017-11-07",1,3,2,5,5,"No",1,1,2,1
"11364","2017-11-07",1,1,3,4,4,"Yes",2,1,0,1
"11365","2017-11-07",8,22,6,28,25,"Yes",1,5,10,12
"11366","2017-11-07",2,9,4,13,13,"No",1,3,3,6
"11367","2017-11-07",3,9,5,14,14,"Yes",3,2,5,4
"11368","2017-11-07",1,2,4,6,6,"Yes",3,1,1,1
"11369","2017-11-07",1,4,1,5,5,"Yes",0,1,2,2
"11370","2017-11-07",3,6,6,12,12,"Yes",4,2,3,3
"11371","2017-11-07",1,5,2,7,7,"Yes",0,2,3,2
"11372","2017-11-07",4,10,4,14,14,"No",1,3,4,6
"11373","2017-11-07",1,2,5,7,7,"Yes",4,1,1,1
"11374","2017-11-07",7,18,13,31,32,"Yes",5,8,7,11
"11375","2017-11-03",1,5,2,7,7,"No",NA,2,3,2
"11376","2017-11-07",1,2,4,6,6,"No",1,3,1,1
"11377","2017-11-07",2,5,3,8,8,"Yes",2,1,2,3
"11378","2017-11-07",3,7,9,16,16,"Yes",3,6,4,3
"11379","2017-11-07",2,2,4,6,6,"Yes",2,2,1,1
"11380","2017-11-07",1,1,5,6,6,"Yes",3,2,1,0
"11381","2017-11-07",2,10,4,14,14,"No",2,2,6,4
"11382","2017-11-07",3,9,5,14,14,"Yes",3,2,5,4
"11383","2017-11-07",4,9,17,26,26,"Yes",9,8,5,4
"11384","2017-11-07",2,9,3,12,12,"No",2,1,4,5
"11385","2017-11-07",2,4,3,7,7,"No",1,2,2,2
"11386","2017-11-07",3,9,6,15,16,"Yes",3,3,4,5
"11387","2017-12-03",1,3,2,5,5,"Yes",1,1,2,1
"11388","2017-11-07",3,5,3,8,8,"Yes",0,3,3,2
"11389","2017-11-07",5,10,4,14,14,"Yes",3,1,5,5
"11390","2017-11-03",1,6,3,9,9,"No",1,2,2,4
"11391","2017-11-07",2,4,7,11,11,"Yes",3,4,2,2
"11392","2017-11-07",2,6,2,8,8,"Yes",1,1,4,2
"11393","2017-11-07",1,2,4,6,6,"Yes",2,2,1,1
"11394","2017-11-07",2,7,8,15,3,"No",5,3,3,4
"11395","2017-11-07",3,6,5,11,11,"Yes",1,4,3,3
"11396","2017-11-07",1,3,1,4,4,"Yes",0,1,1,2
"11397","2017-11-07",1,2,4,6,5,"Yes",1,3,1,1
"11398","2017-11-07",2,7,3,10,10,"No",1,2,4,3
"11399","2017-11-07",1,2,3,5,6,"Yes",2,1,1,1
"11400","2017-11-07",4,6,8,14,14,"Yes",5,3,4,2
"11401","2017-11-07",3,6,5,11,12,"Yes",0,5,3,3
"11402","2017-11-07",2,4,7,11,11,"Yes",5,2,2,2
"11403","2017-11-07",3,5,3,8,8,"No",0,3,4,1
"11404","2017-11-07",1,2,0,2,2,"No",0,0,1,1
"11405","2017-11-07",1,5,2,7,7,"Yes",1,1,2,3
"11406","2017-11-07",4,8,12,20,20,"Yes",5,7,4,4
"11407","2017-11-07",NA,8,70,78,NA,"Yes",30,40,4,4
"11408","2017-11-07",2,5,2,7,7,"No",1,1,2,3
"11409","2017-11-07",4,12,11,23,15,"Yes",4,7,6,6
"11410","2017-11-07",1,5,3,8,8,"No",2,1,3,2
"11411","2017-11-07",1,2,4,6,7,"Yes",3,1,1,1
"11412","2017-11-07",4,9,5,14,15,"Yes",3,2,4,5
"11413","2017-11-07",3,7,5,12,17,NA,1,4,5,2
"11414","2017-11-07",2,4,6,10,10,"No",4,2,2,2
"11415","2017-11-07",3,7,5,12,14,"Yes",3,2,3,4
"11416","2017-11-07",3,6,7,13,13,"Yes",3,4,3,3
"11417","2017-11-07",1,6,3,9,9,"Yes",2,1,3,3
"11418","2017-11-07",1,2,0,2,3,"Yes",0,0,1,1
"11419","2017-11-07",1,2,13,15,15,"Yes",8,5,1,1
"11420","2017-11-08",2,9,5,14,14,"No",2,3,4,5
"11421","2017-11-07",4,10,10,20,20,"No",4,6,5,5
"11422","2017-11-07",1,2,7,9,9,"Yes",4,3,1,1
"11423","2017-11-07",1,5,1,6,6,"Yes",0,1,2,3
"11424","2017-11-07",3,8,9,17,17,"No",5,4,3,5
"11425","2017-11-07",1,3,4,7,7,"Yes",2,2,1,2
"11426","2017-11-07",4,10,9,19,19,"Yes",6,3,4,6
"11427","2017-11-07",1,2,6,8,8,"Yes",1,5,1,1
"11428","2017-11-07",8,10,1,11,11,"No",1,NA,5,5
"11429","2017-11-07",1,3,2,5,5,"Yes",1,1,1,2
"11430","2017-11-07",1,4,2,6,6,"No",1,1,3,1
"11431","2017-11-07",2,5,8,13,13,"Yes",4,4,2,3
"11432","2017-11-07",4,7,6,13,13,"Yes",2,4,5,2
"11433","2017-11-02",1,4,2,6,6,"No",2,NA,2,2
"11434","2017-11-07",1,3,1,4,4,"No",1,0,2,1
"11435","2017-11-07",2,6,5,11,11,"No",2,3,3,3
"11436","2017-11-07",3,7,9,16,16,"Yes",6,3,3,4
"11437","2017-11-07",3,12,4,16,16,"No",2,2,4,8
"11438","2017-11-07",2,4,3,7,6,"Yes",2,1,2,2
"11439","2017-11-07",1,2,3,5,5,"Yes",1,2,1,1
"11440","2017-11-07",2,2,2,4,4,"No",1,1,1,1
"11441","2017-11-07",1,2,4,6,6,"No",1,3,1,1
"11442","2017-11-07",4,12,8,20,20,"No",4,4,5,7
"11443","2017-11-07",1,2,3,5,5,"Yes",1,2,1,1
"11444","2017-11-07",2,2,4,6,8,"No",0,4,0,2
"11445","2017-11-07",1,7,3,10,8,"Yes",2,1,4,3
"11446","2017-11-07",7,17,14,31,33,"Yes",8,6,7,10
"11447","2017-11-07",2,8,5,13,13,"Yes",3,2,5,3
"11448","2017-11-07",2,6,6,12,12,"No",2,4,3,3
"11449","2017-11-07",4,10,9,19,19,"No",3,6,4,6
"11450","2017-11-07",3,10,6,16,16,"Yes",2,4,4,6
"11451","2017-11-07",1,2,4,6,6,"Yes",2,2,1,1
"11452","2017-11-07",1,3,3,6,6,"No",1,2,2,1
"11453","2017-11-07",6,8,3,11,11,"No",1,2,6,2
"11454",NA,3,8,7,15,15,"Yes",3,4,3,5
"11455","2017-11-07",5,13,9,22,22,"Yes",3,6,5,8
"11456","2017-11-07",2,2,3,5,5,"Yes",2,1,1,1
"11457","2017-11-07",2,7,1,8,7,"Yes",0,1,4,3
"11458","2017-11-07",1,4,3,7,7,"Yes",2,1,1,3
"11459","2017-11-07",1,2,1,3,3,"Yes",0,1,0,2
"11460","2017-11-07",2,4,6,10,10,"No",4,2,2,2
"11461","2017-11-07",2,4,3,7,7,"No",1,2,2,2
"11462","2017-11-07",2,4,5,9,9,"No",2,3,2,2
"11463","2017-11-07",3,10,5,15,15,"No",2,3,6,4
"11464","2017-11-07",2,7,8,15,15,"No",4,4,5,2
"11465","2017-11-07",1,3,2,5,5,"Yes",1,1,1,2
"11466","2017-11-07",3,8,3,11,11,"Yes",2,1,4,4
"11467","2017-11-07",1,3,4,7,7,"Yes",1,3,2,1
"11468","2017-11-07",1,5,2,7,7,"Yes",2,0,3,2
"11469","2017-11-07",2,4,5,9,9,"Yes",2,3,2,2
"11470","2017-11-07",2,4,5,9,9,"Yes",2,3,2,2
"11471","2017-11-07",4,7,4,11,11,"Yes",2,2,3,4
"11472","2017-11-07",NA,2,3,5,NA,"Yes",1,2,1,1
"11473","2017-11-07",5,11,8,19,19,"No",5,3,5,6
"11474","2017-11-07",1,6,2,8,8,"Yes",1,1,3,3
"11475","2017-11-07",2,5,6,11,12,"No",1,5,3,2
"11476","2017-11-07",7,13,12,25,25,"No",5,7,6,7
"11477","2017-11-02",3,7,5,12,12,"No",3,2,4,3
"11478","2017-11-07",2,4,7,11,11,"No",4,3,1,3
"11479","2017-11-07",5,8,1,9,9,NA,0,1,5,3
"11480","2017-11-07",5,10,7,17,17,"Yes",4,3,5,5
"11481","2017-11-07",4,10,8,18,18,"Yes",4,4,3,7
"11482","2017-11-07",1,5,2,7,7,"Yes",1,1,2,3
"11483","2017-11-02",1,2,6,8,8,"Yes",2,4,1,1
"11484",NA,3,4,5,9,9,"Yes",2,3,2,2
"11485","2017-11-07",2,6,5,11,11,"Yes",2,3,3,3
"11486","2017-11-07",1,2,0,2,2,"Yes",0,0,1,1
"11487","2017-11-07",2,4,2,6,6,"No",0,2,2,2
"11488","2017-11-07",4,10,11,21,21,"No",5,6,4,6
"11489","2017-11-07",4,13,5,18,18,"Yes",3,2,5,8
"11490","2017-11-07",2,6,32,38,8,"Yes",0,32,3,3
"11491","2017-11-07",1,3,0,3,3,"Yes",NA,NA,NA,3
"11492","2017-11-07",2,4,4,8,8,NA,2,2,2,2
"11493","2017-11-07",3,8,5,13,13,"Yes",2,3,4,4
"11494","2017-11-07",2,4,5,9,9,"Yes",1,4,2,2
"11495","2017-11-07",1,4,0,4,4,"Yes",0,0,1,3
"11496","2017-11-07",3,8,2,10,10,"Yes",2,0,4,4
"11497","2017-11-07",2,5,1,6,6,"Yes",1,0,2,3
"11498","2017-11-07",1,5,3,8,8,"Yes",2,1,2,3
"11499","2017-11-07",1,5,2,7,7,"Yes",1,1,2,3
"11500","2017-11-07",2,4,5,9,9,"Yes",2,3,2,2
"11501","2017-11-07",2,4,14,18,18,"No",6,8,2,2
"11502","2017-11-07",3,7,8,15,15,"No",5,3,3,4
"11503","2017-11-07",5,10,5,15,15,"Yes",2,3,6,4
"11504","2017-11-07",4,7,8,15,15,"No",5,3,2,5
"11505","2017-11-07",4,11,11,22,22,"Yes",6,5,5,6
"11506","2017-11-07",1,3,1,4,4,"Yes",0,1,2,1
"11507","2017-11-07",1,5,3,8,8,"Yes",1,2,2,3
"11508","2017-11-07",1,2,5,7,7,"Yes",3,2,1,1
"11509","2017-11-07",2,7,5,12,12,"No",2,3,4,3
"11510","2017-11-07",1,2,1,3,3,"Yes",1,0,1,1
"11511","2017-11-07",3,6,6,12,12,"Yes",5,1,3,3
"11512","2017-11-07",1,1,3,4,4,"Yes",2,1,NA,1
"11513","2017-11-07",2,4,3,7,7,"Yes",1,2,2,2
"11514","2017-11-07",1,6,3,9,9,"Yes",2,1,2,4
"11515","2017-11-07",1,5,3,8,7,"Yes",2,1,2,3
"11516","2017-11-07",2,4,10,14,14,"Yes",5,5,2,2
"11517","2017-11-07",1,2,3,5,5,"Yes",2,1,1,1
"11518","2017-11-07",1,2,9,11,11,"Yes",4,5,1,1
"11519","2017-11-07",3,8,5,13,13,"No",5,0,4,4
"11520","2017-11-07",3,4,6,10,10,"Yes",3,3,2,2
"11521","2017-11-07",1,2,0,2,2,"No",0,0,2,0
"11522","2017-11-07",1,2,0,2,2,"No",0,0,1,1
"11523","2017-11-07",2,6,4,10,8,"No",3,1,3,3
"11524","2017-11-07",1,2,1,3,3,"Yes",0,1,1,1
"11525","2017-11-07",1,5,1,6,6,"Yes",0,1,3,2
"11526","2017-11-07",1,2,3,5,5,"Yes",2,1,1,1
"11527","2017-11-07",1,2,2,4,4,"Yes",0,2,1,1
"11528","2017-11-07",2,4,3,7,7,"Yes",2,1,2,2
"11529","2017-11-07",1,2,3,5,5,"Yes",1,2,1,1
"11530","2017-11-07",NA,80,25,105,NA,"No",10,15,30,50
"11531","2017-11-14",1,2,2,4,4,"No",1,1,1,1
"11532","2017-11-07",2,4,6,10,10,"Yes",2,4,2,2
"11533","2017-11-07",2,5,4,9,9,"Yes",2,2,2,3
"11534","2017-11-07",2,6,5,11,11,"Yes",3,2,2,4
"11535","2017-11-07",2,4,8,12,12,"Yes",4,4,2,2
"11536","2017-11-07",2,8,4,12,12,"Yes",1,3,3,5
"11537","2017-11-07",4,10,3,13,13,"Yes",3,0,5,5
"11538","2017-11-07",3,7,5,12,12,"Yes",3,2,3,4
"11539","2017-11-07",2,4,4,8,8,"No",1,3,2,2
"11540","2017-11-07",1,2,4,6,6,"Yes",1,3,1,1
"11541","2017-11-07",1,2,5,7,7,"Yes",4,1,1,1
"11542","2017-11-07",3,6,7,13,13,"Yes",3,4,3,3
"11543","2017-11-07",1,2,4,6,6,"Yes",4,0,1,1
"11544","2017-11-07",1,2,3,5,5,"Yes",1,2,1,1
"11545","2017-11-07",2,7,4,11,11,"No",2,2,3,4
"11546","2017-11-07",1,3,4,7,7,"Yes",1,3,1,2
"11547","2017-11-07",1,2,6,8,8,"Yes",3,3,1,1
"11548","2017-11-07",1,2,3,5,5,"Yes",1,2,1,1
"11549","2017-11-07",1,2,0,2,2,"Yes",0,0,1,1
"11550","2017-11-07",1,2,2,4,4,"Yes",1,1,1,1
"11551","2017-11-07",1,2,1,3,3,"Yes",0,1,1,1
"11552","2017-11-07",3,8,5,13,13,"No",3,2,3,5
"11553","2017-11-07",1,3,4,7,7,"Yes",2,2,2,1
"11554","2017-11-07",1,2,4,6,6,"No",2,2,1,1
"11555","2017-11-07",1,4,4,8,8,"Yes",2,2,2,2
"11556","2017-11-07",5,7,9,16,16,"No",4,5,4,3
"11557","2017-11-07",2,2,6,8,7,"Yes",4,2,1,1
"11558","2017-11-07",1,2,5,7,7,"No",2,3,1,1
"11559","2017-11-07",2,4,4,8,8,"Yes",0,4,2,2
"11560","2017-11-07",1,2,3,5,5,"Yes",0,3,1,1
"11561","2017-11-07",4,8,10,18,18,"Yes",4,6,4,4
"11562","2017-11-07",7,10,6,16,16,"No",4,2,7,3
"11563","2017-11-07",1,5,2,7,7,NA,1,1,2,3
"11564","2017-11-07",2,4,6,10,10,"Yes",3,3,2,2
"11565","2017-11-07",1,6,6,12,12,"Yes",4,2,2,4
"11566","2017-11-07",1,5,2,7,7,"Yes",1,1,2,3
"11567","2017-11-07",1,7,6,13,13,"Yes",3,3,4,3
"11568","2017-11-07",31,5,10,15,14,"No",4,6,2,3
"11569","2017-11-07",1,2,0,2,2,"Yes",NA,NA,1,1
"11570","2017-11-07",3,7,4,11,12,"Yes",2,2,4,3
"11571","2017-11-07",1,2,3,5,5,"Yes",1,2,1,1
"11572","2017-11-07",1,3,7,10,10,"Yes",3,4,1,2
"11573","2017-11-07",1,4,1,5,5,"Yes",0,1,2,2
"11574","2017-11-07",1,7,7,14,14,"Yes",2,5,2,5
"11575","2017-11-07",1,3,4,7,7,"Yes",3,1,1,2
"11576","2017-11-07",2,3,3,6,6,"Yes",1,2,1,2
"11577","2017-11-07",1,5,4,9,9,"No",2,2,2,3
"11578","2017-11-07",2,4,3,7,7,"No",1,2,2,2
"11579","2017-11-07",5,12,2,14,15,"No",0,2,7,5
"11580","2017-11-07",1,2,2,4,4,"Yes",1,1,1,1
"11581","2017-11-07",4,11,7,18,18,"Yes",3,4,4,7
"11582","2017-11-07",1,5,3,8,8,"Yes",1,2,2,3
"11583","2017-11-07",3,8,4,12,12,"No",2,2,4,4
"11584","2017-11-07",1,7,2,9,9,"Yes",0,2,4,3
"11585","2017-11-07",NA,14,481,495,NA,"No",231,250,8,6
"11586","2017-11-07",3,6,2,8,10,"Yes",2,0,4,2
"11587","2017-11-07",2,4,2,6,6,"Yes",1,1,1,3
"11588","2017-11-07",6,12,5,17,17,"No",2,3,6,6
"11589","2017-11-07",2,7,4,11,10,"Yes",1,3,2,5
"11590","2017-11-07",4,12,5,17,17,"No",2,3,5,7
"11591","2017-11-07",NA,3,30,33,NA,"No",13,17,0,3
"11592","2017-11-07",5,10,9,19,19,"Yes",5,4,5,5
"11593","2017-11-07",1,4,4,8,8,"Yes",2,2,1,3
"11594","2017-11-07",4,8,6,14,11,"Yes",2,4,4,4
"11595","2017-11-07",1,3,5,8,6,"No",2,3,1,2
"11596","2017-11-07",4,9,5,14,13,"Yes",3,2,4,5
"11597","2017-11-07",1,3,2,5,5,"No",1,1,1,2
"11598","2017-11-07",1,5,2,7,7,"Yes",1,1,2,3
"11599","2017-11-07",1,3,3,6,6,"Yes",1,2,2,1
"11600","2017-11-07",1,8,2,10,9,"Yes",1,1,6,2
"11601","2017-11-07",2,4,5,9,9,"Yes",2,3,2,2
"11602","2017-11-07",5,11,11,22,23,"No",1,10,5,6
"11603","2017-11-07",2,6,7,13,13,"Yes",2,5,4,2
"11604","2017-11-07",4,11,7,18,19,"Yes",3,4,4,7
"11605","2017-11-07",1,8,5,13,13,"No",1,4,3,5
"11606","2017-11-07",1,2,5,7,8,"Yes",1,4,1,1
"11607","2017-11-07",2,4,6,10,10,"Yes",2,4,2,2
"11608","2017-11-07",1,4,2,6,6,"Yes",2,0,2,2
"11609","2017-11-07",1,2,3,5,5,"No",1,2,1,1
"11610","2017-11-08",1,3,2,5,5,"Yes",1,1,1,2
"11611","2017-11-08",1,5,1,6,6,"Yes",0,1,2,3
"11612","2017-11-08",NA,120,30,150,NA,"Yes",10,20,50,70
"11613","2017-11-08",1,2,3,5,4,"Yes",2,1,1,1
"11614","2017-11-08",3,6,5,11,11,"Yes",2,3,3,3
"11615","2017-11-08",2,4,5,9,9,"No",2,3,2,2
"11616","2017-11-08",1,6,4,10,10,"No",2,2,3,3
"11617","2017-11-08",3,6,2,8,8,"No",1,1,3,3
"11618","2017-11-08",1,7,2,9,9,"Yes",2,NA,4,3
"11619","2017-11-08",1,3,4,7,7,"No",1,3,2,1
"11620","2017-11-08",2,10,5,15,15,"No",2,3,4,6
"11621","2017-11-08",1,3,3,6,6,"Yes",1,2,1,2
"11622","2017-11-08",2,5,3,8,8,"No",2,1,2,3
"11623","2017-11-08",2,3,0,3,3,"Yes",0,0,1,2
"11624","2017-11-08",5,12,11,23,23,"Yes",5,6,4,8
"11625","2017-11-08",1,7,6,13,13,"Yes",3,3,2,5
"11626","2017-11-08",1,6,3,9,8,"Yes",3,NA,3,3
"11627","2017-11-08",3,7,5,12,12,"Yes",2,3,3,4
"11628","2017-11-08",5,11,5,16,16,"Yes",3,2,6,5
"11629","2017-11-08",2,5,1,6,6,"Yes",0,1,2,3
"11630","2017-11-08",2,6,5,11,11,"Yes",3,2,2,4
"11631","2017-11-08",1,3,7,10,10,"Yes",1,6,1,2
"11632","2017-11-09",1,5,3,8,9,"No",2,1,3,2
"11633","2017-11-08",4,11,9,20,20,"Yes",5,4,4,7
"11634","2017-11-08",3,6,1,7,7,"Yes",NA,1,3,3
"11635","2017-11-08",2,7,1,8,8,"Yes",1,0,3,4
"11636","2017-11-08",1,4,3,7,7,"Yes",1,2,2,2
"11637","2017-11-09",1,5,3,8,8,"No",2,1,3,2
"11638","2017-11-08",1,1,0,1,1,"Yes",0,0,1,0
"11639","2017-11-08",1,2,3,5,5,"No",1,2,1,1
"11640","2017-11-08",2,8,5,13,13,"Yes",2,3,4,4
"11641","2017-11-08",1,2,0,2,2,"Yes",0,0,1,1
"11642","2017-11-08",1,2,0,2,2,"No",0,0,1,1
"11643","2017-11-08",2,4,4,8,8,"Yes",1,3,2,2
"11644","2017-11-08",1,6,3,9,9,"No",1,2,3,3
"11645","2017-11-08",1,2,2,4,4,"Yes",1,1,1,1
"11646","2017-11-08",1,2,3,5,5,"Yes",2,1,1,1
"11647","2017-11-08",3,7,5,12,12,"Yes",2,3,3,4
"11648","2017-11-08",1,2,5,7,7,"Yes",2,3,1,1
"11649","2017-11-08",1,7,4,11,11,"No",2,2,4,3
"11650","2017-11-08",1,4,6,10,10,"Yes",4,2,2,2
"11651","2017-11-08",1,4,2,6,6,"Yes",1,1,1,3
"11652","2017-11-08",1,2,3,5,6,"Yes",0,3,1,1
"11653","2017-11-08",2,7,5,12,12,"Yes",2,3,4,3
"11654","2017-11-08",1,3,1,4,4,"Yes",1,0,2,1
"11655","2017-11-08",2,4,4,8,8,"No",1,3,2,2
"11656","2017-11-08",1,3,3,6,6,"Yes",2,1,1,2
"11657","2017-11-08",4,11,7,18,18,"Yes",4,3,4,7
"11658",NA,1,8,1,9,8,"Yes",1,NA,4,4
"11659","2017-11-08",1,2,3,5,5,"No",1,2,1,1
"11660","2017-11-08",1,4,3,7,7,"Yes",2,1,2,2
"11661","2017-11-08",1,5,3,8,8,"Yes",2,1,2,3
"11662","2017-11-08",2,7,5,12,12,"No",3,2,4,3
"11663","2017-11-08",7,12,10,22,22,"Yes",5,5,7,5
"11664","2017-11-08",3,9,10,19,19,"Yes",7,3,4,5
"11665","2017-11-08",4,5,5,10,10,"No",2,3,2,3
"11666","2017-11-08",1,2,4,6,6,"Yes",2,2,1,1
"11667","2017-11-08",1,4,9,13,13,"Yes",5,4,1,3
"11668","2017-11-08",1,5,4,9,9,"Yes",2,2,2,3
"11669","2017-11-08",1,3,7,10,9,"Yes",2,5,0,3
"11670","2017-11-08",1,2,4,6,6,"Yes",1,3,1,1
"11671","2017-11-08",4,4,4,8,8,"No",3,1,2,2
"11672","2017-11-08",5,12,10,22,21,"Yes",6,4,5,7
"11673","2017-11-08",1,2,3,5,5,"Yes",2,1,1,1
"11674","2017-11-08",1,3,4,7,7,"Yes",3,1,1,2
"11675","2017-11-08",1,2,4,6,6,"Yes",0,4,1,1
"11676","2017-11-08",1,2,3,5,5,"Yes",2,1,1,1
"11677","2017-11-08",1,6,1,7,7,"Yes",1,NA,5,1
"11678","2017-11-08",3,8,7,15,15,"Yes",5,2,3,5
"11679","2017-11-08",2,8,6,14,14,"No",4,2,3,5
"11680","2017-11-08",1,2,3,5,5,"Yes",2,1,1,1
"11681","2017-11-08",1,7,2,9,8,"Yes",1,1,4,3
"11682","2017-11-08",1,6,3,9,9,"No",2,1,3,3
"11683","2017-11-08",1,2,3,5,1,"Yes",2,1,1,1
"11684","2017-11-08",1,3,4,7,6,"Yes",1,3,1,2
"11685","2017-11-08",1,4,1,5,5,"Yes",1,0,2,2
"11686","2017-11-08",2,8,5,13,13,"No",2,3,4,4
"11687","2017-11-08",1,4,4,8,8,"Yes",2,2,2,2
"11688","2017-11-08",3,7,8,15,15,"Yes",4,4,3,4
"11689","2017-11-08",1,6,1,7,8,"Yes",0,1,4,2
"11690","2017-11-08",1,5,3,8,8,"No",2,1,3,2
"11691","2017-11-08",3,9,6,15,15,"Yes",2,4,4,5
"11692","2017-11-08",1,2,3,5,5,"Yes",1,2,1,1
"11693","2017-11-08",1,5,5,10,10,"No",2,3,3,2
"11694","2017-11-08",1,3,8,11,11,"Yes",5,3,2,1
"11695","2017-11-08",1,3,3,6,5,"Yes",1,2,1,2
"11696","2017-11-08",2,7,5,12,12,"No",3,2,4,3
"11697","2017-11-08",1,2,0,2,2,"Yes",0,0,1,1
"11698","2017-11-08",1,6,1,7,7,"Yes",0,1,2,4
"11699","2017-11-08",2,8,4,12,12,"No",2,2,3,5
"11700","2017-11-08",1,2,42,44,47,"Yes",17,25,1,1
"11701","2017-11-08",2,9,5,14,14,"No",2,3,4,5
"11702","2017-11-08",3,6,7,13,13,"Yes",4,3,3,3
"11703","2017-11-08",2,5,5,10,10,"No",2,3,2,3
"11704","2017-11-08",2,3,5,8,8,"Yes",3,2,2,1
"11705","2017-11-08",1,6,3,9,9,"No",1,2,3,3
"11706","2017-11-08",2,4,4,8,8,"Yes",2,2,2,2
"11707","2017-11-08",2,9,4,13,13,"No",2,2,4,5
"11708","2017-11-08",2,7,2,9,9,"Yes",0,2,3,4
"11709","2017-11-08",1,4,4,8,8,"Yes",2,2,1,3
"11710","2017-11-08",3,4,4,8,8,"Yes",2,2,2,2
"11711","2017-11-08",1,6,3,9,9,"Yes",1,2,2,4
"11712","2017-11-08",1,6,2,8,7,"No",1,1,4,2
"11713","2017-11-08",NA,2,40,42,NA,"Yes",25,15,1,1
"11714","2017-11-08",1,7,1,8,8,"No",0,1,4,3
"11715","2017-11-08",1,5,1,6,6,"Yes",1,0,2,3
"11716","2017-11-08",1,7,3,10,10,"No",2,1,3,4
"11717","2017-11-08",1,5,7,12,12,"Yes",5,2,3,2
"11718","2017-11-08",2,10,7,17,14,"Yes",4,3,5,5
"11719","2017-11-08",2,5,2,7,9,"No",1,1,2,3
"11720","2017-11-08",1,4,2,6,6,"No",1,1,2,2
"11721","2017-11-08",3,5,5,10,10,"Yes",2,3,4,1
"11722","2017-11-08",3,6,4,10,10,"Yes",1,3,3,3
"11723","2017-11-08",1,2,2,4,4,"Yes",1,1,1,1
"11724","2017-11-08",1,2,4,6,6,"Yes",2,2,1,1
"11725","2017-11-08",3,6,5,11,12,"Yes",2,3,3,3
"11726","2017-11-08",1,2,3,5,5,"Yes",0,3,1,1
"11727","2017-11-08",1,5,4,9,4,"Yes",2,2,3,2
"11728","2017-11-08",1,2,5,7,7,"Yes",2,3,1,1
"11729","2017-11-08",2,6,4,10,10,"Yes",1,3,4,2
"11730","2017-11-08",3,4,1,5,5,"Yes",0,1,2,2
"11731","2017-11-08",1,3,3,6,6,"Yes",1,2,2,1
"11732","2017-11-08",2,2,2,4,4,"Yes",NA,2,1,1
"11733","2017-11-08",1,4,4,8,8,"Yes",2,2,2,2
"11734","2017-11-08",2,9,3,12,12,"No",1,2,4,5
"11735","2017-11-08",3,6,5,11,11,"Yes",3,2,3,3
"11736","2017-11-08",3,11,10,21,21,"Yes",6,4,4,7
"11737","2017-11-08",1,2,1,3,3,NA,NA,1,1,1
"11738","2017-11-08",2,7,7,14,14,"No",4,3,2,5
"11739","2017-11-08",1,6,1,7,7,"Yes",1,0,2,4
"11740","2017-11-08",2,7,3,10,10,"Yes",1,2,3,4
"11741","2017-11-08",2,7,7,14,13,"Yes",5,2,3,4
"11742","2017-11-08",4,8,5,13,13,"Yes",3,2,4,4
"11743","2017-11-08",2,4,2,6,6,"No",1,1,2,2
"11744","2017-11-08",1,4,3,7,7,"Yes",2,1,1,3
"11745","2017-11-08",3,6,10,16,16,"Yes",4,6,3,3
"11746","2017-11-08",1,4,3,7,7,"Yes",1,2,3,1
"11747","2017-11-08",3,8,5,13,14,"Yes",3,2,4,4
"11748","2017-11-08",1,5,3,8,8,"Yes",2,1,2,3
"11749","2017-11-15",1,4,2,6,6,"No",1,1,1,3
"11750","2017-11-08",3,8,4,12,12,"Yes",1,3,4,4
"11751","2017-11-08",1,6,4,10,10,"Yes",2,2,3,3
"11752","2017-11-08",3,9,2,11,11,"Yes",1,1,6,3
"11753","2017-11-08",1,6,3,9,9,"No",1,2,4,2
"11754","2017-11-08",1,4,5,9,9,"Yes",2,3,2,2
"11755","2017-11-08",1,4,4,8,8,"Yes",3,1,2,2
"11756","2017-11-08",2,10,6,16,16,"No",2,4,4,6
"11757","2017-11-08",1,4,2,6,6,"Yes",1,1,2,2
"11758","2017-11-08",1,5,2,7,7,"No",1,1,3,2
"11759","2017-11-08",1,2,3,5,5,"Yes",0,3,1,1
"11760","2017-11-08",2,7,4,11,11,"No",2,2,4,3
"11761","2017-11-08",4,8,7,15,15,"No",3,4,3,5
"11762","2017-11-08",1,4,3,7,7,"Yes",0,3,1,3
"11763","2017-11-08",1,3,3,6,6,"Yes",1,2,1,2
"11764","2017-11-08",2,5,5,10,10,"Yes",2,3,3,2
"11765","2017-11-08",1,2,3,5,5,"Yes",2,1,1,1
"11766","2017-11-08",1,3,3,6,6,"Yes",2,1,1,2
"11767","2017-11-08",2,4,4,8,8,"Yes",1,3,2,2
"11768","2017-11-08",2,7,2,9,9,"Yes",1,1,3,4
"11769","2017-11-08",2,4,5,9,9,"No",2,3,2,2
"11770","2017-11-08",1,2,4,6,6,"Yes",1,3,1,1
"11771","2017-11-08",2,8,4,12,12,"Yes",2,2,5,3
"11772","2017-11-08",1,2,0,2,2,"Yes",0,0,1,1
"11773","2017-11-08",3,5,4,9,9,"Yes",1,3,3,2
"11774","2017-11-08",1,4,1,5,4,"Yes",1,0,2,2
"11775","2017-11-08",1,3,2,5,5,"Yes",1,1,1,2
"11776","2017-11-08",3,10,5,15,15,"No",3,2,4,6
"11777","2017-11-08",4,10,9,19,19,"Yes",6,3,4,6
"11778","2017-11-08",2,4,5,9,9,"Yes",3,2,2,2
"11779","2017-11-08",2,9,5,14,14,"Yes",3,2,4,5
"11780","2017-11-08",1,5,3,8,8,"Yes",2,1,2,3
"11781","2017-11-08",1,4,3,7,7,"Yes",2,1,1,3
"11782","2017-11-08",1,4,4,8,8,"Yes",2,2,2,2
"11783","2017-11-08",1,2,5,7,7,"Yes",3,2,0,2
"11784","2017-10-26",4,6,2,8,8,"No",2,NA,2,4
"11785","2017-11-08",1,3,1,4,4,"Yes",0,1,1,2
"11786","2017-11-08",1,2,5,7,7,"Yes",2,3,1,1
"11787","2017-11-08",1,5,2,7,7,"Yes",1,1,3,2
"11788","2017-11-08",1,2,2,4,4,"Yes",1,1,1,1
"11789","2017-11-08",3,12,13,25,25,"No",5,8,5,7
"11790","2017-11-08",1,3,2,5,5,"Yes",1,1,1,2
"11791","2017-11-08",5,11,10,21,21,"No",7,3,6,5
"11792","2017-11-08",2,8,6,14,13,"No",1,5,5,3
"11793","2017-11-08",1,2,4,6,6,"Yes",1,3,1,1
"11794","2017-11-08",1,2,2,4,4,"Yes",1,1,1,1
"11795","2017-11-08",3,7,2,9,9,"No",2,0,4,3
"11796","2017-11-08",1,3,3,6,6,"Yes",1,2,1,2
"11797","2017-11-08",1,5,3,8,8,"Yes",1,2,2,3
"11798","2017-11-08",2,5,6,11,11,"Yes",4,2,2,3
"11799","2017-11-08",1,3,4,7,7,"Yes",1,3,2,1
"11800","2017-11-08",1,2,4,6,6,"Yes",2,2,1,1
"11801","2017-11-08",1,2,3,5,5,"No",1,2,1,1
"11802","2017-11-08",1,4,3,7,5,"Yes",NA,3,1,3
"11803","2017-11-08",1,4,2,6,6,"Yes",1,1,2,2
"11804","2017-11-08",1,2,3,5,5,"Yes",2,1,1,1
"11805","2017-11-08",1,2,5,7,7,"Yes",2,3,1,1
"11806","2017-11-08",1,3,4,7,7,"Yes",2,2,2,1
"11807","2017-11-08",1,2,1,3,3,"No",0,1,1,1
"11808","2017-11-08",1,4,2,6,3,"No",1,1,2,2
"11809","2017-11-08",1,2,2,4,4,"Yes",2,0,1,1
"11810","2017-11-08",1,6,2,8,8,"Yes",1,1,3,3
"11811","2017-11-08",1,5,3,8,8,"Yes",1,2,4,1
"11812","2017-11-08",1,2,4,6,6,"Yes",2,2,1,1
"11813","2017-11-08",3,6,8,14,14,"No",3,5,4,2
"11814","2017-11-08",6,13,6,19,17,"Yes",3,3,9,4
"11815","2017-11-08",1,5,5,10,10,"Yes",3,2,1,4
"11816","2017-11-08",1,3,4,7,8,"Yes",4,0,2,1
"11817","2017-11-08",1,4,4,8,8,"No",3,1,2,2
"11818","2017-11-08",2,9,5,14,14,"No",3,2,4,5
"11819","2017-11-08",1,3,2,5,5,"Yes",NA,2,1,2
"11820","2017-11-08",4,8,7,15,15,"Yes",2,5,4,4
"11821","2017-11-08",1,3,5,8,8,"Yes",3,2,1,2
"11822","2017-11-08",1,5,2,7,7,"No",1,1,3,2
"11823","2017-11-08",1,2,3,5,5,"No",1,2,1,1
"11824","2017-11-08",5,10,7,17,16,"No",3,4,5,5
"11825","2017-11-08",2,3,5,8,8,"Yes",2,3,1,2
"11826","2017-11-08",1,3,2,5,6,"Yes",1,1,1,2
"11827","2017-11-08",1,5,3,8,8,"Yes",1,2,2,3
"11828","2017-11-08",1,2,3,5,5,"Yes",2,1,1,1
"11829","2017-11-08",2,5,4,9,9,"Yes",2,2,3,2
"11830","2017-11-08",1,2,5,7,7,"Yes",1,4,1,1
"11831","2017-11-08",3,5,1,6,6,"Yes",0,1,3,2
"11832","2017-11-08",1,3,3,6,7,"Yes",2,1,1,2
"11833","2017-11-08",3,5,8,13,14,"Yes",4,4,2,3
"11834","2017-11-07",1,3,3,6,6,"Yes",1,2,1,2
"11835","2017-11-08",4,9,7,16,18,"Yes",3,4,4,5
"11836","2017-11-08",3,6,5,11,12,"Yes",3,2,3,3
"11837","2017-11-08",3,5,7,12,12,"No",4,3,3,2
"11838","2017-11-08",1,4,3,7,8,"Yes",1,2,1,3
"11839","2017-11-08",1,2,4,6,6,"Yes",2,2,1,1
"11840","2017-11-08",2,7,7,14,15,"No",2,5,3,4
"11841","2017-11-08",1,2,4,6,6,"Yes",1,3,1,1
"11842","2017-11-08",4,10,6,16,16,"Yes",3,3,4,6
"11843","2017-11-08",1,2,3,5,6,"Yes",2,1,1,1
"11844","2017-11-08",2,5,1,6,6,"Yes",0,1,2,3
"11845","2017-11-08",1,2,2,4,4,"Yes",1,1,1,1
"11846","2017-11-08",1,2,3,5,5,"Yes",2,1,1,1
"11847","2017-11-08",2,5,8,13,11,"Yes",5,3,2,3
"11848","2017-11-08",1,2,2,4,4,"No",1,1,1,1
"11849","2017-11-08",4,11,4,15,15,"Yes",1,3,4,7
"11850","2017-11-08",2,5,5,10,10,"Yes",2,3,2,3
"11851","2017-11-08",1,3,6,9,9,"No",4,2,1,2
"11852","2017-11-08",3,6,7,13,14,"Yes",3,4,3,3
"11853","2017-11-08",1,4,3,7,6,"Yes",2,1,1,3
"11854","2017-11-08",2,5,4,9,10,"Yes",2,2,2,3
"11855","2017-11-08",2,6,6,12,14,"Yes",2,4,3,3
"11856","2017-11-08",2,4,3,7,7,"Yes",2,1,2,2
"11857","2017-11-08",1,2,3,5,6,"Yes",2,1,1,1
"11858","2017-11-08",3,7,8,15,16,"No",3,5,3,4
"11859","2017-11-08",2,5,4,9,12,"Yes",1,3,2,3
"11860","2017-11-08",2,4,5,9,9,"No",2,3,2,2
"11861","2017-11-08",3,6,6,12,14,"No",3,3,3,3
"11862","2017-11-08",2,3,0,3,3,"Yes",0,0,2,1
"11863","2017-11-08",1,3,2,5,6,"No",2,0,1,2
"11864","2017-11-08",1,4,9,13,5,"No",4,5,2,2
"11865","2017-11-08",1,2,5,7,8,"Yes",2,3,1,1
"11866","2017-11-08",1,2,0,2,2,"Yes",0,0,1,1
"11867","2017-11-08",1,6,7,13,8,"Yes",3,4,3,3
"11868","2017-11-08",2,7,3,10,9,"Yes",0,3,4,3
"11869","2017-11-08",2,4,5,9,7,"No",2,3,2,2
"11870","2017-11-08",1,2,3,5,6,"Yes",2,1,1,1
"11871","2017-11-08",4,7,6,13,14,"No",4,2,3,4
"11872","2017-11-08",1,3,4,7,8,"Yes",0,4,1,2
"11873","2017-11-08",1,2,6,8,8,"Yes",3,3,1,1
"11874","2017-11-09",1,2,4,6,9,"Yes",2,2,1,1
"11875","2017-11-09",1,6,0,6,6,"Yes",0,0,4,2
"11876","2017-11-09",1,2,2,4,4,"Yes",1,1,1,1
"11877","2017-11-09",2,3,0,3,3,"Yes",0,0,2,1
"11878","2017-11-09",4,9,6,15,15,"Yes",4,2,4,5
"11879","2017-11-09",2,4,5,9,9,"Yes",4,1,2,2
"11880","2017-11-09",2,5,3,8,8,"Yes",0,3,2,3
"11881","2017-11-09",1,2,5,7,7,"Yes",2,3,1,1
"11882","2017-11-09",1,3,4,7,7,"Yes",1,3,1,2
"11883","2017-11-09",2,5,2,7,7,"No",2,0,2,3
"11884","2017-11-09",1,4,2,6,6,"Yes",0,2,2,2
"11885","2017-11-09",3,4,5,9,9,"Yes",2,3,2,2
"11886","2017-11-09",4,8,6,14,14,"No",3,3,4,4
"11887","2017-11-09",3,7,6,13,13,"Yes",3,3,3,4
"11888","2017-11-09",2,4,3,7,7,"No",1,2,2,2
"11889","2017-11-09",2,3,5,8,8,"Yes",2,3,1,2
"11890","2017-11-09",1,7,5,12,12,"Yes",3,2,2,5
"11891","2017-11-09",NA,3,16,19,NA,"Yes",6,10,2,1
"11892","2017-11-09",4,7,5,12,14,"Yes",3,2,4,3
"11893","2017-11-09",2,4,2,6,6,"Yes",1,1,3,1
"11894","2017-11-09",1,1,2,3,3,"Yes",1,1,0,1
"11895","2017-11-09",1,2,2,4,4,"Yes",NA,2,1,1
"11896","2017-11-09",2,7,2,9,9,"No",1,1,3,4
"11897","2017-11-09",4,6,4,10,10,"Yes",2,2,3,3
"11898","2017-11-09",1,2,1,3,3,"Yes",0,1,1,1
"11899","2017-11-09",1,3,2,5,5,"Yes",1,1,2,1
"11900","2017-11-09",1,2,6,8,8,"Yes",3,3,1,1
"11901","2017-11-09",1,2,4,6,6,"Yes",2,2,1,1
"11902","2017-11-09",2,9,4,13,13,"Yes",2,2,4,5
"11903","2017-11-09",1,2,4,6,7,"Yes",2,2,1,1
"11904","2017-11-09",1,4,2,6,6,"Yes",1,1,1,3
"11905","2017-11-09",3,9,1,10,10,"Yes",NA,1,5,4
"11906","2017-11-09",2,7,5,12,12,"No",3,2,3,4
"11907","2017-11-09",1,2,1,3,3,"Yes",NA,1,1,1
"11908","2017-11-09",1,2,2,4,4,NA,NA,2,1,1
"11909","2017-11-09",1,5,3,8,8,"Yes",2,1,3,2
"11910","2017-11-09",1,4,2,6,6,"Yes",1,1,3,1
"11911","2017-11-09",1,3,4,7,7,"No",3,1,1,2
"11912","2017-11-09",4,7,2,9,9,"Yes",2,0,4,3
"11913","2017-11-09",2,5,5,10,10,"Yes",3,2,2,3
"11914","2017-11-09",1,6,3,9,9,"Yes",1,2,2,4
"11915","2017-11-09",3,4,5,9,9,"Yes",2,3,2,2
"11916","2017-11-09",1,2,3,5,5,"Yes",1,2,1,1
"11917","2017-11-09",NA,2,4,6,NA,"Yes",1,3,1,1
"11918","2017-11-09",4,4,5,9,9,"Yes",3,2,3,1
"11919","2017-11-09",3,6,3,9,9,"Yes",1,2,3,3
"11920","2017-11-09",2,8,5,13,13,"No",2,3,4,4
"11921","2017-11-09",1,2,0,2,2,"Yes",0,0,1,1
"11922","2017-11-09",1,2,4,6,6,"Yes",2,2,1,1
"11923","2017-11-09",3,6,6,12,12,"No",4,2,3,3
"11924","2017-11-09",1,2,8,10,10,"Yes",4,4,1,1
"11925","2017-11-09",2,5,1,6,5,"Yes",0,1,2,3
"11926","2017-11-09",3,6,3,9,9,"Yes",2,1,3,3
"11927","2017-11-09",1,6,3,9,9,"No",1,2,3,3
"11928","2017-11-09",1,2,6,8,8,"Yes",2,4,1,1
"11929","2017-11-09",1,2,4,6,6,"Yes",2,2,1,1
"11930","2017-11-09",1,5,4,9,9,"Yes",2,2,3,2
"11931","2017-11-09",1,3,3,6,6,"Yes",1,2,2,1
"11932","2017-11-09",1,2,4,6,6,"Yes",2,2,1,1
"11933","2017-11-09",1,3,6,9,8,"Yes",1,5,1,2
"11934","2017-11-09",1,5,3,8,8,"Yes",2,1,2,3
"11935","2017-11-09",1,2,3,5,5,"Yes",1,2,1,1
"11936","2017-11-09",1,2,4,6,6,"Yes",2,2,1,1
"11937","2017-11-09",1,2,5,7,7,"Yes",2,3,1,1
"11938","2017-11-09",1,3,5,8,7,"Yes",2,3,1,2
"11939","2017-11-09",1,2,5,7,7,"Yes",2,3,1,1
"11940","2017-11-09",4,9,7,16,16,"Yes",5,2,4,5
"11941","2017-11-09",1,2,4,6,6,"Yes",1,3,1,1
"11942","2017-11-09",1,5,4,9,9,"Yes",1,3,2,3
"11943","2017-11-09",1,3,8,11,11,"Yes",2,6,1,2
"11944","2017-11-09",1,2,2,4,4,"Yes",1,1,1,1
"11945","2017-11-09",1,5,4,9,9,"Yes",1,3,2,3
"11946","2017-11-09",1,2,4,6,5,"Yes",1,3,1,1
"11947","2017-11-09",1,3,2,5,5,"Yes",0,2,2,1
"11948","2017-11-09",NA,4,48,52,NA,"No",27,21,1,3
"11949","2017-11-09",1,2,3,5,5,"Yes",3,0,1,1
"11950","2017-11-09",3,7,5,12,12,NA,2,3,4,3
"11951",NA,1,2,2,4,4,"No",2,0,1,1
"11952","2017-11-09",2,4,6,10,10,"No",3,3,2,2
"11953","2017-11-09",2,8,4,12,12,"Yes",2,2,5,3
"11954","2017-11-09",1,2,5,7,7,"Yes",4,1,1,1
"11955","2017-11-09",1,5,2,7,7,"Yes",1,1,2,3
"11956","2017-11-09",2,4,6,10,10,"Yes",4,2,2,2
"11957","2017-11-09",4,10,5,15,15,"No",2,3,6,4
"11958","2017-11-09",2,5,4,9,9,"No",2,2,2,3
"11959","2017-11-09",1,2,5,7,7,"Yes",1,4,1,1
"11960","2017-11-09",1,2,3,5,5,"Yes",1,2,1,1
"11961","2017-11-09",1,6,3,9,9,"No",2,1,3,3
"11962","2017-11-09",1,2,2,4,4,"No",2,0,1,1
"11963","2017-11-09",9745502503,2,6,8,8,"No",3,3,1,1
"11964","2017-11-09",1,5,3,8,8,"No",2,1,3,2
"11965","2017-11-09",1,3,3,6,6,"Yes",0,3,1,2
"11966","2017-11-09",2,8,3,11,11,"Yes",1,2,3,5
"11967","2017-11-09",1,2,3,5,5,"Yes",1,2,1,1
"11968","2017-11-09",2,4,0,4,4,"Yes",0,0,2,2
"11969","2017-11-09",1,3,3,6,6,"Yes",3,0,1,2
"11970","2017-11-09",1,4,5,9,9,"Yes",2,3,2,2
"11971","2017-11-09",1,3,4,7,7,"Yes",3,1,1,2
"11972","2017-11-09",NA,6,75,81,NA,"No",30,45,3,3
"11973","2017-11-09",1,2,1,3,3,"Yes",1,NA,1,1
"11974","2017-11-09",1,3,1,4,4,"Yes",0,1,1,2
"11975","2017-11-09",1,4,0,4,4,"Yes",0,0,3,1
"11976","2017-11-09",1,6,5,11,10,"Yes",2,3,2,4
"11977","2017-11-09",1,2,0,2,2,"Yes",NA,NA,1,1
"11978","2017-11-09",1,5,1,6,6,"No",0,1,3,2
"11979","2017-11-09",1,6,5,11,11,"No",4,1,3,3
"11980","2017-11-09",1,2,3,5,5,"Yes",1,2,1,1
"11981","2017-11-09",1,3,3,6,6,"Yes",1,2,2,1
"11982","2017-11-09",1,5,4,9,9,"Yes",2,2,2,3
"11983","2017-11-09",1,4,1,5,5,"Yes",1,0,1,3
"11984","2017-11-09",2,2,4,6,6,"No",1,3,1,1
"11985","2017-11-09",5,12,5,17,17,"No",3,2,5,7
"11986","2017-11-09",1,2,11,13,13,"Yes",5,6,1,1
"11987","2017-11-09",1,4,3,7,7,"Yes",3,0,2,2
"11988","2017-11-09",2,4,5,9,8,"Yes",1,4,2,2
"11989","2017-11-09",1,2,6,8,8,"Yes",2,4,1,1
"11990","2017-11-09",2,8,4,12,12,"Yes",2,2,5,3
"11991","2017-11-08",1,4,2,6,6,"Yes",1,1,1,3
"11992","2017-11-09",3,3,0,3,3,"Yes",0,0,0,3
"11993","2017-11-09",1,4,4,8,8,"Yes",3,1,2,2
"11994","2017-11-09",1,5,3,8,8,"No",2,1,2,3
"11995","2017-11-09",1,6,3,9,9,"No",2,1,3,3
"11996","2017-11-09",2,4,4,8,8,"No",3,1,2,2
"11997","2017-11-09",1,4,2,6,6,"Yes",1,1,2,2
"11998","2017-11-09",1,5,3,8,9,"No",1,2,2,3
"11999","2017-11-09",2,5,7,12,11,"No",3,4,3,2
"12000","2017-11-09",3,2,2,4,8,"Yes",1,1,1,1
"12001","2017-11-09",2,4,4,8,9,"Yes",1,3,2,2
"12002","2017-11-09",3,6,9,15,15,"No",4,5,3,3
"12003","2017-11-09",2,6,6,12,12,"No",3,3,2,4
"12004","2017-11-09",1,4,2,6,6,"No",1,1,2,2
"12005","2017-11-09",1,2,2,4,4,"Yes",2,0,1,1
"12006","2017-11-09",3,6,12,18,18,"Yes",5,7,3,3
"12007","2017-11-09",1,3,2,5,5,"Yes",1,1,1,2
"12008","2017-11-09",1,8,5,13,13,"Yes",1,4,3,5
"12009","2017-11-09",1,2,3,5,5,"No",2,1,1,1
"12010","2017-11-09",3,5,5,10,10,"No",2,3,3,2
"12011","2017-11-09",1,2,3,5,5,"Yes",3,0,1,1
"12012","2017-11-09",1,3,2,5,5,"Yes",1,1,2,1
"12013","2017-11-09",3,6,5,11,11,"No",3,2,3,3
"12014","2017-11-09",2,10,4,14,14,"Yes",1,3,4,6
"12015","2017-11-09",1,4,6,10,10,"No",2,4,2,2
"12016","2017-11-09",1,2,2,4,4,"Yes",1,1,1,1
"12017","2017-11-09",1,3,2,5,5,"Yes",0,2,1,2
"12018","2017-11-09",1,4,3,7,7,"Yes",1,2,2,2
"12019","2017-11-09",2,4,6,10,10,"Yes",2,4,2,2
"12020","2017-11-09",2,5,5,10,10,"No",3,2,2,3
"12021","2017-11-09",2,10,5,15,15,"No",2,3,4,6
"12022","2017-11-09",4,9,4,13,13,"Yes",3,1,4,5
"12023","2017-11-09",4,9,5,14,14,"Yes",3,2,4,5
"12024","2017-11-09",2,7,4,11,11,"No",1,3,2,5
"12025","2017-11-09",1,2,6,8,9,"Yes",2,4,1,1
"12026","2017-11-09",1,12,6,18,18,"Yes",5,1,7,5
"12027","2017-11-09",1,5,4,9,9,"Yes",2,2,2,3
"12028","2017-11-09",2,5,3,8,8,"Yes",1,2,2,3
"12029","2017-11-09",2,4,3,7,7,"Yes",1,2,2,2
"12030","2017-11-09",1,2,4,6,6,"Yes",2,2,1,1
"12031","2017-11-09",1,3,2,5,5,"Yes",2,0,2,1
"12032","2017-11-09",1,2,6,8,8,"Yes",2,4,1,1
"12033","2017-11-09",2,3,0,3,3,"No",NA,NA,2,1
"12034","2017-11-09",1,3,2,5,5,"Yes",1,1,1,2
"12035","2017-11-09",1,3,4,7,7,"Yes",1,3,2,1
"12036","2017-11-09",1,3,1,4,4,"No",0,1,1,2
"12037","2017-11-09",NA,306,55,361,NA,"Yes",30,25,106,200
"12038","2017-11-09",2,4,2,6,6,"Yes",1,1,2,2
"12039","2017-11-09",2,3,3,6,6,"Yes",2,1,1,2
"12040","2017-11-09",1,5,2,7,7,"No",1,1,3,2
"12041","2017-11-09",1,4,3,7,7,"Yes",1,2,2,2
"12042","2017-11-09",2,4,7,11,11,"No",3,4,3,1
"12043","2017-11-09",3,6,4,10,10,"No",1,3,3,3
"12044","2017-11-09",2,6,4,10,10,"Yes",2,2,3,3
"12045","2017-11-09",5,11,8,19,19,"No",4,4,5,6
"12046","2017-11-09",5,11,10,21,21,"Yes",5,5,4,7
"12047","2017-11-09",5,2,5,7,7,"Yes",2,3,1,1
"12048","2017-11-09",4,6,0,6,6,"No",0,0,3,3
"12049","2017-11-09",2,5,5,10,10,"No",2,3,2,3
"12050","2017-11-09",1,5,3,8,8,"No",2,1,3,2
"12051","2017-11-09",1,8,5,13,13,"Yes",3,2,5,3
"12052","2017-11-09",2,5,3,8,8,"Yes",1,2,3,2
"12053","2017-11-09",2,10,4,14,14,"No",2,2,5,5
"12054","2017-11-09",NA,35,0,35,NA,"Yes",NA,NA,20,15
"12055","2017-11-09",1,2,1,3,3,"Yes",0,1,1,1
"12056","2017-11-09",3,6,5,11,12,"No",3,2,3,3
"12057","2017-11-09",5,10,7,17,17,"No",3,4,7,3
"12058","2017-11-09",2,4,4,8,8,"Yes",2,2,2,2
"12059","2017-11-09",3,8,7,15,15,"Yes",4,3,3,5
"12060","2017-11-09",1,3,7,10,10,"Yes",3,4,1,2
"12061","2017-11-09",3,10,7,17,17,"No",4,3,3,7
"12062","2017-11-09",4,7,2,9,10,"No",1,1,5,2
"12063","2017-11-09",2,4,2,6,6,"Yes",1,1,2,2
"12064","2017-11-09",4,11,6,17,17,"Yes",1,5,4,7
"12065","2017-11-09",2,4,5,9,9,"Yes",3,2,2,2
"12066","2017-11-09",1,4,0,4,4,"Yes",0,0,4,0
"12067","2017-11-09",1,2,5,7,7,"Yes",2,3,1,1
"12068","2017-11-09",1,3,2,5,6,"Yes",1,1,1,2
"12069","2017-11-09",2,8,9,17,11,"Yes",5,4,5,3
"12070","2017-11-09",1,2,4,6,6,"Yes",2,2,1,1
"12071","2017-11-09",1,2,1,3,3,"Yes",0,1,1,1
"12072","2017-11-09",1,5,5,10,10,"Yes",2,3,1,4
"12073","2017-11-09",4,8,3,11,11,"No",2,1,4,4
"12074","2017-11-09",1,2,7,9,8,"Yes",5,2,1,1
"12075","2017-11-09",2,4,1,5,5,"Yes",0,1,2,2
"12076","2017-11-09",1,2,2,4,4,"Yes",1,1,1,1
"12077","2017-11-09",1,3,4,7,7,"Yes",3,1,1,2
"12078","2017-11-09",1,3,3,6,6,"Yes",2,1,1,2
"12079","2017-11-09",1,2,4,6,7,"Yes",1,3,1,1
"12080","2017-11-09",4,9,5,14,16,"Yes",2,3,4,5
"12081","2017-11-09",1,2,3,5,5,"No",2,1,1,1
"12082","2017-11-09",1,3,4,7,7,"Yes",2,2,1,2
"12083","2017-11-09",1,3,2,5,7,"Yes",1,1,1,2
"12084","2017-11-09",1,3,1,4,4,"Yes",0,1,1,2
"12085","2017-11-09",1,3,3,6,6,"Yes",1,2,1,2
"12086","2017-11-09",2,6,3,9,10,"Yes",1,2,2,4
"12087","2017-11-09",5,14,15,29,30,"Yes",8,7,5,9
"12088","2017-11-10",2,5,3,8,11,"No",2,1,3,2
"12089","2017-11-10",NA,18,3,21,NA,"Yes",1,2,5,13
"12090","2017-11-10",NA,2,0,2,NA,"No",NA,NA,1,1
"12091","2017-11-10",2,6,6,12,12,"Yes",3,3,3,3
"12092","2017-11-10",1,2,5,7,7,"No",3,2,1,1
"12093","2017-11-10",2,5,3,8,8,"No",2,1,2,3
"12094","2017-11-10",1,5,2,7,7,"Yes",1,1,3,2
"12095","2017-11-10",3,9,3,12,12,"Yes",2,1,2,7
"12096","2017-11-10",1,6,3,9,9,"No",2,1,3,3
"12097","2017-11-10",3,10,5,15,15,"Yes",2,3,5,5
"12098","2017-11-10",2,5,5,10,10,"No",3,2,2,3
"12099","2017-11-10",2,5,6,11,11,"No",1,5,3,2
"12100","2017-11-10",2,7,6,13,15,"Yes",2,4,3,4
"12101","2017-11-10",2,9,4,13,13,"No",2,2,5,4
"12102","2017-11-10",1,2,3,5,5,"Yes",2,1,1,1
"12103","2017-11-10",2,7,5,12,12,"No",3,2,3,4
"12104","2017-11-10",4,8,8,16,16,"Yes",3,5,4,4
"12105","2017-11-10",1,2,2,4,4,"Yes",1,1,1,1
"12106","2017-11-10",2,6,6,12,12,"No",3,3,4,2
"12107","2017-11-10",4,5,7,12,12,"No",5,2,2,3
"12108","2017-11-10",1,6,4,10,10,"No",3,1,2,4
"12109","2017-11-10",5,8,12,20,20,"Yes",5,7,4,4
"12110","2017-11-10",3,7,5,12,12,"Yes",3,2,4,3
"12111","2017-11-10",2,4,2,6,6,"Yes",1,1,2,2
"12112","2017-11-10",1,3,3,6,6,"Yes",1,2,1,2
"12113","2017-11-10",4,7,5,12,12,"No",2,3,5,2
"12114","2017-11-10",2,7,6,13,13,"No",3,3,3,4
"12115","2017-11-10",2,9,4,13,13,"No",2,2,4,5
"12116","2017-11-10",4,7,11,18,18,"Yes",4,7,4,3
"12117","2017-11-10",1,2,2,4,4,"No",1,1,0,2
"12118","2017-11-10",4,5,5,10,10,"Yes",3,2,2,3
"12119","2017-11-10",3,5,10,15,15,"Yes",4,6,2,3
"12120","2017-11-10",1,3,0,3,3,"Yes",0,0,2,1
"12121","2017-11-10",2,8,6,14,14,"No",4,2,5,3
"12122","2017-11-10",4,6,10,16,16,"No",5,5,4,2
"12123","2017-11-10",2,6,6,12,12,"Yes",3,3,2,4
"12124","2017-11-10",2,4,8,12,12,"Yes",3,5,2,2
"12125","2017-11-10",2,6,1,7,7,"Yes",0,1,4,2
"12126","2017-11-10",2,9,4,13,13,"No",2,2,4,5
"12127","2017-11-10",1,4,3,7,7,"Yes",1,2,3,1
"12128","2017-11-10",1,5,6,11,11,"Yes",4,2,2,3
"12129","2017-11-10",1,1,0,1,1,"No",NA,NA,1,NA
"12130","2017-11-10",3,7,7,14,14,"Yes",3,4,3,4
"12131","2017-11-10",2,7,8,15,15,"No",3,5,2,5
"12132","2017-11-10",1,2,1,3,3,"Yes",NA,1,1,1
"12133","2017-11-10",1,5,3,8,8,"No",2,1,3,2
"12134","2017-11-10",1,5,4,9,9,"No",3,1,1,4
"12135","2017-11-10",2,7,2,9,9,"Yes",1,1,3,4
"12136","2017-11-10",2,0,0,0,7,"No",NA,NA,NA,NA
"12137","2017-11-10",1,2,1,3,3,"No",1,0,1,1
"12138","2017-11-10",2,8,5,13,13,"Yes",3,2,5,3
"12139","2017-11-10",1,2,3,5,5,"Yes",1,2,1,1
"12140","2017-11-10",1,3,5,8,8,"No",2,3,1,2
"12141","2017-11-10",4,8,12,20,20,"No",5,7,4,4
"12142","2017-11-10",1,2,4,6,6,"No",1,3,1,1
"12143","2017-11-10",1,2,3,5,5,"Yes",1,2,1,1
"12144","2017-11-10",1,2,2,4,4,"Yes",1,1,1,1
"12145","2017-11-10",2,3,7,10,10,"Yes",3,4,1,2
"12146","2017-11-10",1,5,2,7,7,"No",1,1,2,3
"12147","2017-11-10",4,6,4,10,10,"Yes",1,3,3,3
"12148","2017-11-10",5,19,9,28,27,"No",5,4,9,10
"12149","2017-11-10",4,9,7,16,16,"Yes",3,4,4,5
"12150","2017-11-10",2,4,4,8,8,"No",1,3,2,2
"12151","2017-11-10",1,2,3,5,5,"Yes",2,1,1,1
"12152","2017-11-10",2,6,2,8,8,"No",1,1,3,3
"12153","2017-11-10",1,4,2,6,6,"Yes",1,1,1,3
"12154","2017-11-10",1,8,6,14,8,"No",4,2,3,5
"12155","2017-11-10",2,4,7,11,11,"Yes",3,4,2,2
"12156","2017-11-10",1,5,3,8,8,"Yes",1,2,2,3
"12157","2017-11-10",1,2,1,3,3,"Yes",1,NA,NA,2
"12158","2017-11-10",1,5,2,7,7,"No",1,1,3,2
"12159","2017-11-10",3,11,2,13,15,"No",1,1,4,7
"12160","2017-11-10",1,4,5,9,9,"Yes",2,3,1,3
"12161","2017-11-10",1,5,4,9,9,"Yes",2,2,3,2
"12162","2017-11-10",4,8,12,20,20,"Yes",7,5,4,4
"12163","2017-11-10",2,6,5,11,11,"Yes",1,4,3,3
"12164","2017-11-10",2,7,8,15,15,"Yes",5,3,4,3
"12165","2017-11-10",3,6,1,7,7,"Yes",0,1,3,3
"12166","2017-11-10",1,5,3,8,8,"No",2,1,3,2
"12167","2017-11-10",2,2,4,6,6,"No",1,3,1,1
"12168","2017-11-10",1,2,2,4,4,"No",1,1,1,1
"12169","2017-11-10",2,9,5,14,14,"Yes",3,2,4,5
"12170","2017-11-10",3,1,4,5,8,NA,1,3,1,0
"12171","2017-11-10",2,4,2,6,6,"No",2,NA,2,2
"12172","2017-11-10",1,5,2,7,7,"Yes",0,2,2,3
"12173","2017-11-10",1,2,4,6,6,"Yes",2,2,1,1
"12174","2017-11-10",4,5,10,15,15,"Yes",5,5,2,3
"12175","2017-11-10",2,2,4,6,6,"Yes",3,1,1,1
"12176","2017-11-10",3,8,7,15,15,"Yes",2,5,5,3
"12177","2017-11-10",1,2,3,5,5,"Yes",1,2,1,1
"12178","2017-11-10",1,3,4,7,7,NA,2,2,2,1
"12179","2017-11-10",3,5,6,11,11,"No",3,3,3,2
"12180","2017-11-10",1,2,4,6,6,"Yes",1,3,1,1
"12181","2017-11-10",2,8,5,13,13,"Yes",2,3,5,3
"12182","2017-11-10",2,4,9,13,13,"Yes",4,5,2,2
"12183","2017-11-03",3,11,6,17,17,"Yes",4,2,8,3
"12184","2017-11-10",2,4,6,10,10,"Yes",2,4,2,2
"12185","2017-11-10",1,2,3,5,5,"Yes",2,1,1,1
"12186","2017-11-10",4,12,2,14,14,"Yes",1,1,6,6
"12187","2017-11-10",1,3,6,9,9,"Yes",3,3,1,2
"12188","2017-11-10",3,12,3,15,15,"Yes",1,2,7,5
"12189","2017-11-10",1,3,2,5,5,"Yes",1,1,1,2
"12190","2017-11-10",1,5,3,8,8,"Yes",1,2,3,2
"12191","2017-11-10",1,2,4,6,6,"Yes",2,2,1,1
"12192","2017-11-10",1,2,5,7,7,"Yes",1,4,1,1
"12193","2017-11-10",3,6,4,10,18,"No",4,NA,3,3
"12194","2017-11-10",1,5,5,10,10,"No",3,2,2,3
"12195","2017-11-10",1,3,2,5,5,"Yes",0,2,2,1
"12196","2017-11-10",1,3,3,6,5,"Yes",2,1,1,2
"12197","2017-11-10",2,2,5,7,7,"Yes",2,3,1,1
"12198","2017-11-10",1,6,3,9,9,"Yes",3,0,3,3
"12199","2017-11-10",2,9,5,14,14,"No",3,2,5,4
"12200","2017-11-10",1,2,5,7,7,"Yes",3,2,1,1
"12201","2017-11-10",2,3,2,5,5,"Yes",1,1,1,2
"12202","2017-11-10",3,6,2,8,8,"Yes",0,2,3,3
"12203","2017-11-10",2,4,3,7,8,"Yes",2,1,2,2
"12204","2017-11-10",2,8,5,13,13,"No",2,3,3,5
"12205","2017-11-10",2,4,4,8,8,"Yes",1,3,2,2
"12206","2017-11-10",1,2,3,5,5,"Yes",1,2,1,1
"12207","2017-11-10",1,5,3,8,8,"Yes",2,1,2,3
"12208","2017-11-10",2,4,9,13,13,"Yes",3,6,2,2
"12209","2017-11-10",3,6,4,10,10,"Yes",3,1,3,3
"12210","2017-11-10",1,5,2,7,7,"No",1,1,3,2
"12211","2017-11-10",4,8,4,12,12,"Yes",2,2,4,4
"12212","2017-11-10",1,3,2,5,5,"Yes",1,1,1,2
"12213","2017-11-10",1,3,4,7,7,"Yes",3,1,1,2
"12214","2017-11-10",1,3,3,6,6,"Yes",2,1,1,2
"12215","2017-11-10",1,2,5,7,7,"Yes",3,2,1,1
"12216","2017-11-10",1,2,1,3,3,"Yes",NA,1,1,1
"12217","2017-11-10",1,4,4,8,8,"No",2,2,1,3
"12218","2017-11-10",2,2,2,4,4,"Yes",1,1,1,1
"12219","2017-11-10",3,6,6,12,12,"No",3,3,3,3
"12220","2017-11-10",2,7,4,11,11,"Yes",2,2,3,4
"12221","2017-11-10",4,8,9,17,17,"Yes",5,4,4,4
"12222","2017-11-10",1,2,3,5,5,"No",1,2,1,1
"12223","2017-11-10",5,10,5,15,15,"No",2,3,5,5
"12224","2017-11-10",2,4,2,6,6,"Yes",1,1,2,2
"12225","2017-11-10",1,1,4,5,5,"Yes",1,3,0,1
"12226","2017-11-10",1,4,2,6,6,"Yes",0,2,2,2
"12227","2017-11-10",4,0,7,7,11,"Yes",3,4,NA,NA
"12228","2017-11-10",2,6,6,12,12,"Yes",2,4,3,3
"12229","2017-11-10",2,10,5,15,15,"Yes",3,2,2,8
"12230","2017-11-10",1,3,4,7,7,"Yes",2,2,0,3
"12231","2017-11-10",2,8,6,14,14,"No",2,4,3,5
"12232","2017-11-17",1,4,4,8,8,"Yes",3,1,2,2
"12233","2017-11-10",1,5,2,7,11,"No",1,1,3,2
"12234","2017-11-10",2,5,7,12,11,"Yes",3,4,3,2
"12235","2017-11-10",1,9,5,14,14,"Yes",2,3,4,5
"12236","2017-11-10",1,2,3,5,5,"No",1,2,1,1
"12237","2017-11-10",1,5,3,8,8,"Yes",2,1,2,3
"12238","2017-11-10",2,4,6,10,10,"Yes",4,2,2,2
"12239","2017-11-11",1,5,2,7,7,"No",1,1,3,2
"12240","2017-11-10",1,5,2,7,7,"No",1,1,3,2
"12241","2017-11-10",1,3,2,5,6,"No",1,1,1,2
"12242","2017-11-10",1,5,6,11,11,"No",3,3,2,3
"12243","2017-11-09",3,0,0,0,18,NA,NA,NA,NA,NA
"12244","2017-11-10",1,4,4,8,8,"Yes",1,3,2,2
"12245","2017-11-10",1,2,3,5,5,"No",NA,3,1,1
"12246","2017-11-10",4,10,8,18,18,"No",3,5,5,5
"12247","2017-11-10",2,5,5,10,10,"Yes",3,2,2,3
"12248","2017-11-10",3,8,6,14,14,"Yes",3,3,3,5
"12249","2017-11-10",3,7,8,15,15,"Yes",4,4,4,3
"12250","2017-11-10",1,2,3,5,5,NA,1,2,1,1
"12251","2017-11-10",1,6,3,9,9,"No",2,1,3,3
"12252","2017-11-10",1,2,1,3,3,"Yes",1,NA,1,1
"12253","2017-11-10",1,5,3,8,8,"Yes",2,1,3,2
"12254","2017-11-10",1,2,4,6,6,"Yes",2,2,1,1
"12255","2017-11-10",3,4,4,8,8,"Yes",1,3,2,2
"12256","2017-11-10",1,2,3,5,5,"Yes",1,2,1,1
"12257","2017-11-10",3,4,4,8,8,"Yes",2,2,2,2
"12258","2017-11-10",2,10,5,15,15,"No",2,3,5,5
"12259","2017-11-10",3,8,8,16,16,"No",4,4,3,5
"12260","2017-11-10",2,7,8,15,15,"No",3,5,2,5
"12261","2017-11-10",1,2,2,4,4,"Yes",1,1,1,1
"12262","2017-11-10",1,2,4,6,6,"Yes",2,2,1,1
"12263","2017-11-10",1,4,4,8,8,"No",2,2,1,3
"12264","2017-11-10",1,0,3,3,3,"Yes",0,3,0,0
"12265",NA,5,14,8,22,22,"Yes",1,7,6,8
"12266","2017-11-10",1,6,3,9,9,"No",2,1,3,3
"12267","2017-11-10",5,13,10,23,23,"Yes",4,6,7,6
"12268","2017-11-11",2,7,8,15,15,"Yes",5,3,2,5
"12269","2017-11-11",1,3,3,6,6,"Yes",2,1,1,2
"12270","2017-11-11",1,4,4,8,8,"Yes",1,3,2,2
"12271","2017-11-11",2,5,3,8,8,"No",2,1,2,3
"12272","2017-11-11",3,6,6,12,12,"Yes",2,4,3,3
"12273","2017-11-11",3,10,10,20,20,"Yes",4,6,5,5
"12274","2017-11-11",4,7,5,12,12,"Yes",2,3,4,3
"12275","2017-11-11",4,8,7,15,15,"Yes",4,3,4,4
"12276","2017-11-11",1,2,2,4,4,"No",1,1,1,1
"12277","2017-11-11",3,7,5,12,1,"Yes",2,3,3,4
"12278","2017-11-11",4,7,12,19,16,"Yes",5,7,3,4
"12279","2017-11-11",3,7,1,8,8,"Yes",1,0,4,3
"12280","2017-11-11",1,7,2,9,9,"Yes",0,2,3,4
"12281","2017-11-11",1,6,2,8,8,"Yes",1,1,5,1
"12282","2017-11-11",1,2,5,7,5,"Yes",2,3,1,1
"12283","2017-11-11",2,8,3,11,11,"Yes",1,2,4,4
"12284","2017-11-11",2,5,4,9,9,"Yes",1,3,2,3
"12285","2017-11-11",3,6,5,11,11,"Yes",3,2,3,3
"12286","2017-11-11",4,11,8,19,19,"Yes",4,4,5,6
"12287","2017-11-11",1,2,4,6,6,"No",2,2,1,1
"12288","2017-11-11",2,6,2,8,7,"No",1,1,1,5
"12289","2017-11-11",1,2,3,5,5,"Yes",0,3,1,1
"12290","2017-11-11",2,5,4,9,9,"Yes",3,1,2,3
"12291","2017-11-11",1,7,1,8,8,NA,0,1,4,3
"12292","2017-11-11",1,4,1,5,5,"Yes",1,0,1,3
"12293","2017-11-11",1,2,6,8,8,"Yes",2,4,1,1
"12294","2017-11-11",2,4,6,10,10,"Yes",3,3,2,2
"12295","2017-11-11",2,13,3,16,16,"Yes",1,2,6,7
"12296","2017-11-11",1,2,3,5,5,"Yes",1,2,1,1
"12297","2017-11-11",1,2,3,5,5,"Yes",1,2,1,1
"12298","2017-11-11",1,2,5,7,7,"Yes",3,2,1,1
"12299","2017-11-11",1,5,4,9,9,"Yes",2,2,2,3
"12300","2017-11-11",NA,2,3,5,NA,"Yes",2,1,1,1
"12301","2017-11-11",2,4,4,8,8,"Yes",3,1,2,2
"12302","2017-11-11",3,11,9,20,20,"No",4,5,5,6
"12303","2017-11-11",1,2,5,7,7,"Yes",2,3,1,1
"12304","2017-11-11",1,2,1,3,3,"Yes",NA,1,1,1
"12305","2017-11-11",1,5,3,8,8,"Yes",1,2,2,3
"12306","2017-11-11",2,8,8,16,16,"No",4,4,3,5
"12307","2017-11-11",1,2,4,6,6,"Yes",2,2,1,1
"12308","2017-11-11",1,2,6,8,8,"No",4,2,1,1
"12309","2017-11-11",2,4,2,6,9,NA,1,1,2,2
"12310","2017-11-11",1,5,4,9,9,"Yes",3,1,3,2
"12311","2017-11-11",1,1,3,4,4,"Yes",1,2,NA,1
"12312","2017-11-11",3,11,7,18,18,"Yes",3,4,5,6
"12313","2017-11-11",3,6,7,13,13,"Yes",3,4,3,3
"12314","2017-11-11",3,8,4,12,12,"Yes",2,2,4,4
"12315","2017-11-11",4,8,4,12,12,"No",2,2,4,4
"12316","2017-11-11",1,2,5,7,8,"Yes",3,2,1,1
"12317","2017-11-10",1,2,3,5,6,"Yes",1,2,1,1
"12318","2017-11-11",2,5,4,9,9,"Yes",1,3,3,2
"12319","2017-11-11",3,6,7,13,13,"Yes",5,2,3,3
"12320","2017-11-11",7,18,8,26,27,"No",2,6,10,8
"12321","2017-11-11",1,12,7,19,5,"No",4,3,7,5
"12322","2017-11-11",1,3,0,3,3,"Yes",0,0,1,2
"12323","2017-11-11",7,13,5,18,20,"Yes",2,3,8,5
"12324","2017-11-11",3,12,5,17,17,"Yes",2,3,5,7
"12325","2017-11-11",3,6,8,14,14,"No",5,3,3,3
"12326","2017-11-11",1,2,2,4,4,"Yes",1,1,1,1
"12327","2017-11-11",3,8,3,11,13,"Yes",1,2,3,5
"12328","2017-11-11",2,6,5,11,13,"Yes",2,3,2,4
"12329","2017-11-11",1,3,2,5,5,"No",1,1,1,2
"12330","2017-11-11",4,14,9,23,25,"Yes",6,3,9,5
"12331","2017-11-11",3,6,6,12,12,"No",3,3,3,3
"12332","2017-11-11",1,4,4,8,8,"Yes",2,2,2,2
"12333","2017-11-11",2,8,5,13,14,"No",2,3,5,3
"12334","2017-11-11",2,12,5,17,17,"Yes",2,3,5,7
"12335","2017-11-11",1,2,3,5,5,"No",1,2,1,1
"12336","2017-11-11",2,6,5,11,12,"Yes",3,2,2,4
"12337","2017-11-11",3,6,3,9,9,"No",1,2,3,3
"12338","2017-11-11",5,12,6,18,18,"No",4,2,7,5
"12339","2017-11-11",1,2,3,5,5,"Yes",2,1,1,1
"12340","2017-11-10",5,9,4,13,13,"No",1,3,5,4
"12341","2017-11-11",1,3,5,8,8,"Yes",2,3,2,1
"12342","2017-11-11",2,4,2,6,6,"Yes",1,1,2,2
"12343","2017-11-11",2,5,1,6,6,"Yes",0,1,2,3
"12344","2017-11-11",2,7,5,12,14,"Yes",2,3,4,3
"12345","2017-11-11",3,6,2,8,8,"Yes",0,2,3,3
"12346","2017-11-11",2,4,2,6,7,"No",1,1,2,2
"12347","2017-11-11",4,8,5,13,13,"No",3,2,4,4
"12348","2017-11-11",1,10,5,15,7,"Yes",2,3,6,4
"12349","2017-11-11",2,5,5,10,10,"Yes",1,4,2,3
"12350","2017-11-11",1,2,3,5,5,"Yes",2,1,1,1
"12351","2017-11-10",1,3,7,10,12,"Yes",4,3,2,1
"12352","2017-11-11",2,4,1,5,5,"Yes",0,1,2,2
"12353","2017-11-10",2,4,4,8,10,"No",1,3,2,2
"12354","2017-11-10",4,10,7,17,18,"Yes",2,5,4,6
"12355","2017-11-10",3,8,5,13,14,"Yes",3,2,3,5
"12356","2017-11-10",1,2,4,6,6,"Yes",2,2,1,1
"12357","2017-11-10",2,5,6,11,11,"Yes",4,2,2,3
"12358","2017-11-10",2,6,7,13,14,"Yes",3,4,2,4
"12359","2017-11-10",1,3,3,6,7,"Yes",1,2,2,1
"12360","2017-11-10",1,5,3,8,8,"Yes",2,1,2,3
"12361","2017-11-10",3,6,6,12,12,"No",3,3,3,3
"12362","2017-11-10",3,7,4,11,11,"No",0,4,3,4
"12363","2017-11-10",2,4,3,7,7,"Yes",2,1,2,2
"12364","2017-11-10",4,7,3,10,10,"No",1,2,4,3
"12365","2017-11-10",2,7,5,12,14,"Yes",3,2,4,3
"12366","2017-11-10",3,8,4,12,13,"No",2,2,5,3
"12367","2017-11-10",1,3,4,7,7,"Yes",2,2,2,1
"12368","2017-11-10",4,11,9,20,24,"Yes",4,5,4,7
"12369","2017-11-10",1,3,3,6,7,"Yes",1,2,2,1
"12370","2017-11-10",1,5,4,9,10,"No",2,2,1,4
"12371","2017-11-10",1,3,5,8,8,"Yes",1,4,1,2
"12372","2017-11-10",2,4,7,11,11,"Yes",3,4,2,2
"12373","2017-11-10",2,4,5,9,10,"No",2,3,2,2
"12374","2017-11-10",2,4,1,5,5,"No",0,1,2,2
"12375","2017-11-10",1,2,4,6,6,"Yes",2,2,1,1
"12376","2017-11-10",1,3,2,5,5,"Yes",1,1,1,2
"12377","2017-11-10",1,2,1,3,3,"Yes",1,0,1,1
"12378","2017-11-10",1,2,4,6,6,"Yes",1,3,1,1
"12379","2017-11-10",1,3,6,9,10,"Yes",3,3,1,2
"12380","2017-11-10",7,14,5,19,19,"Yes",2,3,7,7
"12381","2017-11-13",1,2,6,8,8,"Yes",2,4,1,1
"12382","2017-11-13",1,2,2,4,4,"No",1,1,1,1
"12383","2017-11-13",4,8,12,20,20,"Yes",6,6,4,4
"12384","2017-11-13",3,6,4,10,10,"Yes",2,2,3,3
"12385","2017-11-13",1,1,0,1,1,"Yes",0,0,0,1
"12386","2017-11-13",1,2,0,2,2,"Yes",0,0,1,1
"12387","2017-11-13",4,7,5,12,12,"Yes",2,3,4,3
"12388","2017-11-13",1,4,7,11,11,"Yes",5,2,2,2
"12389","2017-11-13",2,4,2,6,6,"Yes",1,1,2,2
"12390","2017-11-13",2,5,1,6,6,"Yes",0,1,2,3
"12391","2017-11-13",1,4,2,6,6,"Yes",1,1,2,2
"12392","2017-11-13",3,10,7,17,17,"Yes",5,2,5,5
"12393","2017-11-13",1,3,2,5,5,"Yes",1,1,2,1
"12394","2017-11-13",1,2,3,5,5,"Yes",1,2,1,1
"12395","2017-11-13",1,5,5,10,10,"Yes",2,3,2,3
"12396","2017-11-13",1,2,6,8,8,"Yes",2,4,1,1
"12397","2017-11-13",1,2,2,4,4,"No",1,1,1,1
"12398","2017-11-13",4,8,2,10,9,"No",0,2,4,4
"12399","2017-11-13",2,4,6,10,10,"Yes",1,5,2,2
"12400","2017-11-13",2,6,3,9,9,"Yes",1,2,3,3
"12401","2017-11-13",1,2,3,5,5,"No",2,1,1,1
"12402","2017-11-13",1,5,3,8,8,"Yes",1,2,2,3
"12403","2017-11-13",4,10,10,20,20,"Yes",5,5,6,4
"12404","2017-11-13",1,2,5,7,7,"Yes",2,3,1,1
"12405","2017-11-13",3,7,5,12,12,"Yes",2,3,3,4
"12406","2017-11-13",2,6,6,12,12,"No",2,4,3,3
"12407","2017-11-13",1,2,2,4,4,NA,1,1,1,1
"12408","2017-11-13",4,8,5,13,13,"Yes",5,0,4,4
"12409","2017-11-13",1,3,0,3,3,"Yes",NA,NA,1,2
"12410","2017-11-13",1,4,3,7,7,"Yes",1,2,2,2
"12411","2017-11-13",5,10,2,12,12,"Yes",1,1,5,5
"12412","2017-11-13",4,8,12,20,20,"No",5,7,4,4
"12413","2017-11-13",3,9,5,14,14,"Yes",2,3,3,6
"12414","2017-11-13",2,3,4,7,7,"Yes",2,2,1,2
"12415","2017-11-13",5,9,8,17,17,"No",2,6,2,7
"12416","2017-11-13",4,8,1,9,9,"Yes",0,1,4,4
"12417","2017-11-13",2,5,6,11,11,"Yes",3,3,2,3
"12418","2017-11-13",1,2,5,7,7,"Yes",2,3,1,1
"12419","2017-11-13",3,5,6,11,11,"Yes",3,3,3,2
"12420","2017-11-13",1,3,4,7,7,"Yes",1,3,1,2
"12421","2017-11-13",4,8,1,9,13,"Yes",0,1,4,4
"12422","2017-11-13",2,8,5,13,13,"Yes",3,2,5,3
"12423","2017-11-13",1,2,0,2,2,"Yes",0,0,1,1
"12424","2017-11-13",NA,0,0,0,NA,"No",NA,NA,NA,NA
"12425","2017-11-13",3,6,7,13,13,"Yes",2,5,3,3
"12426","2017-11-13",2,3,2,5,5,"Yes",1,1,2,1
"12427","2017-11-13",2,4,6,10,10,"No",3,3,2,2
"12428","2017-11-13",2,4,5,9,9,"Yes",4,1,2,2
"12429","2017-11-13",3,6,5,11,11,"Yes",4,1,3,3
"12430","2017-11-13",3,5,10,15,15,"No",5,5,3,2
"12431","2017-11-13",1,2,4,6,6,"Yes",2,2,1,1
"12432","2017-11-13",5,7,11,18,18,"No",3,8,2,5
"12433","2017-11-13",4,7,8,15,16,"No",5,3,3,4
"12434","2017-11-13",3,6,6,12,12,"Yes",2,4,3,3
"12435","2017-11-13",2,2,3,5,5,"Yes",1,2,1,1
"12436","2017-11-13",7,5,5,10,10,"Yes",2,3,3,2
"12437","2017-11-13",1,2,3,5,5,"Yes",0,3,1,1
"12438","2017-11-13",2,4,4,8,8,"No",1,3,2,2
"12439","2017-11-13",2,4,6,10,10,"No",3,3,2,2
"12440","2017-11-13",1,1,3,4,4,"Yes",2,1,NA,1
"12441","2017-11-13",2,4,9,13,13,"No",4,5,2,2
"12442","2017-11-13",2,4,5,9,9,"Yes",2,3,3,1
"12443","2017-11-13",1,5,4,9,9,"Yes",1,3,2,3
"12444","2017-11-13",2,3,5,8,8,"Yes",0,5,1,2
"12445","2017-11-13",5,10,15,25,25,"Yes",5,10,5,5
"12446","2017-11-13",2,3,5,8,8,"No",2,3,1,2
"12447","2017-11-13",4,9,6,15,15,"No",3,3,4,5
"12448","2017-11-13",4,13,5,18,18,"Yes",2,3,5,8
"12449","2017-11-13",18,22,28,50,50,"No",11,17,10,12
"12450","2017-11-13",2,4,2,6,6,"No",2,NA,2,2
"12451","2017-11-13",3,4,4,8,8,"Yes",2,2,1,3
"12452","2017-11-13",2,5,3,8,8,"Yes",0,3,2,3
"12453","2017-11-13",4,8,13,21,21,"Yes",4,9,4,4
"12454","2017-11-13",NA,10,188,198,NA,"Yes",82,106,2,8
"12455","2017-11-13",4,4,8,12,12,"Yes",4,4,2,2
"12456","2017-11-13",5,8,6,14,14,"Yes",3,3,3,5
"12457","2017-11-13",7,8,7,15,15,"No",5,2,3,5
"12458","2017-11-13",1,3,3,6,5,"Yes",1,2,2,1
"12459","2017-11-13",NA,701,0,701,NA,"Yes",NA,NA,300,401
"12460","2017-11-13",4,10,9,19,20,"Yes",5,4,5,5
"12461","2017-11-13",2,4,5,9,9,"No",2,3,2,2
"12462","2017-11-13",NA,12,0,12,NA,"No",0,0,0,12
"12463","2017-11-13",3,3,5,8,8,"Yes",2,3,2,1
"12464","2017-11-20",3,13,12,25,25,"Yes",5,7,6,7
"12465","2017-11-13",1,1,5,6,8,"Yes",3,2,NA,1
"12466","2017-11-13",3,6,3,9,9,"Yes",2,1,3,3
"12467","2017-11-13",NA,27,164,191,NA,"No",64,100,17,10
"12468","2017-11-13",4,8,5,13,13,"Yes",3,2,4,4
"12469","2017-11-13",1,3,4,7,7,"No",0,4,2,1
"12470","2017-11-13",1,2,4,6,6,"No",1,3,1,1
"12471","2017-11-13",2,4,12,16,16,"Yes",8,4,2,2
"12472","2017-11-13",1,4,8,12,12,"Yes",3,5,2,2
"12473","2017-11-13",NA,4,175,179,NA,"Yes",60,115,1,3
"12474","2017-11-13",1,2,8,10,10,"Yes",5,3,1,1
"12475","2017-11-13",2,4,3,7,7,"Yes",2,1,2,2
"12476","2017-11-13",3,6,4,10,10,"Yes",2,2,2,4
"12477","2017-11-13",1,2,3,5,5,"Yes",1,2,1,1
"12478","2017-11-13",1,2,1,3,3,"No",1,0,1,1
"12479","2017-11-10",1,1,4,5,5,"No",1,3,NA,1
"12480","2017-11-13",1,2,3,5,5,"Yes",1,2,1,1
"12481","2017-11-13",6,12,10,22,22,"No",4,6,6,6
"12482","2017-11-13",2,4,4,8,8,"Yes",2,2,2,2
"12483","2017-11-13",4,12,8,20,20,"Yes",2,6,4,8
"12484","2017-11-13",2,3,2,5,6,"No",1,1,2,1
"12485","2017-11-13",1,2,7,9,9,"No",6,1,1,1
"12486","2017-11-13",NA,4,30,34,NA,"Yes",11,19,2,2
"12487","2017-11-13",3,9,6,15,15,"Yes",3,3,4,5
"12488","2017-11-13",1,2,5,7,7,"Yes",3,2,1,1
"12489","2017-11-13",2,3,3,6,6,"Yes",2,1,1,2
"12490","2017-11-13",2,4,5,9,9,"Yes",1,4,2,2
"12491","2017-11-13",5,9,7,16,16,"No",3,4,5,4
"12492","2017-11-13",NA,2,5,7,NA,"Yes",2,3,1,1
"12493","2017-11-13",2,4,2,6,6,"No",1,1,2,2
"12494","2017-11-13",1,2,3,5,5,"Yes",2,1,1,1
"12495","2017-11-13",NA,3,31,34,NA,"No",14,17,1,2
"12496","2017-11-13",2,3,3,6,6,"Yes",1,2,1,2
"12497","2017-11-13",1,2,5,7,7,"Yes",3,2,1,1
"12498","2017-11-13",1,2,3,5,5,"Yes",2,1,1,1
"12499","2017-11-13",1,2,6,8,8,"Yes",5,1,1,1
"12500","2017-11-13",3,9,12,21,19,"Yes",3,9,5,4
"12501","2017-11-13",1,2,3,5,5,"Yes",1,2,1,1
"12502","2017-11-13",9,22,15,37,NA,"No",7,8,12,10
"12503","2017-11-13",4,8,3,11,11,"Yes",1,2,5,3
"12504","2017-11-13",2,5,5,10,10,"No",2,3,1,4
"12505","2017-11-13",1,2,5,7,7,"Yes",2,3,1,1
"12506","2017-11-13",1,8,8,16,16,"Yes",6,2,2,6
"12507","2017-11-13",1,2,2,4,4,"Yes",0,2,1,1
"12508","2017-11-13",1,2,3,5,5,"Yes",1,2,1,1
"12509","2017-11-13",2,7,5,12,12,"Yes",2,3,3,4
"12510","2017-11-13",3,5,5,10,10,"Yes",2,3,3,2
"12511","2017-11-13",3,6,5,11,11,"No",1,4,3,3
"12512",NA,5,5,10,15,15,"No",5,5,2,3
"12513","2017-11-13",4,7,5,12,12,"No",2,3,4,3
"12514","2017-11-13",2,4,4,8,8,"No",2,2,2,2
"12515","2017-11-13",1,3,5,8,8,"No",2,3,2,1
"12516","2017-11-13",1,3,7,10,9,"Yes",4,3,1,2
"12517","2017-11-13",3,13,0,13,12,"No",0,0,7,6
"12518","2017-11-13",1,2,2,4,4,"No",1,1,1,1
"12519","2017-11-13",2,6,0,6,6,"Yes",NA,NA,3,3
"12520","2017-11-13",5,13,12,25,25,"No",6,6,6,7
"12521","2017-11-13",4,8,8,16,15,"Yes",2,6,4,4
"12522","2017-11-13",3,6,4,10,10,"Yes",0,4,3,3
"12523","2017-11-13",4,11,5,16,16,"Yes",3,2,4,7
"12524","2017-11-13",1,4,2,6,6,"Yes",0,2,2,2
"12525","2017-11-13",1,4,4,8,8,"Yes",2,2,2,2
"12526","2017-11-26",1,2,2,4,4,"No",0,2,1,1
"12527","2017-11-13",1,2,3,5,5,"Yes",1,2,1,1
"12528","2017-11-13",2,3,3,6,7,"Yes",2,1,1,2
"12529","2017-11-13",5,13,8,21,21,"No",4,4,5,8
"12530","2017-11-13",1,2,4,6,6,"Yes",2,2,1,1
"12531","2017-11-13",1,3,4,7,7,"No",2,2,1,2
"12532","2017-11-13",2,7,4,11,11,"Yes",2,2,2,5
"12533","2017-11-13",2,3,9,12,12,"Yes",4,5,1,2
"12534","2017-11-13",4,11,6,17,17,"Yes",4,2,4,7
"12535","2017-11-13",1,2,3,5,5,"No",2,1,1,1
"12536","2017-11-13",1,2,2,4,4,"Yes",1,1,1,1
"12537","2017-11-13",1,5,2,7,7,"Yes",2,NA,2,3
"12538","2017-11-13",2,5,8,13,13,"Yes",3,5,2,3
"12539","2017-11-13",3,12,7,19,19,"Yes",4,3,7,5
"12540","2017-11-13",1,2,8,10,10,"Yes",2,6,1,1
"12541","2017-11-13",1,5,4,9,9,"Yes",2,2,2,3
"12542","2017-11-13",4,4,4,8,8,"No",2,2,2,2
"12543","2017-11-13",3,8,5,13,13,"No",2,3,3,5
"12544","2017-11-13",3,7,8,15,15,"No",3,5,3,4
"12545","2017-11-13",5,12,8,20,20,"No",4,4,7,5
"12546","2017-11-13",1,3,1,4,4,"Yes",0,1,1,2
"12547","2017-11-13",2,4,5,9,10,"Yes",2,3,2,2
"12548","2017-11-13",4,14,9,23,17,"Yes",5,4,6,8
"12549","2017-11-13",1,2,2,4,4,"No",1,1,1,1
"12550","2017-11-13",4,8,5,13,15,"No",2,3,4,4
"12551","2017-11-13",3,7,4,11,12,"Yes",2,2,3,4
"12552","2017-11-13",1,3,2,5,5,"Yes",1,1,1,2
"12553","2017-11-13",1,3,0,3,3,"No",0,0,1,2
"12554","2017-11-13",1,3,2,5,5,"Yes",1,1,2,1
"12555","2017-11-13",1,3,4,7,7,"Yes",2,2,1,2
"12556","2017-11-13",3,7,7,14,14,"Yes",2,5,3,4
"12557","2017-11-13",2,5,5,10,10,"Yes",3,2,2,3
"12558","2017-11-13",2,4,2,6,6,"No",0,2,2,2
"12559","2017-11-13",4,8,4,12,8,"No",1,3,4,4
"12560","2017-11-13",5,14,6,20,23,"Yes",2,4,5,9
"12561","2017-11-13",4,8,4,12,12,"No",2,2,4,4
"12562","2017-11-13",10,23,14,37,39,"No",6,8,10,13
"12563","2017-11-13",1,3,4,7,7,"Yes",1,3,1,2
"12564","2017-11-13",2,9,4,13,13,"No",1,3,5,4
"12565","2017-11-13",4,8,7,15,16,"Yes",3,4,4,4
"12566","2017-11-13",3,4,1,5,5,"Yes",0,1,2,2
"12567","2017-11-13",1,2,5,7,7,"Yes",3,2,1,1
"12568","2017-11-13",2,4,7,11,11,"Yes",3,4,2,2
"12569","2017-11-13",1,2,2,4,5,"Yes",1,1,1,1
"12570","2017-11-13",2,11,5,16,16,"Yes",2,3,7,4
"12571","2017-11-13",4,8,1,9,9,"Yes",0,1,4,4
"12572","2017-11-13",3,6,5,11,9,"Yes",3,2,3,3
"12573","2017-11-13",1,2,2,4,4,"No",1,1,1,1
"12574","2017-11-13",6,13,14,27,27,"Yes",7,7,5,8
"12575","2017-11-14",3,7,7,14,4,"Yes",3,4,2,5
"12576","2017-11-14",1,3,1,4,4,"Yes",1,0,1,2
"12577","2017-11-14",1,4,4,8,8,"Yes",3,1,1,3
"12578","2017-11-14",1,5,1,6,6,"Yes",0,1,2,3
"12579","2017-11-14",3,5,2,7,7,"Yes",1,1,2,3
"12580","2017-11-14",1,5,3,8,8,"Yes",1,2,3,2
"12581","2017-11-14",2,4,1,5,5,"Yes",0,1,2,2
"12582","2017-11-14",1,2,3,5,5,"Yes",2,1,1,1
"12583","2017-11-14",1,9,5,14,14,"Yes",2,3,4,5
"12584","2017-11-14",1,2,7,9,9,"Yes",1,6,1,1
"12585","2017-11-14",1,2,1,3,3,"Yes",0,1,1,1
"12586","2017-11-14",3,6,7,13,13,"Yes",5,2,3,3
"12587","2017-11-14",3,11,9,20,21,"No",5,4,7,4
"12588","2017-11-14",2,7,5,12,12,"Yes",2,3,2,5
"12589","2017-11-14",3,10,10,20,20,"No",1,9,4,6
"12590","2017-11-14",1,2,3,5,5,"Yes",1,2,1,1
"12591","2017-11-14",2,4,4,8,8,"No",2,2,2,2
"12592","2017-11-14",1,2,3,5,5,"No",1,2,1,1
"12593","2017-11-14",1,2,2,4,4,"Yes",1,1,1,1
"12594","2017-11-14",2,6,3,9,9,"No",2,1,3,3
"12595","2017-11-14",1,2,4,6,6,"No",2,2,1,1
"12596","2017-11-14",3,6,6,12,12,"Yes",2,4,3,3
"12597","2017-11-14",1,2,4,6,6,"Yes",1,3,1,1
"12598","2017-11-14",1,2,3,5,5,"Yes",1,2,1,1
"12599","2017-11-14",1,2,4,6,6,"Yes",1,3,1,1
"12600","2017-11-14",1,2,3,5,5,"No",1,2,1,1
"12601","2017-11-14",2,5,6,11,11,"No",3,3,2,3
"12602","2017-11-14",4,3,5,8,18,"No",2,3,1,2
"12603","2017-11-14",3,6,4,10,10,NA,2,2,2,4
"12604","2017-11-14",4,9,9,18,18,"Yes",6,3,5,4
"12605","2017-11-14",1,2,2,4,4,"No",NA,2,1,1
"12606","2017-11-14",2,5,5,10,10,"No",1,4,2,3
"12607","2017-11-14",1,4,3,7,7,"No",1,2,2,2
"12608","2017-11-14",1,2,4,6,6,"Yes",1,3,1,1
"12609","2017-11-14",4,6,8,14,14,"Yes",4,4,2,4
"12610","2017-11-14",8,14,10,24,24,"Yes",6,4,8,6
"12611","2017-11-14",1,4,7,11,11,"Yes",5,2,2,2
"12612","2017-11-14",3,9,7,16,16,"Yes",3,4,4,5
"12613","2017-11-14",1,6,4,10,10,"Yes",2,2,3,3
"12614","2017-11-14",2,4,5,9,9,"Yes",0,5,2,2
"12615","2017-11-14",2,2,5,7,7,"No",2,3,1,1
"12616","2017-11-14",4,8,4,12,12,"Yes",2,2,4,4
"12617","2017-11-14",1,2,1,3,3,"Yes",0,1,1,1
"12618","2017-11-14",2,4,5,9,9,"Yes",2,3,2,2
"12619","2017-11-14",1,6,3,9,8,"No",2,1,3,3
"12620","2017-11-14",2,5,4,9,9,"No",2,2,2,3
"12621","2017-11-14",1,2,2,4,4,"Yes",2,NA,1,1
"12622","2017-11-14",1,4,5,9,9,"No",3,2,2,2
"12623","2017-11-14",4,9,5,14,14,"Yes",2,3,4,5
"12624","2017-11-14",1,3,1,4,5,"Yes",NA,1,1,2
"12625","2017-11-14",5,11,10,21,21,"Yes",5,5,5,6
"12626","2017-11-14",6,8,9,17,17,"No",6,3,4,4
"12627","2017-11-14",1,2,3,5,5,"Yes",3,0,1,1
"12628","2017-11-14",2,4,3,7,7,"No",2,1,2,2
"12629","2017-11-14",4,9,5,14,14,"Yes",2,3,4,5
"12630","2017-11-14",1,5,2,7,7,"No",1,1,3,2
"12631","2017-11-14",1,2,5,7,7,"Yes",4,1,1,1
"12632","2017-11-14",4,8,5,13,13,"No",3,2,4,4
"12633","2017-11-14",1,2,6,8,8,"Yes",2,4,1,1
"12634","2017-11-14",1,2,2,4,4,"Yes",0,2,1,1
"12635","2017-11-14",1,4,0,4,4,"Yes",0,0,2,2
"12636","2017-11-14",1,6,3,9,9,"No",1,2,3,3
"12637","2017-11-14",1,4,3,7,7,"Yes",1,2,2,2
"12638","2017-11-14",1,2,2,4,4,"Yes",2,0,1,1
"12639","2017-11-14",1,4,1,5,5,"Yes",1,0,2,2
"12640","2017-11-14",1,2,4,6,6,"Yes",1,3,1,1
"12641","2017-11-14",3,9,2,11,11,"No",1,1,5,4
"12642","2017-11-14",2,4,5,9,9,"Yes",3,2,2,2
"12643","2017-11-14",1,3,4,7,7,"Yes",3,1,2,1
"12644","2017-11-14",1,2,0,2,2,"Yes",NA,NA,1,1
"12645","2017-11-14",2,7,5,12,12,"No",3,2,3,4
"12646","2017-11-14",4,8,9,17,17,"Yes",2,7,4,4
"12647","2017-11-14",1,5,5,10,10,"Yes",2,3,3,2
"12648","2017-11-14",4,8,10,18,18,"No",4,6,4,4
"12649","2017-11-14",1,7,2,9,9,"Yes",0,2,3,4
"12650","2017-11-14",3,8,5,13,13,"No",2,3,4,4
"12651","2017-11-14",1,2,3,5,4,"No",1,2,1,1
"12652","2017-11-14",2,4,6,10,10,"No",3,3,2,2
"12653","2017-11-14",1,5,3,8,8,"Yes",2,1,2,3
"12654","2017-11-14",4,0,0,0,11,"Yes",NA,NA,NA,NA
"12655","2017-11-14",1,2,0,2,2,"Yes",NA,NA,1,1
"12656","2017-11-14",2,6,3,9,9,"No",1,2,3,3
"12657","2017-11-14",1,2,3,5,5,"Yes",0,3,1,1
"12658","2017-11-14",1,4,2,6,6,"Yes",1,1,2,2
"12659","2017-11-14",1,8,11,19,19,"Yes",6,5,6,2
"12660","2017-11-14",NA,0,0,0,NA,"No",NA,NA,NA,NA
"12661","2017-11-10",4,9,5,14,14,"No",3,2,4,5
"12662","2017-11-14",2,9,4,13,13,"No",2,2,4,5
"12663","2017-11-14",2,6,4,10,10,"Yes",2,2,3,3
"12664","2017-11-14",1,4,1,5,5,"Yes",0,1,2,2
"12665","2017-11-14",1,5,4,9,9,"Yes",3,1,1,4
"12666","2017-11-14",1,2,4,6,6,"Yes",1,3,1,1
"12667","2017-11-14",3,6,5,11,11,"Yes",2,3,3,3
"12668","2017-11-14",1,2,1,3,3,"No",0,1,1,1
"12669","2017-11-14",1,3,4,7,7,"Yes",2,2,2,1
"12670","2017-11-14",1,5,0,5,5,"Yes",0,0,3,2
"12671","2017-11-14",1,2,3,5,5,"Yes",2,1,1,1
"12672","2017-11-14",3,5,4,9,9,"Yes",2,2,2,3
"12673","2017-11-14",1,2,6,8,8,"Yes",2,4,1,1
"12674","2017-11-14",1,3,0,3,3,"Yes",NA,NA,1,2
"12675","2017-11-14",2,4,6,10,10,"Yes",2,4,2,2
"12676","2017-11-14",1,3,3,6,6,"Yes",2,1,2,1
"12677","2017-11-14",2,9,3,12,12,"No",2,1,4,5
"12678","2017-11-14",1,2,3,5,5,"No",1,2,1,1
"12679","2017-11-14",1,2,2,4,4,"Yes",NA,2,1,1
"12680","2017-11-14",2,4,0,4,4,"No",0,0,3,1
"12681","2017-11-14",2,2,2,4,4,"No",1,1,1,1
"12682","2017-11-14",2,5,5,10,10,"Yes",1,4,3,2
"12683","2017-11-14",1,2,13,15,15,"Yes",10,3,1,1
"12684","2017-11-14",3,6,9,15,15,"Yes",5,4,3,3
"12685","2017-11-14",3,5,5,10,10,"No",3,2,2,3
"12686","2017-11-14",1,2,5,7,7,"Yes",2,3,1,1
"12687","2017-11-14",1,2,5,7,7,"Yes",2,3,1,1
"12688","2017-11-14",1,2,5,7,7,"Yes",4,1,1,1
"12689","2017-11-14",3,8,2,10,8,"No",1,1,5,3
"12690","2017-11-14",1,5,3,8,8,"No",1,2,3,2
"12691","2017-11-14",1,3,3,6,6,"Yes",2,1,1,2
"12692","2017-11-14",2,4,4,8,8,"Yes",0,4,2,2
"12693","2017-11-14",3,6,14,20,22,"No",6,8,3,3
"12694","2017-11-14",2,4,6,10,10,"No",2,4,2,2
"12695","2017-11-14",1,8,3,11,11,"Yes",1,2,1,7
"12696","2017-11-14",1,4,2,6,6,"Yes",1,1,3,1
"12697","2017-11-14",4,9,5,14,14,"No",2,3,5,4
"12698","2017-11-14",1,2,4,6,6,"Yes",1,3,1,1
"12699","2017-11-14",1,2,6,8,8,"Yes",3,3,1,1
"12700","2017-11-14",1,6,2,8,8,"Yes",1,1,3,3
"12701","2017-11-14",2,4,2,6,6,"Yes",1,1,2,2
"12702","2017-11-14",2,5,4,9,9,"Yes",2,2,2,3
"12703","2017-11-14",1,5,3,8,8,"No",2,1,3,2
"12704","2017-11-14",1,2,5,7,7,"Yes",1,4,1,1
"12705","2017-11-14",1,2,3,5,5,"Yes",1,2,1,1
"12706","2017-11-14",1,5,1,6,6,"Yes",0,1,3,2
"12707","2017-11-14",1,2,4,6,6,"Yes",2,2,1,1
"12708","2017-11-14",1,2,3,5,5,"Yes",2,1,1,1
"12709","2017-11-14",1,3,2,5,4,"Yes",1,1,2,1
"12710","2017-11-14",2,9,3,12,12,"No",2,1,4,5
"12711","2017-11-14",1,2,0,2,2,"No",NA,NA,1,1
"12712","2017-11-14",2,8,4,12,12,"No",3,1,5,3
"12713","2017-11-14",1,2,3,5,5,"No",1,2,1,1
"12714","2017-11-14",1,2,5,7,7,"Yes",2,3,1,1
"12715","2017-11-14",5,7,4,11,11,"Yes",2,2,3,4
"12716","2017-11-14",1,3,3,6,6,"Yes",2,1,1,2
"12717","2017-11-14",1,2,6,8,8,"Yes",2,4,1,1
"12718","2017-11-14",1,2,6,8,8,"Yes",4,2,1,1
"12719","2017-11-14",2,9,5,14,14,"Yes",2,3,4,5
"12720","2017-11-14",1,1,0,1,1,"No",NA,NA,1,NA
"12721","2017-11-14",1,3,3,6,6,"Yes",2,1,2,1
"12722","2017-11-14",1,2,6,8,8,"Yes",4,2,1,1
"12723","2017-11-14",NA,4,22,26,NA,"Yes",2,20,1,3
"12724","2017-11-14",1,2,3,5,5,"Yes",2,1,1,1
"12725","2017-11-08",2,8,5,13,13,"No",3,2,5,3
"12726","2017-11-14",1,2,3,5,5,"No",2,1,1,1
"12727","2017-11-14",1,2,4,6,6,"No",3,1,1,1
"12728","2017-11-14",3,7,2,9,14,"No",1,1,4,3
"12729","2017-11-14",1,3,4,7,7,"Yes",2,2,1,2
"12730","2017-11-14",1,3,2,5,5,"Yes",1,1,2,1
"12731","2017-11-14",1,7,2,9,9,"No",1,1,5,2
"12732","2017-11-14",4,8,4,12,12,"Yes",2,2,4,4
"12733","2017-11-14",1,3,2,5,5,"No",1,1,1,2
"12734","2017-11-14",1,4,1,5,5,"Yes",NA,1,2,2
"12735","2017-11-14",2,4,9,13,13,"No",3,6,2,2
"12736","2017-11-14",NA,10,300,310,NA,"No",120,180,6,4
"12737","2017-11-14",2,4,4,8,8,"No",1,3,2,2
"12738","2017-11-14",1,2,5,7,5,"No",3,2,1,1
"12739","2017-11-14",1,3,3,6,6,"Yes",1,2,2,1
"12740","2017-11-14",1,2,5,7,7,"Yes",2,3,1,1
"12741","2017-11-14",7,14,26,40,40,"No",11,15,7,7
"12742","2017-11-14",2,3,4,7,7,"No",3,1,1,2
"12743","2017-11-14",5,11,10,21,21,"No",5,5,6,5
"12744","2017-11-14",1,4,5,9,9,"Yes",3,2,2,2
"12745","2017-11-14",2,4,2,6,6,"No",0,2,2,2
"12746","2017-11-14",2,2,4,6,6,"Yes",0,4,1,1
"12747","2017-11-14",1,2,3,5,5,"Yes",1,2,1,1
"12748","2017-11-13",1,3,5,8,8,"No",2,3,1,2
"12749","2017-11-14",1,2,1,3,3,"Yes",1,0,1,1
"12750","2017-11-14",2,4,4,8,8,"Yes",3,1,2,2
"12751","2017-11-14",1,2,4,6,6,"No",0,4,1,1
"12752","2017-11-14",3,6,5,11,11,"Yes",3,2,3,3
"12753","2017-11-14",1,3,2,5,5,"Yes",1,1,2,1
"12754","2017-11-14",1,5,3,8,8,"No",2,1,3,2
"12755","2017-11-14",3,4,4,8,8,"No",2,2,2,2
"12756","2017-11-14",2,7,4,11,11,"Yes",2,2,3,4
"12757","2017-11-14",1,3,5,8,8,"Yes",2,3,1,2
"12758","2017-11-14",1,3,6,9,9,"Yes",3,3,1,2
"12759","2017-11-14",1,4,0,4,4,"Yes",0,0,2,2
"12760","2017-11-14",1,2,0,2,2,"No",0,0,1,1
"12761","2017-11-14",3,5,4,9,9,"Yes",2,2,3,2
"12762","2017-11-14",1,2,4,6,6,"No",1,3,1,1
"12763","2017-11-14",2,4,6,10,10,"Yes",0,6,2,2
"12764","2017-11-14",1,2,3,5,5,"Yes",2,1,1,1
"12765","2017-11-14",1,3,5,8,8,"Yes",3,2,2,1
"12766","2017-11-14",1,5,5,10,10,"No",1,4,2,3
"12767","2017-11-14",1,3,5,8,7,"Yes",2,3,2,1
"12768","2017-11-14",1,4,1,5,5,"No",0,1,2,2
"12769","2017-11-14",3,5,1,6,6,"Yes",0,1,4,1
"12770","2017-11-14",1,2,3,5,5,"No",1,2,1,1
"12771","2017-11-14",2,4,4,8,8,"Yes",2,2,2,2
"12772","2017-11-14",1,2,4,6,6,"Yes",3,1,1,1
"12773","2017-11-14",1,2,5,7,7,"Yes",2,3,1,1
"12774","2017-11-14",2,5,7,12,12,"Yes",3,4,2,3
"12775","2017-11-14",2,4,4,8,8,"No",1,3,2,2
"12776","2017-11-14",1,2,5,7,7,"No",3,2,1,1
"12777","2017-11-14",1,2,3,5,6,"Yes",1,2,1,1
"12778","2017-11-14",2,4,1,5,5,"Yes",NA,1,2,2
"12779","2017-11-14",1,2,2,4,5,"Yes",2,0,1,1
"12780","2017-11-14",1,2,10,12,12,"Yes",4,6,1,1
"12781","2017-11-14",1,2,2,4,4,"Yes",NA,2,1,1
"12782","2017-11-14",NA,40,25,65,NA,"Yes",10,15,15,25
"12783","2017-11-14",2,5,6,11,11,"No",3,3,3,2
"12784","2017-11-14",1,2,9,11,11,"Yes",4,5,1,1
"12785","2017-11-14",3,9,6,15,15,"Yes",3,3,6,3
"12786","2017-11-14",1,2,3,5,5,"No",1,2,1,1
"12787","2017-11-14",1,2,3,5,5,"Yes",1,2,1,1
"12788","2017-11-14",3,3,6,9,9,"No",3,3,1,2
"12789","2017-11-14",1,2,5,7,7,"Yes",2,3,1,1
"12790","2017-11-14",1,4,4,8,8,"No",1,3,2,2
"12791","2017-11-14",2,9,4,13,13,"No",2,2,4,5
"12792","2017-11-14",1,1,3,4,4,"No",2,1,NA,1
"12793","2017-11-14",1,2,4,6,6,"Yes",1,3,1,1
"12794","2017-11-14",1,4,4,8,8,"Yes",1,3,3,1
"12795","2017-11-14",1,4,2,6,6,"No",2,0,1,3
"12796","2017-11-14",1,2,3,5,4,"Yes",1,2,1,1
"12797","2017-11-14",1,2,3,5,5,"Yes",0,3,1,1
"12798","2017-11-14",6,10,10,20,20,"No",5,5,4,6
"12799","2017-11-14",1,1,2,3,3,"Yes",0,2,0,1
"12800","2017-11-14",3,10,7,17,17,"Yes",6,1,4,6
"12801","2017-11-14",1,2,3,5,5,"No",2,1,1,1
"12802","2017-11-14",1,5,4,9,9,"Yes",2,2,2,3
"12803","2017-11-14",1,3,6,9,9,"Yes",2,4,2,1
"12804","2017-11-14",2,4,2,6,6,"No",1,1,2,2
"12805","2017-11-14",5,7,3,10,10,"Yes",2,1,3,4
"12806","2017-11-14",1,2,4,6,5,"Yes",1,3,1,1
"12807","2017-11-14",1,3,2,5,5,"Yes",1,1,2,1
"12808","2017-11-14",1,2,1,3,3,"No",1,0,1,1
"12809","2017-11-14",2,4,3,7,7,"No",1,2,2,2
"12810","2017-11-14",3,4,11,15,15,"Yes",5,6,2,2
"12811","2017-11-14",1,4,5,9,9,"No",2,3,1,3
"12812","2017-11-14",1,2,5,7,7,"Yes",2,3,1,1
"12813","2017-11-14",1,2,5,7,7,"Yes",2,3,1,1
"12814","2017-11-14",1,2,5,7,7,"Yes",2,3,1,1
"12815","2017-11-14",4,9,9,18,18,"Yes",3,6,5,4
"12816","2017-11-14",1,2,1,3,3,"Yes",1,NA,1,1
"12817","2017-11-14",1,2,3,5,5,"Yes",2,1,1,1
"12818","2017-11-14",NA,34,0,34,NA,"No",NA,NA,14,20
"12819","2017-11-14",3,6,5,11,11,"Yes",3,2,3,3
"12820","2017-11-14",1,5,4,9,9,"No",3,1,3,2
"12821","2017-11-14",3,4,6,10,10,"Yes",3,3,3,1
"12822","2017-11-14",1,2,7,9,9,"Yes",3,4,1,1
"12823","2017-11-14",2,5,4,9,9,"Yes",2,2,2,3
"12824","2017-11-14",1,2,10,12,12,"Yes",4,6,1,1
"12825","2017-11-14",1,3,5,8,8,"Yes",2,3,2,1
"12826","2017-11-14",1,2,4,6,6,"Yes",1,3,1,1
"12827","2017-11-14",1,3,2,5,5,"Yes",1,1,2,1
"12828","2017-11-14",1,2,5,7,7,"No",2,3,1,1
"12829","2017-11-14",1,2,5,7,7,"Yes",2,3,1,1
"12830","2017-11-14",1,3,3,6,7,"Yes",2,1,1,2
"12831","2017-11-14",1,3,4,7,7,"Yes",2,2,2,1
"12832","2017-11-14",3,6,2,8,10,"Yes",0,2,3,3
"12833","2017-11-14",3,6,5,11,12,"Yes",3,2,3,3
"12834","2017-11-14",1,3,3,6,7,"No",1,2,2,1
"12835","2017-11-14",1,4,2,6,7,"Yes",1,1,1,3
"12836","2017-11-14",5,8,2,10,10,"No",0,2,5,3
"12837","2017-11-14",2,5,6,11,11,"No",2,4,2,3
"12838","2017-11-14",1,2,2,4,4,"Yes",1,1,1,1
"12839","2017-11-14",1,3,2,5,5,"Yes",1,1,2,1
"12840","2017-11-14",1,4,1,5,5,"Yes",0,1,1,3
"12841","2017-11-09",1,4,2,6,6,"No",0,2,2,2
"12842","2017-11-14",3,6,3,9,8,"Yes",1,2,3,3
"12843","2017-11-14",4,7,4,11,15,"No",1,3,4,3
"12844","2017-11-14",1,3,2,5,5,"Yes",1,1,2,1
"12845","2017-11-14",1,5,7,12,12,"No",3,4,3,2
"12846","2017-11-14",1,3,3,6,6,"No",1,2,2,1
"12847","2017-11-14",1,2,4,6,6,"Yes",1,3,1,1
"12848","2017-11-14",1,2,2,4,5,"No",1,1,1,1
"12849","2017-11-14",2,4,3,7,7,"Yes",2,1,2,2
"12850","2017-11-14",1,3,5,8,8,"Yes",2,3,1,2
"12851","2017-11-14",4,8,7,15,16,"Yes",2,5,4,4
"12852","2017-11-14",1,3,2,5,6,"Yes",1,1,1,2
"12853","2017-11-14",2,6,5,11,7,"No",2,3,4,2
"12854","2017-11-14",4,6,2,8,8,"Yes",1,1,4,2
"12855","2017-11-14",1,2,2,4,4,"Yes",0,2,1,1
"12856","2017-11-14",4,7,3,10,10,"Yes",1,2,4,3
"12857","2017-11-14",1,2,2,4,4,"No",2,0,1,1
"12858","2017-11-14",3,9,5,14,13,"Yes",2,3,3,6
"12859","2017-11-14",1,2,6,8,9,"Yes",2,4,1,1
"12860","2017-11-14",1,2,1,3,3,"Yes",0,1,1,1
"12861","2017-11-14",1,2,5,7,7,"No",2,3,1,1
"12862","2017-11-14",1,3,5,8,8,"Yes",3,2,1,2
"12863","2017-11-14",4,10,3,13,13,"Yes",1,2,4,6
"12864","2017-11-14",2,4,7,11,12,"Yes",3,4,2,2
"12865","2017-11-14",1,2,2,4,5,"Yes",1,1,1,1
"12866","2017-11-15",2,4,6,10,10,"No",0,6,2,2
"12867","2017-11-15",1,4,2,6,6,"Yes",1,1,2,2
"12868","2017-11-15",1,2,6,8,8,"No",2,4,1,1
"12869","2017-11-15",3,6,12,18,18,"Yes",7,5,3,3
"12870","2017-11-15",1,5,1,6,6,"Yes",0,1,2,3
"12871","2017-11-15",2,4,5,9,9,"No",1,4,2,2
"12872","2017-11-15",2,4,8,12,12,"Yes",4,4,2,2
"12873","2017-11-15",2,4,4,8,8,"No",1,3,2,2
"12874","2017-11-15",1,3,3,6,6,"Yes",2,1,1,2
"12875","2017-11-15",3,6,10,16,16,"Yes",4,6,3,3
"12876","2017-11-15",1,2,6,8,8,"Yes",2,4,1,1
"12877","2017-11-15",1,2,2,4,4,"Yes",1,1,1,1
"12878","2017-11-15",3,8,12,20,20,"Yes",7,5,3,5
"12879","2017-11-15",1,2,2,4,4,"Yes",0,2,1,1
"12880","2017-11-15",2,4,9,13,13,"Yes",5,4,2,2
"12881","2017-11-15",1,2,4,6,6,"Yes",2,2,1,1
"12882","2017-11-15",2,4,1,5,5,"Yes",0,1,2,2
"12883","2017-11-15",3,8,7,15,15,"Yes",4,3,5,3
"12884","2017-11-15",1,4,4,8,6,"Yes",2,2,2,2
"12885","2017-11-15",3,5,8,13,13,"Yes",4,4,3,2
"12886","2017-11-15",1,2,6,8,8,"Yes",5,1,1,1
"12887","2017-11-15",1,2,4,6,6,"Yes",2,2,1,1
"12888","2017-11-15",2,7,6,13,13,"Yes",3,3,3,4
"12889","2017-11-15",1,4,5,9,9,"Yes",3,2,2,2
"12890","2017-11-15",1,2,3,5,5,"Yes",1,2,1,1
"12891","2017-11-15",1,2,5,7,7,"Yes",2,3,1,1
"12892","2017-11-15",1,2,2,4,4,"No",1,1,1,1
"12893","2017-11-15",1,2,3,5,5,"Yes",2,1,1,1
"12894","2017-11-15",2,4,7,11,11,"No",5,2,2,2
"12895","2017-11-15",1,3,4,7,7,"Yes",1,3,2,1
"12896","2017-11-15",1,2,5,7,7,"Yes",3,2,1,1
"12897","2017-11-15",1,2,4,6,6,"Yes",2,2,1,1
"12898","2017-11-15",1,2,4,6,6,"Yes",3,1,1,1
"12899","2017-11-15",1,2,5,7,6,"Yes",2,3,1,1
"12900","2017-11-15",3,6,4,10,10,"No",2,2,3,3
"12901","2017-11-15",1,3,3,6,6,"Yes",0,3,2,1
"12902","2017-11-15",3,4,7,11,10,"Yes",1,6,1,3
"12903","2017-11-15",3,9,5,14,15,"Yes",2,3,4,5
"12904","2017-11-15",2,6,3,9,9,"No",1,2,3,3
"12905","2017-11-14",1,4,0,4,4,"No",0,0,1,3
"12906","2017-11-15",2,2,2,4,4,"No",1,1,1,1
"12907","2017-12-03",2,4,2,6,8,"Yes",1,1,2,2
"12908","2017-11-15",1,2,7,9,8,"Yes",5,2,1,1
"12909","2017-11-15",1,6,4,10,10,"Yes",2,2,3,3
"12910","2017-11-15",1,5,2,7,7,"Yes",1,1,3,2
"12911","2017-11-15",1,2,4,6,6,"Yes",2,2,1,1
"12912","2017-11-15",1,2,3,5,5,"Yes",1,2,1,1
"12913","2017-11-15",2,6,6,12,12,"No",3,3,3,3
"12914","2017-11-15",1,2,8,10,10,"Yes",3,5,1,1
"12915","2017-11-15",3,6,6,12,12,"No",2,4,3,3
"12916","2017-11-15",2,7,5,12,12,"Yes",2,3,3,4
"12917","2017-11-15",4,5,2,7,12,"No",1,1,3,2
"12918","2017-11-15",1,3,3,6,6,"Yes",0,3,2,1
"12919","2017-11-15",1,2,10,12,12,"Yes",6,4,1,1
"12920","2017-11-15",2,4,4,8,8,"No",0,4,2,2
"12921","2017-11-15",1,5,3,8,8,"No",2,1,3,2
"12922","2017-11-15",2,6,5,11,11,"Yes",3,2,2,4
"12923","2017-11-15",1,7,0,7,7,"Yes",0,0,3,4
"12924","2017-11-15",1,2,4,6,6,"Yes",2,2,1,1
"12925","2017-11-15",1,4,4,8,8,"Yes",3,1,2,2
"12926","2017-11-15",3,8,5,13,13,"No",2,3,3,5
"12927","2017-11-15",1,2,1,3,3,"Yes",0,1,1,1
"12928","2017-11-15",3,10,6,16,16,"No",2,4,4,6
"12929","2017-11-15",1,2,2,4,4,"Yes",1,1,1,1
"12930","2017-11-15",1,2,7,9,9,"Yes",7,0,1,1
"12931","2017-11-15",3,5,5,10,10,"No",3,2,3,2
"12932","2017-11-15",1,7,5,12,10,"Yes",2,3,0,7
"12933","2017-11-15",1,2,5,7,7,"Yes",1,4,1,1
"12934","2017-11-15",1,2,2,4,4,"Yes",0,2,1,1
"12935","2017-11-15",1,5,4,9,9,"Yes",3,1,2,3
"12936","2017-11-15",2,3,3,6,6,"Yes",1,2,2,1
"12937","2017-11-15",2,4,7,11,9,"No",2,5,2,2
"12938","2017-11-15",3,6,7,13,13,"Yes",3,4,3,3
"12939","2017-11-15",1,5,2,7,7,"No",1,1,2,3
"12940","2017-11-26",3,6,9,15,12,"No",2,7,3,3
"12941","2017-11-15",2,2,3,5,5,"No",1,2,1,1
"12942","2017-11-15",2,2,5,7,8,"Yes",3,2,1,1
"12943","2017-11-15",NA,190,54,244,NA,"Yes",23,31,90,100
"12944","2017-11-15",1,5,3,8,8,"Yes",2,1,3,2
"12945","2017-11-15",1,2,7,9,9,"Yes",3,4,1,1
"12946","2017-11-15",3,7,0,7,7,"Yes",0,0,5,2
"12947","2017-11-15",1,2,4,6,6,"Yes",2,2,1,1
"12948","2017-11-15",2,9,2,11,11,"No",1,1,3,6
"12949","2017-11-15",3,5,9,14,14,"No",4,5,2,3
"12950","2017-11-15",2,4,7,11,11,"No",6,1,2,2
"12951","2017-11-15",1,2,2,4,4,"No",1,1,1,1
"12952",NA,1,2,4,6,6,"Yes",1,3,1,1
"12953","2017-11-15",1,2,4,6,6,"Yes",2,2,1,1
"12954","2017-11-15",2,4,7,11,11,"Yes",3,4,2,2
"12955","2017-11-15",2,5,4,9,9,"Yes",1,3,3,2
"12956","2017-11-15",4,7,8,15,15,"Yes",2,6,4,3
"12957","2017-11-15",1,3,0,3,3,"Yes",NA,NA,2,1
"12958","2017-11-15",1,2,4,6,6,"No",2,2,1,1
"12959","2017-11-15",3,13,6,19,19,"Yes",3,3,9,4
"12960","2017-11-15",2,10,5,15,15,"No",2,3,5,5
"12961","2017-11-15",5,10,10,20,20,"No",4,6,5,5
"12962","2017-11-15",1,3,2,5,5,"Yes",1,1,1,2
"12963","2017-11-15",3,4,4,8,9,"Yes",3,1,2,2
"12964","2017-11-15",1,3,3,6,5,"Yes",1,2,2,1
"12965","2017-11-15",3,10,6,16,16,"No",4,2,6,4
"12966","2017-12-04",2,4,4,8,8,"Yes",4,0,2,2
"12967","2017-11-15",4,7,5,12,12,"Yes",1,4,4,3
"12968","2017-11-15",4,5,10,15,15,"No",5,5,2,3
"12969","2017-11-15",2,5,3,8,8,"Yes",1,2,3,2
"12970","2017-11-15",4,8,12,20,20,"No",5,7,4,4
"12971","2017-11-15",4,10,5,15,15,"No",2,3,5,5
"12972","2017-11-15",1,2,5,7,7,"Yes",4,1,1,1
"12973","2017-12-03",1,2,3,5,5,"Yes",2,1,1,1
"12974","2017-11-15",2,9,3,12,12,"No",2,1,5,4
"12975","2017-11-15",1,2,3,5,5,"Yes",1,2,1,1
"12976","2017-11-15",2,4,8,12,12,"No",4,4,2,2
"12977","2017-11-15",3,10,10,20,20,"Yes",5,5,4,6
"12978","2017-11-15",1,4,7,11,11,"Yes",3,4,2,2
"12979","2017-11-15",4,7,9,16,16,"No",3,6,4,3
"12980","2017-11-15",1,2,2,4,4,"Yes",1,1,1,1
"12981","2017-11-15",NA,6,67,73,NA,"Yes",30,37,1,5
"12982","2017-11-16",1,8,5,13,8,"No",2,3,3,5
"12983","2017-11-15",3,5,4,9,9,"No",2,2,3,2
"12984","2017-11-15",1,4,0,4,4,"Yes",0,0,2,2
"12985","2017-11-15",1,2,3,5,5,"Yes",1,2,1,1
"12986","2017-11-15",3,4,2,6,6,"Yes",1,1,2,2
"12987","2017-11-15",1,2,0,2,2,"Yes",NA,NA,1,1
"12988","2017-11-15",2,7,3,10,10,"No",2,1,3,4
"12989","2017-11-15",1,2,2,4,4,"Yes",1,1,1,1
"12990","2017-11-15",1,2,3,5,5,"No",1,2,1,1
"12991","2017-11-15",2,10,4,14,14,"Yes",1,3,4,6
"12992","2017-11-15",1,2,3,5,5,"Yes",1,2,1,1
"12993","2017-11-15",4,5,10,15,15,"No",5,5,2,3
"12994","2017-11-15",1,3,2,5,5,"Yes",1,1,2,1
"12995","2017-11-15",1,5,5,10,10,"Yes",3,2,2,3
"12996","2017-11-15",1,4,7,11,11,"Yes",4,3,2,2
"12997","2017-11-15",1,4,2,6,6,"Yes",1,1,2,2
"12998","2017-11-15",2,8,6,14,14,"Yes",2,4,4,4
"12999","2017-11-15",2,5,7,12,12,"Yes",5,2,2,3
"13000","2017-11-15",1,4,4,8,8,"Yes",2,2,2,2
"13001","2017-11-15",1,2,5,7,7,"Yes",2,3,1,1
"13002","2017-11-15",3,6,5,11,11,"Yes",3,2,3,3
"13003","2017-11-15",1,2,6,8,8,"Yes",4,2,1,1
"13004","2017-11-15",1,2,4,6,6,"Yes",2,2,1,1
"13005","2017-11-15",1,2,2,4,4,"Yes",1,1,1,1
"13006","2017-11-15",1,2,3,5,5,"Yes",1,2,1,1
"13007","2017-11-15",2,3,5,8,8,"Yes",2,3,2,1
"13008","2017-11-15",4,8,7,15,15,"No",5,2,5,3
"13009","2017-11-15",1,3,1,4,4,"Yes",1,0,1,2
"13010","2017-11-15",1,2,3,5,5,"Yes",1,2,1,1
"13011","2017-11-15",5,11,11,22,22,"No",6,5,6,5
"13012","2017-11-15",1,5,2,7,7,"Yes",1,1,2,3
"13013","2017-11-15",1,2,3,5,6,"Yes",3,0,1,1
"13014","2017-11-15",1,7,3,10,9,"Yes",0,3,3,4
"13015","2017-11-15",2,6,6,12,12,"No",2,4,3,3
"13016","2017-11-15",1,2,2,4,4,"No",1,1,1,1
"13017","2017-11-15",2,4,7,11,11,"Yes",3,4,2,2
"13018","2017-11-15",1,2,1,3,3,"Yes",0,1,1,1
"13019","2017-11-15",3,4,7,11,11,"Yes",3,4,2,2
"13020","2017-11-15",2,4,4,8,8,"No",1,3,2,2
"13021","2017-11-15",1,4,4,8,8,"Yes",2,2,2,2
"13022","2017-11-15",1,2,4,6,6,"Yes",1,3,1,1
"13023","2017-11-15",1,2,4,6,6,"Yes",1,3,1,1
"13024","2017-11-15",3,11,2,13,13,"Yes",1,1,5,6
"13025","2017-11-15",NA,5,56,61,NA,"Yes",20,36,2,3
"13026","2017-11-26",1,2,6,8,8,"Yes",4,2,1,1
"13027","2017-11-15",1,1,4,5,6,"Yes",2,2,NA,1
"13028","2017-11-15",1,2,5,7,7,"Yes",3,2,1,1
"13029","2017-11-15",2,5,4,9,9,"Yes",2,2,3,2
"13030","2017-11-15",2,4,10,14,14,"Yes",4,6,2,2
"13031","2017-11-15",2,2,6,8,8,"Yes",3,3,1,1
"13032","2017-11-15",2,7,6,13,13,"No",3,3,3,4
"13033","2017-11-15",2,9,5,14,14,"No",3,2,6,3
"13034","2017-11-26",2,4,5,9,9,"No",4,1,2,2
"13035","2017-11-15",2,7,5,12,12,"Yes",3,2,3,4
"13036","2017-11-15",3,5,10,15,15,"Yes",3,7,2,3
"13037","2017-11-15",4,10,6,16,16,"Yes",4,2,4,6
"13038","2017-11-15",2,7,5,12,12,"Yes",2,3,3,4
"13039","2017-12-03",2,2,6,8,8,"Yes",4,2,1,1
"13040","2017-11-15",2,9,2,11,11,"Yes",1,1,5,4
"13041","2017-11-15",1,2,1,3,3,"Yes",1,NA,1,1
"13042","2017-12-04",1,3,4,7,7,"Yes",0,4,1,2
"13043","2017-11-15",3,5,5,10,10,"No",3,2,2,3
"13044","2017-11-15",3,12,6,18,18,"Yes",4,2,4,8
"13045","2017-11-15",1,2,3,5,5,"No",1,2,1,1
"13046","2017-11-15",3,6,10,16,16,"Yes",5,5,3,3
"13047","2017-11-15",2,10,3,13,13,"No",2,1,5,5
"13048","2017-11-15",NA,27,0,27,NA,"Yes",0,0,17,10
"13049","2017-11-15",2,6,4,10,10,"Yes",1,3,2,4
"13050","2017-11-15",2,9,5,14,14,"No",3,2,4,5
"13051","2017-11-15",3,9,9,18,18,"Yes",4,5,4,5
"13052","2017-11-15",1,2,4,6,6,"Yes",1,3,1,1
"13053","2017-11-15",2,6,6,12,12,"No",3,3,3,3
"13054","2017-11-15",1,5,7,12,12,"Yes",3,4,2,3
"13055","2017-11-15",1,6,3,9,9,"No",1,2,3,3
"13056","2017-11-15",1,2,2,4,4,"Yes",1,1,1,1
"13057","2017-11-15",2,4,5,9,9,"Yes",2,3,2,2
"13058","2017-11-15",1,2,3,5,5,"No",3,0,1,1
"13059","2017-11-15",3,5,5,10,10,"Yes",3,2,2,3
"13060","2017-11-15",1,2,5,7,7,"Yes",2,3,1,1
"13061","2017-11-15",1,2,2,4,4,"Yes",1,1,1,1
"13062","2017-11-15",NA,10,4,14,NA,"No",2,2,4,6
"13063","2017-11-15",4,15,10,25,25,"No",5,5,5,10
"13064","2017-11-15",2,4,1,5,5,"Yes",0,1,2,2
"13065","2017-11-15",1,5,3,8,8,"No",2,1,2,3
"13066","2017-11-15",1,2,2,4,4,"Yes",NA,2,1,1
"13067","2017-11-15",3,6,9,15,15,"No",2,7,3,3
"13068","2017-11-16",2,9,5,14,14,"No",3,2,5,4
"13069","2017-11-15",2,3,2,5,5,"Yes",1,1,2,1
"13070","2017-11-15",1,2,5,7,7,"Yes",0,5,1,1
"13071","2017-11-15",3,5,10,15,15,"Yes",4,6,2,3
"13072","2017-11-15",2,5,3,8,8,"No",2,1,2,3
"13073","2017-11-15",1,2,4,6,6,"Yes",1,3,1,1
"13074","2017-11-15",2,4,3,7,7,NA,2,1,1,3
"13075","2017-11-15",4,6,6,12,12,"No",4,2,3,3
"13076","2017-12-03",4,8,4,12,12,"Yes",2,2,4,4
"13077","2017-11-15",3,10,7,17,17,"No",4,3,5,5
"13078","2017-11-15",3,8,10,18,18,"No",3,7,4,4
"13079","2017-11-15",2,6,0,6,6,"No",0,0,4,2
"13080","2017-11-15",2,8,7,15,15,"Yes",2,5,5,3
"13081","2017-11-15",3,4,8,12,12,"Yes",5,3,2,2
"13082","2017-11-15",1,1,4,5,5,"Yes",2,2,NA,1
"13083","2017-11-15",2,3,5,8,8,"Yes",0,5,1,2
"13084","2017-11-15",1,2,5,7,7,"No",3,2,1,1
"13085","2017-12-04",1,4,6,10,10,"Yes",5,1,2,2
"13086","2017-11-15",1,3,3,6,6,"Yes",1,2,1,2
"13087","2017-11-15",1,2,7,9,9,"Yes",4,3,1,1
"13088","2017-11-15",1,2,2,4,4,"Yes",0,2,1,1
"13089","2017-11-15",5,15,7,22,22,"Yes",3,4,7,8
"13090","2017-11-15",3,0,0,0,15,NA,NA,NA,NA,NA
"13091","2017-11-15",4,8,12,20,20,"No",7,5,4,4
"13092","2017-12-04",3,8,6,14,14,"Yes",0,6,4,4
"13093","2017-11-15",5,8,7,15,15,"Yes",3,4,4,4
"13094","2017-11-15",5,8,3,11,11,"Yes",1,2,4,4
"13095","2017-11-15",6,11,14,25,25,"Yes",5,9,6,5
"13096","2017-11-15",5,10,12,22,22,"Yes",7,5,5,5
"13097","2017-11-15",1,4,1,5,5,"No",1,0,1,3
"13098","2017-11-15",2,2,3,5,5,"Yes",1,2,1,1
"13099","2017-11-15",1,2,5,7,7,"Yes",2,3,1,1
"13100","2017-11-15",1,4,2,6,6,"Yes",1,1,2,2
"13101","2017-11-15",1,2,1,3,3,"No",0,1,1,1
"13102","2017-11-15",3,6,9,15,15,"No",4,5,3,3
"13103","2017-11-15",1,6,2,8,7,"Yes",1,1,1,5
"13104","2017-11-15",NA,12,275,287,NA,"Yes",160,115,6,6
"13105","2017-11-15",1,5,1,6,6,"Yes",0,1,1,4
"13106","2017-11-15",1,2,7,9,9,"Yes",3,4,1,1
"13107","2017-11-15",3,10,12,22,22,"Yes",5,7,5,5
"13108","2017-11-15",2,2,4,6,6,"Yes",1,3,1,1
"13109","2017-11-15",3,9,3,12,12,"Yes",1,2,3,6
"13110","2017-11-15",1,2,5,7,7,"Yes",4,1,1,1
"13111","2017-11-15",2,3,11,14,14,"Yes",5,6,1,2
"13112","2017-11-15",2,5,4,9,9,"No",2,2,2,3
"13113","2017-12-03",1,2,2,4,4,"Yes",0,2,1,1
"13114","2017-11-15",3,4,2,6,6,"No",1,1,2,2
"13115","2017-11-15",1,3,3,6,6,"Yes",2,1,1,2
"13116","2017-11-15",1,2,1,3,3,"Yes",0,1,1,1
"13117","2017-11-15",1,2,5,7,6,"Yes",2,3,1,1
"13118","2017-11-15",4,8,5,13,13,"No",1,4,4,4
"13119","2017-11-15",4,8,8,16,16,"Yes",5,3,4,4
"13120","2017-11-15",9,15,15,30,30,"Yes",5,10,7,8
"13121","2017-12-03",1,2,6,8,8,"Yes",4,2,1,1
"13122","2017-11-15",2,7,3,10,10,"Yes",1,2,3,4
"13123",NA,1,4,5,9,9,"Yes",2,3,2,2
"13124","2017-11-15",1,6,3,9,9,"No",2,1,3,3
"13125",NA,1,2,3,5,5,"Yes",NA,3,1,1
"13126","2017-11-15",1,4,2,6,6,"Yes",2,0,2,2
"13127","2017-11-15",1,2,3,5,5,"Yes",1,2,1,1
"13128","2017-11-15",1,2,3,5,6,"Yes",1,2,1,1
"13129","2017-11-15",2,4,2,6,7,"No",0,2,2,2
"13130","2017-11-15",4,10,7,17,17,"Yes",4,3,4,6
"13131","2017-11-15",3,6,1,7,7,"No",0,1,3,3
"13132","2017-11-15",1,2,1,3,3,"Yes",0,1,1,1
"13133","2017-11-15",4,8,4,12,12,"Yes",2,2,4,4
"13134","2017-11-15",1,2,5,7,7,"Yes",3,2,1,1
"13135","2017-11-15",4,8,7,15,15,"Yes",4,3,4,4
"13136","2017-11-15",4,8,8,16,18,"No",4,4,4,4
"13137","2017-11-15",5,9,2,11,11,"Yes",1,1,4,5
"13138","2017-11-15",1,3,3,6,6,"Yes",1,2,1,2
"13139","2017-11-15",1,4,2,6,6,"Yes",1,1,1,3
"13140","2017-11-15",1,8,4,12,13,"Yes",2,2,3,5
"13141","2017-11-15",6,12,6,18,18,"No",1,5,6,6
"13142","2017-11-15",1,7,5,12,12,"Yes",3,2,2,5
"13143","2017-11-15",4,8,10,18,20,"Yes",4,6,4,4
"13144","2017-11-15",2,4,5,9,10,"No",2,3,2,2
"13145","2017-11-15",1,2,3,5,5,"Yes",1,2,1,1
"13146","2017-11-15",2,8,3,11,12,"Yes",1,2,4,4
"13147","2017-11-15",7,15,5,20,21,"No",3,2,7,8
"13148","2017-11-15",1,3,3,6,6,"Yes",1,2,1,2
"13149","2017-11-15",1,3,2,5,5,"Yes",1,1,1,2
"13150","2017-11-15",4,10,4,14,14,"Yes",1,3,4,6
"13151","2017-11-15",4,8,4,12,12,"No",1,3,4,4
"13152","2017-11-15",2,4,1,5,5,"Yes",0,1,2,2
"13153","2017-11-15",1,2,2,4,5,"Yes",1,1,1,1
"13154","2017-11-15",1,4,2,6,7,"Yes",1,1,2,2
"13155","2017-11-15",1,2,4,6,6,"Yes",1,3,1,1
"13156","2017-11-15",2,4,6,10,10,"Yes",3,3,2,2
"13157","2017-11-15",5,10,7,17,18,"Yes",4,3,5,5
"13158","2017-11-15",1,2,2,4,4,"Yes",1,1,1,1
"13159","2017-11-15",1,3,5,8,8,"Yes",2,3,1,2
"13160","2017-11-15",3,6,2,8,8,"Yes",1,1,3,3
"13161","2017-11-15",4,8,3,11,11,"Yes",3,0,4,4
"13162","2017-11-15",1,2,2,4,4,"Yes",1,1,1,1
"13163","2017-11-15",2,5,9,14,15,"Yes",4,5,2,3
"13164","2017-11-15",2,4,5,9,9,"Yes",3,2,2,2
"13165","2017-11-15",1,3,4,7,7,"Yes",2,2,1,2
"13166","2017-11-15",1,3,5,8,9,"Yes",2,3,1,2
"13167","2017-11-15",1,5,3,8,3,"No",1,2,2,3
"13168","2017-11-15",1,3,2,5,5,"Yes",1,1,1,2
"13169","2017-11-15",4,6,6,12,13,"Yes",4,2,3,3
"13170","2017-11-15",4,8,6,14,16,"No",4,2,4,4
"13171","2017-11-16",5,10,10,20,20,"Yes",4,6,5,5
"13172","2017-11-16",1,2,3,5,5,"Yes",1,2,1,1
"13173","2017-11-16",1,2,6,8,8,"Yes",3,3,1,1
"13174","2017-11-16",2,4,7,11,11,"Yes",4,3,2,2
"13175","2017-11-16",1,2,4,6,5,"No",1,3,1,1
"13176","2017-11-16",3,9,7,16,16,"Yes",4,3,3,6
"13177","2017-11-16",1,2,3,5,5,"No",1,2,1,1
"13178","2017-11-16",5,10,8,18,18,"Yes",3,5,5,5
"13179","2017-11-16",4,6,5,11,14,"No",1,4,1,5
"13180","2017-11-16",1,2,0,2,2,"Yes",0,0,1,1
"13181","2017-11-16",6,12,16,28,28,"Yes",7,9,6,6
"13182","2017-11-16",3,6,8,14,14,"No",3,5,3,3
"13183","2017-11-16",1,2,6,8,8,"Yes",2,4,1,1
"13184","2017-11-16",2,5,4,9,9,"Yes",3,1,2,3
"13185","2017-11-16",2,4,4,8,8,"Yes",2,2,2,2
"13186","2017-11-16",4,7,7,14,14,"Yes",3,4,4,3
"13187","2017-11-16",3,6,11,17,17,"Yes",6,5,3,3
"13188","2017-11-16",1,2,4,6,6,"No",2,2,1,1
"13189","2017-11-16",1,1,0,1,1,"Yes",0,0,1,0
"13190","2017-11-16",5,6,10,16,16,"Yes",5,5,3,3
"13191","2017-11-16",4,4,8,12,12,"Yes",3,5,2,2
"13192","2017-11-16",1,2,9,11,11,"Yes",4,5,1,1
"13193","2017-11-16",1,2,0,2,2,"Yes",0,0,1,1
"13194","2017-11-16",1,2,3,5,5,"Yes",0,3,1,1
"13195","2017-11-16",7,14,5,19,19,"Yes",2,3,7,7
"13196","2017-11-16",4,8,8,16,18,"Yes",2,6,4,4
"13197","2017-11-16",1,2,3,5,5,"Yes",2,1,1,1
"13198","2017-12-03",2,3,3,6,6,"No",0,3,2,1
"13199","2017-11-16",1,4,3,7,7,"Yes",2,1,2,2
"13200","2017-11-16",5,9,4,13,13,"Yes",2,2,5,4
"13201","2017-11-16",6,11,14,25,25,"No",7,7,5,6
"13202","2017-11-16",3,6,6,12,12,"No",2,4,3,3
"13203","2017-11-16",3,5,5,10,10,"Yes",2,3,2,3
"13204","2017-11-16",3,6,6,12,12,"Yes",2,4,3,3
"13205","2017-11-16",1,2,5,7,9,"Yes",1,4,1,1
"13206","2017-11-16",3,6,17,23,23,"Yes",5,12,3,3
"13207","2017-11-16",2,7,6,13,13,"Yes",1,5,3,4
"13208","2017-11-16",5,9,14,23,23,"No",10,4,5,4
"13209","2017-11-16",4,8,12,20,20,"No",5,7,4,4
"13210","2017-11-23",2,4,3,7,7,"No",1,2,2,2
"13211","2017-11-16",4,7,10,17,17,"Yes",5,5,3,4
"13212","2017-11-16",1,2,5,7,7,"Yes",2,3,1,1
"13213","2017-12-03",2,2,1,3,3,"No",0,1,1,1
"13214","2017-11-16",2,4,4,8,8,"No",1,3,2,2
"13215","2017-11-16",1,2,4,6,6,"Yes",1,3,1,1
"13216","2017-11-16",5,10,10,20,20,"Yes",4,6,5,5
"13217","2017-11-16",3,7,4,11,11,"No",1,3,3,4
"13218","2017-12-04",3,1,12,13,13,"Yes",6,6,0,1
"13219","2017-11-16",1,3,8,11,11,"No",2,6,2,1
"13220","2017-11-16",1,2,4,6,6,"No",1,3,1,1
"13221","2017-11-16",3,8,4,12,12,"No",2,2,3,5
"13222","2017-11-16",1,2,7,9,9,"Yes",1,6,1,1
"13223","2017-11-16",4,11,12,23,23,"Yes",8,4,5,6
"13224","2017-11-16",3,4,8,12,12,"Yes",5,3,1,3
"13225","2017-11-16",2,4,3,7,7,"Yes",1,2,2,2
"13226","2017-11-16",2,4,4,8,8,"Yes",2,2,2,2
"13227","2017-11-16",1,2,1,3,3,"Yes",NA,1,1,1
"13228","2017-11-17",1,5,3,8,8,"No",2,1,2,3
"13229","2017-12-03",1,2,3,5,5,"Yes",2,1,1,1
"13230","2017-11-16",5,10,9,19,19,NA,6,3,5,5
"13231","2017-11-16",7,14,9,23,23,"No",5,4,7,7
"13232","2017-11-16",1,2,7,9,9,"Yes",3,4,1,1
"13233","2017-11-16",1,2,3,5,5,"Yes",1,2,1,1
"13234","2017-11-16",3,8,4,12,12,"No",2,2,4,4
"13235","2017-11-16",1,5,2,7,7,"Yes",1,1,2,3
"13236","2017-11-16",3,6,5,11,11,"No",2,3,4,2
"13237","2017-11-16",1,8,8,16,14,"No",3,5,2,6
"13238","2017-11-16",1,2,33,35,8,"No",33,NA,1,1
"13239","2017-11-16",6,12,18,30,30,"Yes",7,11,6,6
"13240","2017-11-16",4,9,4,13,12,"No",1,3,6,3
"13241","2017-11-16",1,3,3,6,6,"Yes",1,2,1,2
"13242","2017-11-16",1,2,2,4,4,"Yes",2,NA,1,1
"13243","2017-11-16",1,2,5,7,7,"Yes",2,3,1,1
"13244","2017-11-16",1,5,1,6,6,"Yes",0,1,2,3
"13245","2017-11-16",1,2,7,9,7,"Yes",2,5,1,1
"13246","2017-11-16",3,5,4,9,9,"Yes",2,2,3,2
"13247","2017-11-16",1,4,3,7,7,"Yes",3,0,3,1
"13248","2017-11-16",1,5,3,8,8,"Yes",2,1,2,3
"13249","2017-11-16",1,2,4,6,6,"Yes",3,1,1,1
"13250","2017-11-16",1,4,3,7,7,"Yes",2,1,2,2
"13251","2017-11-16",2,5,7,12,12,"Yes",3,4,3,2
"13252","2017-11-16",7,14,9,23,23,"No",3,6,7,7
"13253","2017-11-16",3,5,10,15,15,"No",4,6,3,2
"13254","2017-11-16",2,9,3,12,12,"No",2,1,3,6
"13255","2017-11-16",4,8,4,12,12,"Yes",2,2,6,2
"13256","2017-11-16",1,2,3,5,5,"Yes",0,3,1,1
"13257","2017-11-16",1,2,2,4,4,"No",1,1,1,1
"13258","2017-12-04",7,14,16,30,30,"No",12,4,7,7
"13259","2017-11-16",1,7,2,9,6,"No",1,1,3,4
"13260","2017-11-16",1,5,2,7,7,"Yes",1,1,1,4
"13261","2017-11-16",2,4,5,9,9,"Yes",2,3,2,2
"13262","2017-11-16",6,10,14,24,24,"No",6,8,5,5
"13263","2017-11-16",5,8,7,15,15,"Yes",2,5,5,3
"13264","2017-11-16",2,7,3,10,10,"Yes",2,1,3,4
"13265","2017-11-16",2,8,4,12,12,"Yes",2,2,4,4
"13266","2017-11-16",2,6,1,7,7,"Yes",0,1,3,3
"13267","2017-11-16",1,5,3,8,8,NA,2,1,3,2
"13268","2017-11-16",1,3,2,5,5,"Yes",2,0,1,2
"13269","2017-11-16",2,9,2,11,11,"No",1,1,3,6
"13270","2017-11-16",1,3,4,7,7,"Yes",1,3,2,1
"13271","2017-12-03",2,2,6,8,8,"Yes",3,3,1,1
"13272","2017-11-16",4,9,4,13,17,"Yes",1,3,4,5
"13273","2017-11-16",1,2,3,5,5,"No",2,1,1,1
"13274","2017-11-16",1,2,6,8,8,"No",4,2,1,1
"13275","2017-11-16",7,13,11,24,21,"Yes",5,6,7,6
"13276","2017-11-16",1,2,6,8,8,"Yes",2,4,1,1
"13277","2017-11-16",2,5,5,10,10,"No",1,4,2,3
"13278","2017-11-16",1,3,3,6,6,"No",1,2,1,2
"13279","2017-12-03",2,4,8,12,12,"No",3,5,2,2
"13280","2017-11-16",2,3,8,11,11,"Yes",2,6,1,2
"13281","2017-11-16",2,4,4,8,8,"No",2,2,2,2
"13282","2017-11-16",1,2,4,6,6,"Yes",2,2,1,1
"13283","2017-11-16",3,4,4,8,8,"No",2,2,2,2
"13284","2017-11-16",1,2,4,6,6,"Yes",2,2,1,1
"13285","2017-11-16",5,7,17,24,25,"Yes",8,9,4,3
"13286","2017-11-16",4,4,10,14,14,"Yes",5,5,2,2
"13287","2017-11-16",3,6,7,13,10,"Yes",5,2,3,3
"13288","2017-11-16",4,10,10,20,20,"Yes",5,5,6,4
"13289","2017-11-16",1,2,7,9,9,"Yes",3,4,1,1
"13290","2017-11-16",3,6,4,10,10,"Yes",1,3,3,3
"13291","2017-11-16",1,4,4,8,8,"Yes",2,2,1,3
"13292","2017-11-26",1,2,2,4,3,"No",0,2,1,1
"13293","2017-11-16",1,7,5,12,12,"Yes",5,0,6,1
"13294","2017-11-16",10,12,8,20,20,"Yes",2,6,8,4
"13295","2017-11-16",1,2,3,5,5,"Yes",1,2,1,1
"13296","2017-11-16",1,3,4,7,7,"Yes",1,3,1,2
"13297","2017-11-16",2,9,3,12,12,"No",2,1,5,4
"13298","2017-11-16",1,2,5,7,7,"Yes",1,4,1,1
"13299","2017-11-16",2,4,8,12,12,"No",3,5,2,2
"13300","2017-11-16",1,4,5,9,8,"No",2,3,2,2
"13301","2017-11-16",5,11,12,23,23,"No",6,6,5,6
"13302","2017-11-16",3,9,9,18,18,"Yes",6,3,4,5
"13303","2017-11-26",2,4,6,10,10,"Yes",1,5,2,2
"13304","2017-11-16",2,8,8,16,16,"Yes",4,4,5,3
"13305","2017-11-16",2,4,11,15,15,"No",5,6,2,2
"13306","2017-11-16",1,2,3,5,5,"Yes",1,2,1,1
"13307","2017-11-16",4,5,6,11,11,"No",1,5,3,2
"13308","2017-11-16",1,7,5,12,12,"Yes",3,2,3,4
"13309","2017-11-16",3,5,5,10,10,"Yes",3,2,3,2
"13310","2017-11-16",3,3,5,8,8,"Yes",2,3,1,2
"13311","2017-12-03",4,8,7,15,15,"Yes",5,2,4,4
"13312","2017-11-16",1,2,5,7,7,"Yes",3,2,1,1
"13313","2017-11-16",13,25,11,36,50,"Yes",5,6,12,13
"13314","2017-11-16",1,2,4,6,6,"No",3,1,1,1
"13315","2017-11-16",1,3,3,6,6,"Yes",0,3,2,1
"13316","2017-11-16",4,8,3,11,11,"No",3,0,4,4
"13317","2017-11-16",1,2,4,6,6,"Yes",2,2,1,1
"13318","2017-11-16",1,2,4,6,6,"Yes",1,3,1,1
"13319","2017-11-16",3,4,5,9,9,"Yes",2,3,2,2
"13320","2017-11-16",2,8,4,12,12,"Yes",1,3,4,4
"13321","2017-11-16",7,10,7,17,13,"Yes",3,4,6,4
"13322","2017-11-16",1,2,4,6,6,"No",1,3,1,1
"13323","2017-11-16",3,8,5,13,13,"No",2,3,4,4
"13324","2017-11-16",1,2,6,8,8,"Yes",2,4,1,1
"13325","2017-11-16",4,7,10,17,17,"No",2,8,4,3
"13326","2017-11-16",5,5,14,19,19,"Yes",5,9,2,3
"13327","2017-11-16",5,10,10,20,20,"Yes",4,6,5,5
"13328","2017-11-16",1,2,4,6,7,"No",3,1,1,1
"13329","2017-11-16",2,2,3,5,6,"No",1,2,1,1
"13330","2017-11-16",1,2,1,3,3,"No",0,1,1,1
"13331","2017-11-16",1,2,0,2,2,"No",0,0,1,1
"13332","2017-11-16",1,3,3,6,6,"Yes",2,1,1,2
"13333","2017-11-16",1,3,4,7,7,"Yes",2,2,1,2
"13334","2017-11-16",2,4,6,10,10,"Yes",2,4,2,2
"13335","2017-11-16",5,8,8,16,16,"Yes",3,5,4,4
"13336","2017-11-16",1,2,4,6,6,"No",2,2,1,1
"13337","2017-11-26",1,2,6,8,8,"Yes",3,3,1,1
"13338","2017-11-16",1,2,3,5,5,"Yes",2,1,1,1
"13339","2017-11-16",6,10,9,19,19,"Yes",4,5,5,5
"13340","2017-11-16",4,8,11,19,19,"Yes",7,4,4,4
"13341","2017-11-16",1,2,7,9,9,"Yes",7,0,1,1
"13342","2017-11-16",1,2,3,5,5,"No",1,2,1,1
"13343","2017-11-16",3,7,5,12,12,"Yes",3,2,3,4
"13344","2017-11-16",3,8,5,13,13,"Yes",2,3,4,4
"13345","2017-11-16",3,4,4,8,8,"Yes",3,1,2,2
"13346","2017-11-16",2,4,6,10,10,NA,2,4,2,2
"13347","2017-11-16",3,6,3,9,9,"No",1,2,3,3
"13348","2017-11-16",1,2,6,8,8,"Yes",3,3,1,1
"13349","2017-11-16",2,2,4,6,6,"No",2,2,1,1
"13350","2017-11-16",1,2,3,5,5,"Yes",2,1,1,1
"13351","2017-11-16",3,6,6,12,15,"No",2,4,3,3
"13352","2017-11-16",2,5,3,8,8,"Yes",1,2,3,2
"13353",NA,2,5,3,8,8,NA,0,3,2,3
"13354","2017-11-16",1,2,1,3,3,"Yes",0,1,1,1
"13355","2017-11-16",1,2,5,7,7,"Yes",1,4,1,1
"13356","2017-11-16",2,4,4,8,9,"Yes",3,1,2,2
"13357","2017-11-16",1,2,6,8,8,"Yes",4,2,1,1
"13358","2017-11-16",3,3,6,9,9,"Yes",3,3,1,2
"13359","2017-11-16",1,2,1,3,3,"Yes",1,0,1,1
"13360","2017-11-16",3,6,3,9,9,"No",NA,3,3,3
"13361","2017-11-16",6,10,10,20,20,"Yes",5,5,5,5
"13362","2017-11-16",1,2,4,6,6,"Yes",NA,4,1,1
"13363","2017-11-16",3,10,5,15,15,"Yes",2,3,6,4
"13364","2017-11-16",1,2,7,9,9,"Yes",2,5,1,1
"13365","2017-11-16",6,13,12,25,25,"Yes",6,6,6,7
"13366","2017-11-16",2,4,8,12,12,"Yes",3,5,2,2
"13367","2017-11-16",2,6,4,10,10,"Yes",3,1,3,3
"13368","2017-11-16",4,9,8,17,17,"Yes",3,5,3,6
"13369","2017-11-16",1,2,3,5,5,"Yes",1,2,1,1
"13370","2017-11-16",1,3,2,5,5,"No",NA,2,2,1
"13371","2017-11-16",1,3,3,6,6,"No",1,2,2,1
"13372","2017-11-16",3,3,5,8,8,"Yes",2,3,1,2
"13373","2017-11-16",3,6,8,14,14,"Yes",5,3,3,3
"13374","2017-11-16",1,2,5,7,7,"Yes",2,3,1,1
"13375","2017-11-16",1,2,0,2,2,"Yes",0,0,1,1
"13376","2017-11-16",4,9,10,19,19,"Yes",5,5,5,4
"13377","2017-11-16",1,2,3,5,5,"Yes",1,2,1,1
"13378","2017-11-16",2,4,6,10,10,"Yes",2,4,2,2
"13379","2017-11-16",1,2,3,5,5,"No",2,1,1,1
"13380","2017-11-16",1,2,5,7,7,"Yes",3,2,1,1
"13381","2017-11-16",3,8,3,11,11,"Yes",3,0,3,5
"13382","2017-11-16",1,2,3,5,5,"No",1,2,1,1
"13383","2017-11-16",4,6,12,18,18,"Yes",3,9,3,3
"13384","2017-11-16",2,4,8,12,12,"Yes",3,5,2,2
"13385","2017-11-16",2,4,9,13,13,"Yes",7,2,2,2
"13386","2017-12-04",1,2,2,4,4,"Yes",1,1,1,1
"13387","2017-11-16",4,6,7,13,13,"Yes",3,4,3,3
"13388","2017-11-16",2,5,4,9,9,"Yes",1,3,3,2
"13389","2017-11-26",1,1,8,9,9,"Yes",7,1,0,1
"13390","2017-11-16",1,3,5,8,8,"Yes",2,3,1,2
"13391","2017-11-16",2,4,7,11,11,"Yes",5,2,2,2
"13392","2017-11-16",1,1,5,6,6,"Yes",3,2,NA,1
"13393","2017-11-16",1,8,8,16,16,"Yes",2,6,2,6
"13394",NA,2,7,9,16,15,"Yes",6,3,4,3
"13395","2017-11-16",3,4,10,14,14,"Yes",7,3,2,2
"13396","2017-11-16",3,2,7,9,9,"No",4,3,1,1
"13397","2017-11-16",3,8,5,13,13,"Yes",3,2,3,5
"13398","2017-11-16",2,4,10,14,14,"Yes",4,6,2,2
"13399","2017-11-16",4,10,7,17,16,"Yes",4,3,4,6
"13400","2017-11-16",4,5,10,15,15,"No",5,5,2,3
"13401","2017-11-16",4,8,9,17,17,"Yes",5,4,4,4
"13402","2017-11-16",2,2,4,6,6,"Yes",3,1,1,1
"13403","2017-11-16",5,10,10,20,25,"No",3,7,5,5
"13404","2017-11-16",1,2,3,5,5,"Yes",1,2,1,1
"13405","2017-11-16",1,2,2,4,4,"Yes",1,1,1,1
"13406","2017-11-16",2,4,8,12,12,"Yes",4,4,2,2
"13407","2017-11-16",2,4,7,11,11,"No",4,3,2,2
"13408","2017-11-16",1,5,4,9,9,"Yes",1,3,3,2
"13409","2017-11-16",2,3,4,7,7,"No",2,2,1,2
"13410","2017-11-16",1,2,3,5,5,"Yes",1,2,1,1
"13411","2017-11-16",1,2,1,3,3,"Yes",1,0,1,1
"13412","2017-11-16",1,3,3,6,6,"Yes",1,2,1,2
"13413","2017-11-16",NA,2,6,8,8,"No",4,2,1,1
"13414","2017-11-16",4,9,11,20,20,"Yes",5,6,4,5
"13415","2017-11-16",3,6,5,11,11,"Yes",3,2,3,3
"13416","2017-11-16",1,2,3,5,5,"No",0,3,1,1
"13417","2017-11-16",1,3,3,6,6,"No",1,2,2,1
"13418","2017-11-16",1,3,3,6,6,"Yes",1,2,2,1
"13419","2017-11-16",3,6,6,12,12,"Yes",2,4,3,3
"13420","2017-11-16",1,2,3,5,5,"Yes",1,2,1,1
"13421","2017-11-16",2,4,6,10,10,"Yes",3,3,2,2
"13422","2017-11-16",1,2,5,7,7,"No",2,3,1,1
"13423","2017-11-16",2,5,3,8,NA,"No",1,2,3,2
"13424","2017-11-16",3,4,6,10,9,"No",3,3,1,3
"13425","2017-11-16",1,2,3,5,5,"No",1,2,1,1
"13426","2017-11-16",1,2,5,7,7,"Yes",2,3,1,1
"13427","2017-11-16",1,2,3,5,5,"No",1,2,1,1
"13428","2017-11-16",1,3,1,4,4,"Yes",0,1,2,1
"13429","2017-11-16",5,4,3,7,7,"Yes",1,2,2,2
"13430","2017-11-16",2,4,4,8,8,"Yes",1,3,2,2
"13431","2017-11-16",3,7,6,13,13,"Yes",4,2,3,4
"13432","2017-11-16",1,3,2,5,5,"Yes",1,1,1,2
"13433","2017-11-16",1,4,3,7,6,"Yes",1,2,1,3
"13434","2017-11-16",4,8,4,12,12,"Yes",1,3,4,4
"13435","2017-11-16",5,10,5,15,18,"Yes",2,3,5,5
"13436","2017-11-16",5,12,7,19,19,"No",4,3,5,7
"13437","2017-11-16",3,6,8,14,15,"No",5,3,3,3
"13438","2017-11-16",2,5,6,11,11,"Yes",3,3,2,3
"13439","2017-11-16",1,2,5,7,7,"Yes",3,2,1,1
"13440","2017-11-16",4,8,5,13,13,"Yes",2,3,4,4
"13441","2017-11-16",5,14,11,25,25,"No",4,7,5,9
"13442","2017-11-16",2,4,3,7,7,"Yes",2,1,2,2
"13443","2017-11-16",1,2,5,7,7,"Yes",2,3,1,1
"13444","2017-11-16",3,10,7,17,18,"Yes",3,4,7,3
"13445","2017-11-16",1,2,3,5,5,"Yes",1,2,1,1
"13446","2017-11-16",1,2,5,7,8,"Yes",2,3,1,1
"13447","2017-11-16",3,7,6,13,16,"No",4,2,3,4
"13448","2017-11-16",1,2,3,5,5,"Yes",2,1,1,1
"13449","2017-11-16",3,10,7,17,17,"Yes",4,3,3,7
"13450","2017-11-16",4,8,5,13,13,"Yes",1,4,4,4
"13451","2017-11-16",1,2,4,6,6,"Yes",1,3,1,1
"13452","2017-11-16",1,6,6,12,12,"No",3,3,2,4
"13453","2017-11-16",1,2,2,4,4,"Yes",1,1,1,1
"13454","2017-11-16",2,4,5,9,11,"Yes",2,3,2,2
"13455","2017-11-16",1,3,5,8,8,"Yes",2,3,1,2
"13456","2017-11-16",3,7,5,12,14,"Yes",3,2,4,3
"13457","2017-11-16",4,8,4,12,12,"No",1,3,4,4
"13458","2017-11-16",4,8,14,22,22,"No",5,9,4,4
"13459","2017-11-16",5,14,3,17,17,"No",2,1,9,5
"13460","2017-11-16",1,11,11,22,5,"Yes",4,7,5,6
"13461","2017-11-16",5,13,11,24,25,"Yes",5,6,6,7
"13462","2017-11-16",4,12,10,22,21,"No",5,5,4,8
"13463","2017-11-16",2,4,7,11,13,"Yes",2,5,2,2
"13464","2017-11-16",1,4,4,8,8,"Yes",2,2,1,3
"13465","2017-11-16",1,2,2,4,5,"Yes",1,1,1,1
"13466","2017-11-16",1,2,4,6,7,"Yes",1,3,1,1
"13467","2017-11-16",1,2,3,5,6,"No",2,1,1,1
"13468","2017-11-16",4,8,2,10,10,"No",0,2,4,4
"13469","2017-11-16",3,6,11,17,15,"Yes",6,5,3,3
"13470","2017-11-16",6,13,8,21,23,"Yes",4,4,7,6
"13471","2017-11-16",2,3,4,7,7,"No",2,2,2,1
"13472","2017-11-16",4,8,4,12,12,"No",3,1,4,4
"13473","2017-11-13",1,3,1,4,4,"Yes",1,0,1,2
"13474","2017-11-09",2,4,1,5,5,"No",0,1,2,2
"13475","2017-11-01",3,6,12,18,18,"Yes",7,5,3,3
"13476","2017-11-10",1,4,5,9,9,"Yes",2,3,2,2
"13477","2017-11-14",NA,0,0,0,NA,NA,NA,NA,NA,NA
"13478","2017-11-10",1,0,0,0,NA,"Yes",NA,NA,NA,NA
"13479","2017-10-31",4,8,11,19,19,"Yes",5,6,4,4
"13480","2017-11-07",NA,0,0,0,1,NA,NA,NA,NA,NA
"13481","2017-11-07",NA,0,0,0,1,NA,NA,NA,NA,NA
"13482","2017-11-02",3,6,8,14,14,"Yes",5,3,3,3
"13483","2017-11-06",1,4,3,7,7,"Yes",1,2,2,2
"13484","2017-11-07",6,0,0,0,24,"Yes",NA,NA,NA,NA
"13485","2017-11-01",13,25,8,33,33,"No",3,5,13,12
"13486","2017-11-01",5,11,8,19,19,"Yes",4,4,5,6
"13487","2017-11-09",1,3,2,5,5,"Yes",1,1,1,2
"13488","2017-11-09",5,9,10,19,19,"Yes",3,7,5,4
"13489","2017-11-07",1,2,0,2,2,"Yes",0,0,1,1
"13490","2017-11-06",4,0,0,0,16,"Yes",NA,NA,NA,NA
"13491","2017-11-10",4,8,3,11,11,"No",1,2,5,3
"13492","2017-11-07",NA,0,0,0,1,NA,NA,NA,NA,NA
"13493","2017-10-16",1,2,3,5,5,"Yes",NA,3,1,1
"13494","2017-10-31",4,8,8,16,16,"No",5,3,4,4
"13495","2017-11-06",1,2,3,5,5,"No",0,3,1,1
"13496","2017-11-01",1,2,4,6,6,"No",1,3,1,1
"13497","2017-10-14",NA,0,0,0,NA,NA,NA,NA,NA,NA
"13498","2017-11-07",NA,0,0,0,1,NA,NA,NA,NA,NA
"13499","2017-11-01",NA,0,0,0,NA,NA,NA,NA,NA,NA
"13500","2017-10-20",3,7,5,12,12,"Yes",2,3,3,4
"13501","2017-11-08",3,6,3,9,9,"Yes",1,2,3,3
"13502","2017-10-14",1,1,5,6,10,"No",2,3,1,NA
"13503","2017-11-07",NA,0,0,0,1,NA,NA,NA,NA,NA
"13504","2017-10-31",1,3,0,3,3,"Yes",0,0,2,1
"13505","2017-10-31",1,3,4,7,7,"Yes",2,2,1,2
"13506","2017-11-01",1,5,5,10,10,"Yes",1,4,2,3
"13507","2017-11-06",NA,0,0,0,NA,NA,NA,NA,NA,NA
"13508","2017-11-15",NA,0,0,0,NA,NA,NA,NA,NA,NA
"13509","2017-11-07",NA,0,0,0,1,NA,NA,NA,NA,NA
"13510","2017-11-01",1,5,5,10,10,"Yes",4,1,2,3
"13511","2017-11-08",1,9,3,12,12,"Yes",1,2,5,4
"13512","2017-11-01",1,2,1,3,3,"Yes",1,0,1,1
"13513","2017-11-08",1,3,3,6,6,"Yes",1,2,1,2
"13514","2017-10-31",2,4,6,10,10,"No",1,5,2,2
"13515","2017-11-01",3,5,4,9,9,"No",2,2,4,1
"13516","2017-11-09",NA,0,0,0,NA,"Yes",NA,NA,NA,NA
"13517","2017-10-14",5,12,11,23,23,"Yes",5,6,7,5
"13518","2017-11-09",2,4,4,8,8,"Yes",1,3,2,2
"13519","2017-11-07",2,5,1,6,6,"Yes",0,1,2,3
"13520","2017-11-01",3,0,0,0,11,NA,NA,NA,NA,NA
"13521","2017-11-09",1,3,2,5,5,"Yes",1,1,1,2
"13522","2017-11-01",1,2,5,7,7,"No",3,2,1,1
"13523","2017-10-31",2,5,5,10,10,NA,1,4,2,3
"13524","2017-11-07",NA,0,0,0,1,NA,NA,NA,NA,NA
"13525","2017-11-01",NA,0,0,0,NA,NA,NA,NA,NA,NA
"13526","2017-11-08",2,4,2,6,6,"No",0,2,2,2
"13527","2017-11-09",NA,0,0,0,NA,"No",NA,NA,NA,NA
"13528","2017-10-31",1,4,3,7,7,"Yes",1,2,1,3
"13529","2017-11-09",NA,0,0,0,NA,"Yes",NA,NA,NA,NA
"13530","2017-10-31",3,5,6,11,11,"Yes",3,3,2,3
"13531","2017-11-01",3,6,6,12,12,"Yes",2,4,3,3
"13532","2017-11-07",NA,0,0,0,1,NA,NA,NA,NA,NA
"13533","2017-11-08",4,9,8,17,17,"Yes",4,4,3,6
"13534","2017-11-09",1,0,0,0,NA,"Yes",NA,NA,NA,NA
"13535","2017-11-01",1,2,2,4,4,"Yes",0,2,1,1
"13536","2017-11-09",NA,0,0,0,NA,"Yes",NA,NA,NA,NA
"13537","2017-11-07",3,8,6,14,14,"Yes",4,2,3,5
"13538","2017-11-08",1,4,3,7,8,"Yes",2,1,1,3
"13539","2017-10-17",5,14,10,24,24,"Yes",4,6,8,6
"13540","2017-11-01",7,0,0,0,29,"Yes",NA,NA,NA,NA
"13541","2017-11-09",5,0,0,0,19,"Yes",NA,NA,NA,NA
"13542","2017-10-31",1,4,1,5,5,"Yes",1,0,2,2
"13543","2017-11-08",3,8,6,14,14,"Yes",4,2,3,5
"13544","2017-10-14",6,10,13,23,15,"Yes",5,8,4,6
"13545","2017-11-09",1,2,3,5,5,"Yes",0,3,1,1
"13546","2017-11-07",NA,0,0,0,1,NA,NA,NA,NA,NA
"13547","2017-11-07",1,5,7,12,12,"Yes",3,4,2,3
"13548","2017-11-06",5,9,11,20,20,"Yes",5,6,5,4
"13549","2017-11-06",3,7,10,17,17,"Yes",5,5,3,4
"13550","2017-11-07",NA,0,0,0,1,NA,NA,NA,NA,NA
"13551","2017-11-08",1,3,1,4,4,"Yes",0,1,1,2
"13552","2017-11-06",2,5,4,9,9,"No",3,1,2,3
"13553","2017-03-20",5,8,8,16,16,"No",3,5,4,4
"13554","2017-03-20",4,12,3,15,21,"Yes",0,3,6,6
"13555","2017-03-20",3,11,10,21,21,"Yes",6,4,7,4
"13556","2017-03-20",5,8,6,14,15,"No",2,4,4,4
"13557","2017-03-20",8,16,7,23,24,"No",4,3,7,9
"13558","2017-03-20",6,11,5,16,14,"Yes",3,2,3,8
"13559","2017-03-21",10,20,28,48,48,"Yes",11,17,10,10
"13560","2017-03-21",6,10,4,14,15,"Yes",0,4,4,6
"13561","2017-03-21",4,8,3,11,11,"Yes",1,2,4,4
"13562","2017-03-21",12,20,5,25,25,"Yes",2,3,14,6
"13563","2017-03-21",6,9,6,15,18,"Yes",3,3,4,5
"13564","2017-03-21",4,7,3,10,10,"Yes",3,0,4,3
"13565","2017-03-21",7,10,11,21,32,"No",4,7,5,5
"13566","2017-03-21",3,3,5,8,8,"Yes",2,3,1,2
"13567","2017-03-21",13,23,20,43,44,"Yes",16,4,12,11
"13568","2017-03-21",NA,13,300,313,NA,"No",120,180,6,7
"13569","2017-03-21",7,9,7,16,13,"Yes",6,1,5,4
"13570","2017-03-21",7,10,7,17,16,"No",1,6,5,5
"13571","2017-03-21",4,12,6,18,15,"Yes",1,5,7,5
"13572","2017-03-21",4,13,5,18,20,"Yes",3,2,8,5
"13573","2017-03-21",NA,12,0,12,NA,NA,NA,NA,7,5
"13574","2017-03-22",NA,7,5,12,NA,"No",2,3,4,3
"13575","2017-03-22",7,14,24,38,40,"No",6,18,7,7
"13576","2017-03-22",4,10,4,14,20,NA,3,1,4,6
"13577","2017-03-22",8,14,6,20,21,"No",3,3,7,7
"13578","2017-03-22",6,19,3,22,20,"Yes",2,1,11,8
"13579","2017-03-22",3,6,8,14,14,"Yes",5,3,3,3
"13580","2017-03-22",14,28,14,42,46,"Yes",3,11,17,11
"13581",NA,2,4,4,8,8,"Yes",3,1,2,2
"13582","2017-03-22",5,9,6,15,15,"Yes",2,4,5,4
"13583","2017-03-22",1,6,2,8,8,"Yes",1,1,3,3
"13584","2017-03-22",4,5,8,13,13,"Yes",2,6,2,3
"13585","2017-03-22",2,8,3,11,11,"Yes",1,2,4,4
"13586","2017-03-22",5,9,14,23,23,"Yes",8,6,5,4
"13587","2017-03-22",10,20,17,37,39,"Yes",9,8,10,10
"13588","2017-03-22",5,18,9,27,23,"No",6,3,9,9
"13589","2017-03-22",5,12,8,20,20,"Yes",2,6,8,4
"13590","2017-03-22",NA,176,55,231,NA,"No",25,30,98,78
"13591","2017-03-22",4,9,7,16,15,"Yes",5,2,6,3
"13592","2017-03-23",4,12,11,23,23,"Yes",8,3,5,7
"13593","2017-03-23",2,10,4,14,14,"Yes",1,3,6,4
"13594","2017-03-23",2,2,10,12,12,"Yes",4,6,2,NA
"13595","2017-03-23",9,6,6,12,12,"Yes",2,4,2,4
"13596","2017-03-23",5,6,3,9,11,"Yes",2,1,4,2
"13597","2017-03-23",5,10,13,23,26,"No",7,6,5,5
"13598","2017-03-23",6,22,13,35,41,"Yes",7,6,10,12
"13599","2017-03-23",2,7,5,12,13,"Yes",3,2,2,5
"13600","2017-03-23",6,13,15,28,30,"Yes",5,10,6,7
"13601","2017-03-23",4,10,0,10,11,"Yes",0,0,5,5
"13602","2017-03-23",1,5,2,7,7,"Yes",2,NA,2,3
"13603","2017-03-23",2,8,2,10,10,NA,2,0,5,3
"13604","2017-03-29",4,3,9,12,22,"Yes",5,4,1,2
"13605","2017-03-23",12,24,11,35,41,"No",5,6,12,12
"13606","2017-03-23",6,11,5,16,27,"Yes",2,3,6,5
"13607","2017-03-23",NA,55,0,55,NA,"No",NA,NA,30,25
"13608","2017-03-23",7,16,8,24,36,"Yes",4,4,4,12
"13609","2017-03-23",6,12,18,30,34,"No",8,10,6,6
"13610","2017-03-23",11,11,7,18,21,"Yes",1,6,5,6
"13611","2017-03-23",4,11,12,23,21,"Yes",7,5,6,5
"13612","2017-03-30",4,12,7,19,22,"No",2,5,6,6
"13613","2017-03-24",4,9,8,17,15,"Yes",4,4,4,5
"13614","2017-03-24",5,19,11,30,36,"Yes",4,7,11,8
"13615","2017-03-24",1,5,2,7,8,"Yes",0,2,4,1
"13616","2017-03-24",5,10,5,15,15,"Yes",3,2,5,5
"13617","2017-03-24",9,23,9,32,21,"Yes",5,4,15,8
"13618","2017-03-24",6,18,13,31,37,"Yes",6,7,9,9
"13619","2017-03-24",1,6,4,10,10,"Yes",1,3,5,1
"13620","2017-03-24",6,13,14,27,22,"Yes",5,9,4,9
"13621","2017-03-24",11,0,15,15,35,"No",7,8,NA,NA
"13622","2017-03-24",1,5,4,9,9,"No",4,0,4,1
"13623","2017-03-24",13,25,15,40,40,"Yes",8,7,14,11
"13624","2017-03-23",9,14,4,18,18,"Yes",2,2,9,5
"13625","2017-03-24",3,6,6,12,12,"No",2,4,3,3
"13626","2017-03-24",2,12,9,21,15,"Yes",8,1,5,7
"13627","2017-03-24",7,12,6,18,19,"Yes",2,4,7,5
"13628","2017-03-24",2,6,6,12,10,"Yes",4,2,4,2
"13629","2017-03-25",3,10,1,11,11,"Yes",1,0,7,3
"13630","2017-03-25",6,15,13,28,28,"No",4,9,8,7
"13631","2017-03-25",5,7,4,11,26,"Yes",2,2,3,4
"13632","2017-03-25",NA,10,408,418,NA,"Yes",180,228,3,7
"13633","2017-03-25",4,13,5,18,14,"No",3,2,6,7
"13634","2017-03-25",1,8,0,8,8,"Yes",0,0,5,3
"13635","2017-03-25",NA,10,14,24,NA,"Yes",8,6,5,5
"13636","2017-03-25",1,5,5,10,6,"Yes",2,3,3,2
"13637","2017-03-27",3,8,4,12,14,"Yes",2,2,5,3
"13638","2017-03-27",1,2,3,5,7,"Yes",1,2,1,1
"13639",NA,8,11,7,18,15,"No",3,4,5,6
"13640","2017-03-27",NA,270,180,450,NA,"No",80,100,120,150
"13641","2017-03-27",NA,120,0,120,NA,"No",NA,NA,100,20
"13642","2017-03-27",1,5,4,9,9,"Yes",2,2,2,3
"13643","2017-03-27",4,11,9,20,24,"Yes",5,4,7,4
"13644","2017-03-24",5,13,8,21,21,"Yes",3,5,5,8
"13645","2017-03-28",4,4,4,8,8,"Yes",1,3,2,2
"13646","2017-03-28",3,8,9,17,17,"Yes",4,5,4,4
"13647","2017-03-28",3,8,2,10,10,"No",0,2,3,5
"13648","2017-03-28",4,11,4,15,15,"Yes",0,4,5,6
"13649","2017-03-28",1,3,2,5,5,"Yes",2,0,1,2
"13650","2017-03-28",18,13,7,20,20,"Yes",4,3,10,3
"13651","2017-03-28",1,3,5,8,7,"Yes",2,3,2,1
"13652","2017-03-28",6,12,11,23,23,"Yes",3,8,6,6
"13653","2017-03-28",6,10,11,21,21,"Yes",6,5,4,6
"13654","2017-03-28",NA,6,20,26,NA,"No",10,10,2,4
"13655","2017-03-28",9,26,14,40,47,"No",6,8,14,12
"13656","2017-03-28",11,7,6,13,14,"Yes",3,3,2,5
"13657","2017-03-28",4,8,7,15,15,"Yes",4,3,4,4
"13658","2017-03-28",2,4,5,9,9,"Yes",1,4,2,2
"13659","2017-04-04",3,7,0,7,10,"Yes",0,0,5,2
"13660","2017-03-29",NA,22,6,28,NA,NA,3,3,18,4
"13661","2017-03-29",8,16,9,25,25,"No",4,5,8,8
"13662","2017-03-29",4,8,3,11,11,"Yes",2,1,3,5
"13663","2017-03-29",6,10,10,20,17,"Yes",3,7,3,7
"13664","2017-03-29",5,9,12,21,21,"No",7,5,4,5
"13665","2017-03-29",3,6,7,13,13,"Yes",3,4,4,2
"13666","2017-03-29",11,22,13,35,35,"No",5,8,11,11
"13667","2017-03-29",4,9,8,17,13,"Yes",3,5,5,4
"13668","2017-03-29",1,7,1,8,8,"Yes",0,1,1,6
"13669","2017-03-29",7,0,0,0,NA,"Yes",NA,NA,NA,NA
"13670","2017-03-29",4,5,5,10,11,"Yes",2,3,2,3
"13671","2017-03-29",3,4,3,7,7,"Yes",2,1,2,2
"13672","2017-03-30",5,14,12,26,28,"No",7,5,8,6
"13673","2017-03-29",12,21,17,38,38,"Yes",8,9,12,9
"13674","2017-03-29",10,16,84,100,30,NA,84,NA,7,9
"13675","2017-03-29",2,6,3,9,8,"Yes",2,1,3,3
"13676","2017-03-29",2,7,5,12,12,"No",3,2,4,3
"13677","2017-03-29",NA,1150,450,1600,NA,"Yes",200,250,500,650
"13678","2017-03-29",2,0,5,5,10,"Yes",3,2,NA,NA
"13679","2017-03-29",5,9,3,12,12,"Yes",3,0,4,5
"13680","2017-03-29",3,5,7,12,12,"Yes",3,4,2,3
"13681","2017-03-29",5,5,3,8,8,"Yes",3,0,2,3
"13682","2017-03-29",6,17,7,24,26,"No",4,3,9,8
"13683","2017-03-29",3,8,15,23,23,"Yes",7,8,5,3
"13684","2017-03-29",3,5,4,9,9,"Yes",3,1,2,3
"13685","2017-03-30",12,22,10,32,30,"Yes",6,4,12,10
"13686","2017-03-30",14,20,40,60,60,"No",10,30,8,12
"13687","2017-03-30",6,12,5,17,15,"Yes",2,3,6,6
"13688","2017-03-30",3,14,7,21,NA,"Yes",5,2,7,7
"13689","2017-03-30",4,8,6,14,14,"Yes",4,2,4,4
"13690","2017-03-30",10,15,8,23,23,"Yes",5,3,5,10
"13691","2017-03-30",3,6,6,12,12,"Yes",2,4,3,3
"13692","2017-03-30",6,11,6,17,21,"Yes",5,1,3,8
"13693","2017-03-30",7,14,10,24,24,"Yes",6,4,7,7
"13694","2017-03-30",15,33,21,54,NA,"Yes",12,9,18,15
"13695","2017-03-30",1,4,0,4,4,"Yes",0,0,2,2
"13696","2017-03-30",3,9,3,12,10,"Yes",2,1,3,6
"13697","2017-03-30",6,20,12,32,NA,"Yes",6,6,8,12
"13698","2017-03-30",10,14,4,18,15,"Yes",0,4,8,6
"13699","2017-03-30",1,3,0,3,3,"Yes",0,0,1,2
"13700","2017-03-30",3,11,2,13,6,"Yes",1,1,6,5
"13701","2017-03-31",7,20,7,27,NA,"Yes",2,5,12,8
"13702","2017-03-31",3,6,5,11,11,"Yes",2,3,3,3
"13703","2017-03-31",4,10,10,20,25,"Yes",3,7,6,4
"13704","2017-03-31",4,13,5,18,19,"Yes",2,3,6,7
"13705","2017-03-31",5,11,3,14,14,"Yes",2,1,8,3
"13706","2017-03-31",3,7,7,14,14,"Yes",3,4,5,2
"13707","2017-03-31",2,4,4,8,8,"Yes",1,3,2,2
"13708","2017-03-31",4,7,5,12,12,"No",2,3,4,3
"13709","2017-03-31",2,6,6,12,11,"No",2,4,2,4
"13710","2017-03-31",5,4,0,4,7,NA,0,0,1,3
"13711","2017-03-31",NA,330,88,418,NA,"Yes",58,30,200,130
"13712","2017-03-31",4,7,1,8,10,"Yes",1,0,3,4
"13713","2017-03-31",NA,40,0,40,NA,"Yes",NA,NA,25,15
"13714","2017-03-31",1,2,6,8,8,"Yes",6,0,1,1
"13715","2017-03-31",NA,35,0,35,NA,NA,0,0,15,20
"13716","2017-03-31",3,8,5,13,13,"Yes",3,2,3,5
"13717","2017-03-31",5,10,11,21,21,"No",8,3,5,5
"13718","2017-03-31",3,8,5,13,13,"Yes",2,3,3,5
"13719","2017-03-31",2,5,5,10,10,"Yes",2,3,3,2
"13720","2017-03-31",9,22,1,23,29,"Yes",1,0,10,12
"13721","2017-03-31",11,60,70,130,130,"Yes",40,30,30,30
"13722","2017-03-31",4,4,5,9,9,"Yes",4,1,2,2
"13723","2017-04-01",NA,246,95,341,NA,"Yes",52,43,96,150
"13724","2017-04-01",8,13,4,17,17,"No",4,NA,7,6
"13725",NA,4,4,2,6,14,"Yes",0,2,2,2
"13726","2017-04-01",6,12,7,19,25,"No",3,4,6,6
"13727","2017-04-01",4,25,2,27,15,"Yes",1,1,12,13
"13728","2017-04-01",6,12,6,18,NA,"Yes",4,2,7,5
"13729","2017-04-01",3,6,2,8,6,"Yes",2,0,3,3
"13730","2017-04-01",5,9,11,20,20,"Yes",5,6,4,5
"13731","2017-04-01",8,20,15,35,35,"Yes",5,10,10,10
"13732","2017-04-01",4,6,4,10,10,"Yes",1,3,4,2
"13733","2017-04-01",5,10,11,21,22,"Yes",4,7,6,4
"13734","2017-04-01",1,4,3,7,7,"Yes",2,1,2,2
"13735","2017-04-03",3,6,11,17,17,"Yes",5,6,3,3
"13736","2017-04-03",6,10,8,18,18,"Yes",4,4,4,6
"13737","2017-04-03",7,14,11,25,NA,"No",2,9,7,7
"13738","2017-04-03",NA,65,5974,6039,NA,"No",2971,3003,6,59
"13739","2017-04-03",5,10,14,24,24,"Yes",6,8,5,5
"13740","2017-04-03",4,10,5,15,15,"Yes",2,3,5,5
"13741","2017-04-03",3,6,9,15,15,"Yes",4,5,3,3
"13742","2017-04-03",5,14,8,22,21,"No",5,3,5,9
"13743","2017-04-03",4,8,7,15,15,"Yes",3,4,4,4
"13744","2017-04-03",3,7,7,14,14,"Yes",5,2,3,4
"13745","2017-04-03",2,12,5,17,17,"Yes",2,3,9,3
"13746","2017-04-03",1,6,3,9,9,"Yes",NA,3,3,3
"13747","2017-04-03",2,12,4,16,16,"Yes",3,1,5,7
"13748","2017-04-03",2,7,2,9,9,"Yes",0,2,3,4
"13749","2017-04-03",9,11,5,16,16,"No",3,2,5,6
"13750","2017-04-03",1,5,2,7,7,"No",2,NA,3,2
"13751","2017-04-03",3,10,4,14,NA,"Yes",2,2,3,7
"13752","2017-04-03",2,4,3,7,7,"Yes",2,1,1,3
"13753","2017-04-03",3,6,6,12,12,"Yes",4,2,2,4
"13754","2017-04-03",6,8,12,20,20,"No",5,7,3,5
"13755","2017-04-03",3,6,9,15,15,"No",4,5,3,3
"13756","2017-04-03",2,4,8,12,8,"No",4,4,1,3
"13757","2017-04-04",1,5,3,8,8,"Yes",1,2,2,3
"13758","2017-04-04",5,10,18,28,28,"No",7,11,5,5
"13759","2017-04-04",6,12,13,25,25,"Yes",4,9,6,6
"13760","2017-04-04",8,16,9,25,28,"Yes",3,6,8,8
"13761","2017-04-04",2,7,3,10,10,"No",1,2,3,4
"13762","2017-04-04",7,20,10,30,30,"Yes",4,6,7,13
"13763","2017-04-04",5,12,10,22,22,"Yes",5,5,7,5
"13764","2017-04-04",4,7,10,17,17,"Yes",5,5,5,2
"13765","2017-04-04",11,22,8,30,30,"Yes",2,6,11,11
"13766","2017-04-04",2,3,2,5,9,"Yes",1,1,1,2
"13767","2017-04-04",7,14,25,39,29,"No",13,12,7,7
"13768","2017-04-04",9,15,20,35,35,"Yes",10,10,5,10
"13769","2017-04-04",4,7,5,12,12,"No",2,3,4,3
"13770","2017-04-04",7,0,0,0,7,"Yes",0,0,NA,NA
"13771",NA,9,0,0,0,NA,"Yes",NA,NA,NA,NA
"13772","2017-04-04",6,12,12,24,24,"No",5,7,6,6
"13773","2017-04-04",3,8,5,13,13,"Yes",4,1,2,6
"13774","2017-04-04",2,7,6,13,19,"Yes",6,0,2,5
"13775","2017-04-04",NA,2,5,7,NA,"Yes",4,1,1,1
"13776","2017-04-04",1,3,3,6,6,"Yes",2,1,2,1
"13777","2017-04-04",2,7,3,10,11,"No",2,1,5,2
"13778","2017-04-04",2,4,7,11,11,"Yes",1,6,2,2
"13779","2017-04-04",5,20,15,35,35,"Yes",8,7,10,10
"13780","2017-04-04",4,14,10,24,24,"Yes",4,6,7,7
"13781","2017-04-04",2,3,4,7,7,"Yes",2,2,2,1
"13782","2017-04-04",4,8,13,21,20,"Yes",5,8,4,4
"13783","2017-04-04",NA,145,49,194,NA,"No",23,26,56,89
"13784","2017-04-04",6,14,10,24,24,"Yes",5,5,9,5
"13785","2017-04-04",4,8,2,10,10,"Yes",1,1,6,2
"13786","2017-04-04",2,4,4,8,8,"Yes",2,2,3,1
"13787","2017-04-04",1,5,0,5,5,"Yes",NA,NA,2,3
"13788","2017-04-04",3,7,7,14,15,"No",4,3,4,3
"13789","2017-04-04",2,8,5,13,13,"No",1,4,2,6
"13790","2017-04-04",17,35,47,82,80,"Yes",22,25,20,15
"13791","2017-04-04",1,2,4,6,6,"Yes",0,4,1,1
"13792","2017-04-04",10,26,26,52,58,"Yes",11,15,10,16
"13793","2017-04-05",2,4,5,9,9,"No",2,3,1,3
"13794","2017-04-05",5,15,10,25,25,"Yes",4,6,5,10
"13795","2017-04-05",1,5,0,5,5,"Yes",NA,0,3,2
"13796","2017-04-05",5,8,7,15,NA,"Yes",5,2,4,4
"13797","2017-04-05",3,11,4,15,15,"No",1,3,5,6
"13798","2017-04-05",5,8,4,12,17,"No",1,3,4,4
"13799","2017-04-05",4,10,7,17,17,"No",4,3,6,4
"13800","2017-04-05",9,15,20,35,35,"Yes",10,10,10,5
"13801","2017-04-05",NA,6,92,98,NA,"No",44,48,3,3
"13802","2017-04-05",1,3,5,8,8,"Yes",3,2,2,1
"13803","2017-04-05",5,10,6,16,24,"No",4,2,4,6
"13804","2017-04-05",5,0,0,0,NA,"Yes",NA,NA,NA,NA
"13805","2017-04-05",1,2,6,8,8,"Yes",2,4,1,1
"13806","2017-04-05",3,10,7,17,17,"Yes",3,4,5,5
"13807","2017-04-05",NA,110,20,130,NA,"Yes",10,10,40,70
"13808","2017-04-05",5,10,4,14,14,"Yes",2,2,5,5
"13809","2017-04-05",1,2,2,4,4,"No",0,2,1,1
"13810","2017-04-05",4,4,5,9,21,"Yes",1,4,2,2
"13811","2017-04-05",4,14,5,19,15,"Yes",2,3,5,9
"13812","2017-04-05",5,8,9,17,17,"Yes",4,5,4,4
"13813","2017-04-05",6,12,9,21,14,"Yes",3,6,9,3
"13814","2017-04-06",6,12,8,20,34,"Yes",6,2,6,6
"13815","2017-04-06",NA,50,15,65,NA,"Yes",7,8,20,30
"13816","2017-04-06",3,7,8,15,15,"No",3,5,2,5
"13817","2017-04-06",10,20,29,49,45,"Yes",13,16,10,10
"13818","2017-04-06",9,16,9,25,25,"Yes",6,3,8,8
"13819",NA,2,5,5,10,10,"Yes",3,2,3,2
"13820","2017-04-06",NA,280,0,280,NA,"Yes",0,0,200,80
"13821","2017-04-06",2,4,6,10,16,"Yes",3,3,2,2
"13822","2017-04-06",7,14,31,45,45,"No",16,15,7,7
"13823","2017-04-06",2,6,3,9,9,"Yes",3,NA,2,4
"13824","2017-04-13",1,8,4,12,12,"Yes",2,2,3,5
"13825","2017-04-06",2,7,7,14,14,"Yes",5,2,2,5
"13826","2017-04-06",4,12,7,19,19,"Yes",4,3,4,8
"13827","2017-04-06",2,12,2,14,14,"No",1,1,7,5
"13828","2017-04-06",6,12,10,22,22,"Yes",6,4,6,6
"13829","2017-04-06",7,10,10,20,24,"Yes",4,6,5,5
"13830","2017-04-06",9,18,16,34,24,"No",8,8,7,11
"13831","2017-04-06",4,8,6,14,15,"Yes",1,5,3,5
"13832","2017-04-06",13,33,20,53,53,"No",10,10,13,20
"13833","2017-04-06",3,5,7,12,13,"Yes",5,2,2,3
"13834","2017-04-06",8,16,19,35,35,"Yes",12,7,8,8
"13835","2017-04-07",1,5,5,10,10,"Yes",4,1,3,2
"13836","2017-04-07",3,6,4,10,10,"Yes",2,2,4,2
"13837","2017-04-07",7,16,11,27,24,"Yes",6,5,7,9
"13838","2017-04-07",8,15,15,30,30,"Yes",5,10,2,13
"13839","2017-04-07",6,12,9,21,22,"No",4,5,6,6
"13840","2017-04-07",10,21,1,22,NA,"Yes",0,1,11,10
"13841","2017-04-07",13,25,12,37,37,"No",7,5,13,12
"13842","2017-04-07",7,14,11,25,25,"No",6,5,7,7
"13843","2017-04-07",NA,55,15,70,NA,"No",5,10,10,45
"13844","2017-04-07",13,26,32,58,58,"Yes",12,20,13,13
"13845","2017-04-04",5,10,9,19,19,"No",3,6,5,5
"13846","2017-04-07",8,21,15,36,36,"Yes",7,8,10,11
"13847","2017-04-07",4,14,19,33,19,"No",10,9,7,7
"13848","2017-04-07",5,13,6,19,19,"Yes",3,3,6,7
"13849","2017-04-07",5,10,10,20,20,"Yes",3,7,5,5
"13850","2017-04-07",4,11,9,20,25,"Yes",6,3,4,7
"13851","2017-04-07",2,7,4,11,11,"Yes",3,1,4,3
"13852","2017-04-07",5,13,10,23,23,"No",5,5,6,7
"13853","2017-04-07",4,8,5,13,13,"No",5,NA,4,4
"13854","2017-04-07",4,12,13,25,25,"No",6,7,4,8
"13855","2017-04-07",3,8,5,13,13,"No",2,3,3,5
"13856","2017-04-07",1,3,2,5,5,"Yes",1,1,1,2
"13857","2017-04-07",1,9,3,12,12,"Yes",2,1,4,5
"13858","2017-04-07",6,14,13,27,27,"Yes",5,8,7,7
"13859","2017-04-07",2,5,7,12,11,"Yes",5,2,2,3
"13860","2017-04-07",4,15,10,25,25,"Yes",6,4,9,6
"13861","2017-04-08",5,20,7,27,26,"Yes",4,3,8,12
"13862","2017-04-08",2,7,4,11,12,"Yes",2,2,4,3
"13863","2017-04-08",3,12,5,17,17,"Yes",4,1,6,6
"13864","2017-04-08",2,5,6,11,11,"No",5,1,2,3
"13865","2017-04-08",4,13,7,20,20,"Yes",4,3,5,8
"13866","2017-04-08",1,2,5,7,7,"Yes",2,3,1,1
"13867","2017-04-08",9,18,4,22,22,"Yes",1,3,12,6
"13868","2017-04-08",6,10,13,23,23,"Yes",5,8,5,5
"13869","2017-04-08",6,13,23,36,40,"No",2,21,8,5
"13870","2017-04-08",3,7,7,14,14,"Yes",2,5,3,4
"13871","2017-04-08",NA,55,297,352,NA,"Yes",112,185,25,30
"13872","2017-04-08",1,5,0,5,5,"Yes",NA,NA,2,3
"13873","2017-04-08",1,4,5,9,8,"Yes",2,3,3,1
"13874","2017-04-08",3,6,5,11,13,"Yes",2,3,3,3
"13875","2017-04-08",3,9,8,17,17,"Yes",4,4,4,5
"13876","2017-04-08",NA,7,10,17,NA,"No",6,4,4,3
"13877","2017-04-08",8,16,32,48,48,"No",12,20,8,8
"13878","2017-04-08",6,12,8,20,20,"Yes",2,6,5,7
"13879","2017-04-08",2,7,3,10,14,"Yes",2,1,3,4
"13880","2017-04-08",3,15,7,22,22,"Yes",6,1,8,7
"13881","2017-04-08",3,7,3,10,17,"No",1,2,2,5
"13882","2017-04-08",6,14,9,23,NA,"Yes",7,2,8,6
"13883","2017-04-08",1,4,0,4,4,"Yes",NA,NA,3,1
"13884","2017-04-08",4,8,10,18,18,"No",7,3,4,4
"13885","2017-04-08",4,6,5,11,14,"Yes",1,4,3,3
"13886","2017-04-08",4,7,9,16,16,"Yes",2,7,2,5
"13887","2017-04-08",27,48,17,65,65,"Yes",10,7,20,28
"13888","2017-04-10",6,10,30,40,40,"No",10,20,4,6
"13889","2017-04-10",5,10,11,21,23,"Yes",6,5,5,5
"13890","2017-04-10",7,13,13,26,26,"Yes",8,5,6,7
"13891","2017-04-10",7,21,19,40,39,"Yes",11,8,9,12
"13892","2017-04-10",NA,18,110,128,NA,"Yes",50,60,10,8
"13893","2017-04-10",4,0,0,0,25,"Yes",NA,NA,NA,NA
"13894","2017-04-10",4,9,8,17,18,"Yes",3,5,4,5
"13895","2017-04-10",7,15,17,32,32,"Yes",9,8,7,8
"13896","2017-04-10",5,12,16,28,24,"Yes",11,5,5,7
"13897","2017-04-10",3,6,2,8,7,"Yes",1,1,3,3
"13898","2017-04-10",4,9,4,13,13,"No",2,2,6,3
"13899","2017-04-10",2,4,6,10,10,"Yes",5,1,2,2
"13900","2017-04-10",4,11,3,14,14,"Yes",1,2,5,6
"13901","2017-04-10",10,20,7,27,27,"Yes",3,4,10,10
"13902","2017-04-10",1,1,3,4,4,"Yes",1,2,0,1
"13903","2017-04-11",5,13,22,35,32,"Yes",9,13,5,8
"13904","2017-04-11",17,34,38,72,64,"No",18,20,17,17
"13905","2017-04-11",11,20,30,50,40,"No",15,15,5,15
"13906","2017-04-11",6,14,6,20,30,"Yes",3,3,7,7
"13907","2017-04-11",12,10,20,30,30,"Yes",8,12,4,6
"13908","2017-04-11",7,11,16,27,25,"Yes",9,7,5,6
"13909","2017-04-11",10,5,20,25,25,"Yes",8,12,1,4
"13910","2017-04-11",8,16,9,25,24,"Yes",6,3,6,10
"13911","2017-04-11",4,12,13,25,25,"Yes",8,5,6,6
"13912","2017-04-11",10,20,17,37,37,"No",8,9,10,10
"13913","2017-04-11",7,10,30,40,40,"No",10,20,4,6
"13914","2017-04-11",1,20,370,390,390,"Yes",170,200,10,10
"13915","2017-04-11",2,5,5,10,7,"Yes",NA,5,3,2
"13916","2017-04-11",2,3,5,8,8,"Yes",2,3,2,1
"13917","2017-04-11",5,13,17,30,30,"Yes",11,6,5,8
"13918","2017-04-11",16,22,13,35,45,"Yes",5,8,10,12
"13919","2017-04-11",4,8,2,10,10,"Yes",1,1,4,4
"13920","2017-04-11",6,7,18,25,35,"Yes",10,8,2,5
"13921","2017-04-12",8,16,4,20,25,"Yes",1,3,8,8
"13922","2017-04-10",8,18,10,28,29,"No",3,7,8,10
"13923","2017-04-11",8,11,2,13,13,"Yes",1,1,6,5
"13924","2017-04-11",NA,300,85,385,NA,"No",40,45,130,170
"13925","2017-04-11",NA,471,87,558,NA,"No",39,48,203,268
"13926","2017-04-11",7,15,35,50,50,"No",15,20,5,10
"13927","2017-04-12",NA,53,41,94,NA,"No",21,20,15,38
"13928","2017-04-12",12,10,18,28,28,"Yes",8,10,4,6
"13929","2017-04-19",2,3,5,8,8,"No",3,2,2,1
"13930","2017-04-12",4,8,8,16,15,"No",6,2,4,4
"13931","2017-04-12",5,17,13,30,30,"Yes",6,7,9,8
"13932","2017-04-12",3,7,4,11,11,"Yes",1,3,4,3
"13933","2017-04-12",2,2,6,8,8,"Yes",2,4,1,1
"13934","2017-04-12",6,15,4,19,19,"Yes",3,1,8,7
"13935","2017-04-12",12,20,12,32,34,"Yes",7,5,12,8
"13936","2017-04-12",3,11,5,16,14,"Yes",0,5,4,7
"13937","2017-04-12",6,10,8,18,18,"No",4,4,4,6
"13938","2017-04-12",1,1,1,2,2,"Yes",1,0,0,1
"13939","2017-04-06",13,26,13,39,36,"Yes",6,7,13,13
"13940","2017-04-12",7,10,30,40,30,"No",10,20,4,6
"13941","2017-04-13",10,20,35,55,54,"No",14,21,11,9
"13942","2017-04-13",8,16,0,16,16,"Yes",NA,NA,8,8
"13943","2017-04-13",5,11,9,20,20,"Yes",3,6,6,5
"13944","2017-04-13",NA,75,33,108,NA,"No",15,18,35,40
"13945","2017-04-13",3,5,10,15,15,"Yes",4,6,2,3
"13946","2017-04-13",2,2,21,23,23,"Yes",3,18,1,1
"13947","2017-04-13",1,6,3,9,9,"Yes",2,1,3,3
"13948","2017-04-13",2,7,7,14,14,"Yes",4,3,5,2
"13949","2017-04-14",13,0,0,0,NA,"Yes",NA,NA,NA,NA
"13950","2017-04-14",9,14,16,30,30,"Yes",10,6,5,9
"13951","2017-04-14",8,19,9,28,28,"Yes",4,5,8,11
"13952","2017-04-14",12,15,25,40,40,"Yes",10,15,5,10
"13953","2017-04-14",15,29,16,45,45,"No",9,7,14,15
"13954","2017-04-14",10,16,10,26,NA,"Yes",7,3,10,6
"13955","2017-04-14",NA,180,80,260,NA,"No",50,30,80,100
"13956","2017-04-14",5,11,9,20,20,"Yes",3,6,2,9
"13957","2017-04-14",3,10,12,22,24,"No",6,6,5,5
"13958","2017-04-14",9,18,12,30,30,"Yes",2,10,9,9
"13959","2017-04-14",2,8,2,10,7,"Yes",1,1,3,5
"13960",NA,5,12,8,20,17,"Yes",5,3,7,5
"13961","2017-04-14",9,13,9,22,22,"Yes",4,5,9,4
"13962","2017-04-14",4,4,8,12,12,"Yes",3,5,2,2
"13963","2017-04-14",10,20,20,40,40,"Yes",8,12,10,10
"13964","2017-04-17",4,10,4,14,14,"Yes",1,3,4,6
"13965","2017-04-17",4,9,7,16,16,"Yes",3,4,4,5
"13966","2017-04-17",6,12,9,21,19,"No",4,5,6,6
"13967","2017-04-17",6,9,9,18,NA,"Yes",6,3,6,3
"13968","2017-04-17",4,11,3,14,16,"Yes",2,1,5,6
"13969","2017-04-17",6,14,11,25,25,"Yes",5,6,8,6
"13970","2017-04-17",6,13,7,20,27,"Yes",3,4,6,7
"13971","2017-04-17",2,8,3,11,10,"Yes",2,1,4,4
"13972","2017-04-17",10,25,11,36,36,"Yes",6,5,10,15
"13973","2017-04-17",NA,40,167,207,NA,"No",82,85,15,25
"13974","2017-04-17",2,5,2,7,7,"Yes",1,1,3,2
"13975","2017-04-18",3,8,10,18,19,"Yes",6,4,3,5
"13976","2017-04-18",3,8,2,10,12,"Yes",1,1,5,3
"13977","2017-04-18",8,13,17,30,30,"Yes",8,9,7,6
"13978","2017-04-18",4,8,8,16,14,"Yes",2,6,4,4
"13979","2017-04-18",7,13,5,18,19,"Yes",2,3,7,6
"13980","2017-04-18",9,18,22,40,45,"Yes",12,10,9,9
"13981","2017-04-18",5,8,11,19,14,"No",7,4,4,4
"13982","2017-04-18",3,5,2,7,7,"Yes",2,0,4,1
"13983","2017-04-18",NA,19,540,559,NA,"Yes",250,290,8,11
"13984","2017-04-18",3,5,10,15,15,"No",5,5,2,3
"13985","2017-04-18",7,14,11,25,25,"Yes",6,5,7,7
"13986","2017-04-18",5,10,17,27,27,"Yes",7,10,5,5
"13987","2017-04-18",5,10,11,21,21,"Yes",5,6,5,5
"13988","2017-04-18",11,22,5,27,29,"Yes",2,3,12,10
"13989","2017-04-18",7,16,13,29,29,"Yes",7,6,8,8
"13990","2017-04-18",4,10,9,19,24,"Yes",4,5,4,6
"13991","2017-04-18",7,14,9,23,24,"Yes",3,6,7,7
"13992","2017-04-18",4,5,20,25,25,"No",10,10,2,3
"13993","2017-04-10",2,7,6,13,13,"Yes",2,4,3,4
"13994","2017-04-19",5,14,6,20,NA,"No",4,2,6,8
"13995","2017-04-19",NA,18,600,618,NA,"No",250,350,8,10
"13996","2017-04-19",4,11,7,18,18,"Yes",4,3,4,7
"13997","2017-04-19",1,3,4,7,8,"Yes",1,3,1,2
"13998","2017-04-19",NA,17,8193,8210,NA,"No",2561,5632,8,9
"13999","2017-04-19",1,7,1,8,8,"Yes",1,0,3,4
"14000","2017-04-19",7,14,7,21,20,"No",3,4,7,7
"14001","2017-04-20",3,11,11,22,22,"Yes",5,6,3,8
"14002","2017-04-20",5,11,5,16,16,"Yes",3,2,5,6
"14003","2017-04-20",4,8,12,20,20,"No",5,7,4,4
"14004","2017-04-20",3,5,4,9,7,"Yes",2,2,2,3
"14005","2017-04-20",3,8,4,12,14,"Yes",2,2,5,3
"14006","2017-10-13",NA,2,7,9,NA,"No",1,6,1,1
"14007","2017-10-14",4,8,12,20,20,"Yes",4,8,4,4
"14008","2017-10-14",5,11,10,21,21,"Yes",4,6,5,6
"14009","2017-10-14",NA,70,50,120,NA,"Yes",20,30,30,40
"14010","2017-10-14",6,16,6,22,22,"Yes",4,2,7,9
"14011","2017-10-14",6,14,15,29,29,"No",6,9,6,8
"14012","2017-10-14",8,16,17,33,31,"Yes",8,9,6,10
"14013","2017-10-14",7,16,24,40,40,"No",11,13,6,10
"14014","2017-10-14",9,19,26,45,45,"Yes",14,12,9,10
"14015","2017-10-14",7,17,14,31,31,"Yes",6,8,7,10
"14016","2017-10-14",4,8,10,18,21,"No",6,4,3,5
"14017","2017-10-14",NA,10,14,24,NA,"No",6,8,3,7
"14018","2017-10-14",6,19,10,29,29,"Yes",6,4,4,15
"14019","2017-10-14",3,8,6,14,14,"Yes",0,6,5,3
"14020","2017-10-14",2,5,5,10,10,"Yes",2,3,2,3
"14021","2017-10-14",3,10,4,14,14,"Yes",2,2,6,4
"14022","2017-10-14",5,12,7,19,6,"Yes",4,3,7,5
"14023","2017-10-16",NA,393,76,469,NA,"Yes",45,31,183,210
"14024","2017-10-16",2,13,3,16,12,"Yes",1,2,6,7
"14025","2017-10-16",3,7,23,30,32,"Yes",1,22,1,6
"14026","2017-10-16",NA,10,5,15,NA,"Yes",3,2,6,4
"14027","2017-10-16",NA,85,0,85,NA,"No",NA,NA,40,45
"14028","2017-10-16",NA,108,0,108,NA,"Yes",0,0,48,60
"14029","2017-10-16",6,14,10,24,25,"No",6,4,7,7
"14030","2017-10-16",8,11,10,21,22,"Yes",2,8,6,5
"14031","2017-10-23",5,7,6,13,5,"No",2,4,6,1
"14032","2017-10-16",6,15,10,25,25,"Yes",4,6,7,8
"14033","2017-10-16",3,10,8,18,20,"Yes",1,7,4,6
"14034","2017-10-16",7,13,7,20,7,"Yes",5,2,7,6
"14035","2017-10-16",2,4,3,7,7,"Yes",2,1,1,3
"14036","2017-10-16",9,15,6,21,21,"Yes",4,2,5,10
"14037","2017-10-16",1,5,3,8,8,"Yes",2,1,2,3
"14038","2017-10-16",5,10,10,20,15,"Yes",5,5,5,5
"14039","2017-10-16",5,19,10,29,29,"Yes",5,5,8,11
"14040","2017-10-16",4,11,4,15,15,"Yes",1,3,4,7
"14041","2017-10-16",3,8,13,21,21,"Yes",5,8,4,4
"14042","2017-10-16",3,16,9,25,21,"Yes",4,5,10,6
"14043","2017-10-16",NA,12,130,142,NA,"No",58,72,4,8
"14044","2017-10-16",2,5,3,8,8,"Yes",1,2,4,1
"14045","2017-10-16",6,10,15,25,25,"Yes",5,10,4,6
"14046","2017-10-16",6,8,5,13,14,"Yes",2,3,4,4
"14047","2017-10-16",4,15,3,18,18,"Yes",1,2,5,10
"14048","2017-10-14",NA,140,45,185,NA,"No",20,25,70,70
"14049","2017-10-16",NA,3,45,48,NA,NA,20,25,1,2
"14050","2017-10-16",NA,0,0,0,NA,"No",NA,NA,NA,NA
"14051","2017-10-16",NA,295,80,375,NA,"No",30,50,125,170
"14052","2017-10-16",9,26,27,53,50,"Yes",12,15,8,18
"14053","2017-10-16",9,20,20,40,40,"Yes",10,10,15,5
"14054","2017-10-16",3,8,8,16,16,"Yes",3,5,4,4
"14055","2017-10-16",7,18,11,29,27,"No",4,7,10,8
"14056","2017-10-16",NA,330,0,330,NA,"Yes",NA,NA,80,250
"14057","2017-10-16",NA,10,100,110,NA,"No",45,55,4,6
"14058","2017-10-17",4,9,10,19,20,"Yes",4,6,4,5
"14059","2017-10-17",8,6,9,15,15,"Yes",5,4,3,3
"14060","2017-10-17",14,19,25,44,46,"No",10,15,9,10
"14061","2017-10-17",3,7,5,12,13,"No",2,3,3,4
"14062","2017-10-17",1,5,4,9,9,"No",0,4,3,2
"14063","2017-10-17",6,10,5,15,20,"Yes",3,2,5,5
"14064","2017-10-17",3,8,3,11,11,"Yes",3,0,6,2
"14065","2017-10-17",2,5,9,14,13,"Yes",7,2,2,3
"14066","2017-10-17",7,16,5,21,18,"Yes",2,3,7,9
"14067","2017-10-17",11,11,14,25,25,"Yes",7,7,3,8
"14068","2017-10-17",5,13,5,18,18,"No",2,3,5,8
"14069","2017-10-17",NA,7,3,10,NA,"No",2,1,4,3
"14070","2017-10-17",8,17,10,27,27,"Yes",3,7,7,10
"14071","2017-10-17",2,8,10,18,16,"No",8,2,3,5
"14072","2017-10-17",7,19,21,40,24,"No",9,12,9,10
"14073","2017-10-17",5,10,13,23,23,"Yes",5,8,5,5
"14074","2017-10-17",NA,0,0,0,NA,"No",NA,NA,NA,NA
"14075","2017-10-17",5,5,11,16,6,"Yes",5,6,4,1
"14076","2017-10-17",2,6,5,11,11,"Yes",1,4,2,4
"14077","2017-10-17",4,10,7,17,17,"No",5,2,5,5
"14078","2017-10-17",NA,20,10,30,NA,"No",4,6,12,8
"14079","2017-10-17",3,4,6,10,10,"Yes",1,5,2,2
"14080","2017-10-17",NA,50,0,50,NA,"No",0,0,40,10
"14081","2017-10-17",5,8,7,15,15,"No",3,4,3,5
"14082","2017-10-17",5,8,12,20,20,"No",8,4,3,5
"14083","2017-10-17",3,7,8,15,15,"Yes",3,5,3,4
"14084","2017-10-17",NA,7,0,7,NA,"No",0,0,4,3
"14085","2017-10-17",NA,0,0,0,NA,"Yes",NA,NA,NA,NA
"14086","2017-10-17",NA,12,250,262,NA,"No",100,150,6,6
"14087","2017-10-17",NA,0,0,0,NA,"No",NA,NA,NA,NA
"14088","2017-10-17",6,18,15,33,32,"Yes",6,9,8,10
"14089","2017-10-17",4,7,5,12,12,"No",1,4,4,3
"14090","2017-10-17",3,5,4,9,9,"Yes",2,2,3,2
"14091","2017-10-17",3,4,5,9,9,"Yes",2,3,2,2
"14092","2017-10-17",5,19,21,40,38,NA,13,8,9,10
"14093","2017-10-17",5,13,10,23,23,"No",6,4,4,9
"14094","2017-10-16",4,0,0,0,NA,"Yes",NA,NA,NA,NA
"14095","2017-10-16",1,2,3,5,5,"Yes",NA,3,1,1
"14096","2017-10-14",4,8,12,20,20,"Yes",5,7,4,4
"14097","2017-10-14",5,7,13,20,20,"No",9,4,2,5
"14098","2017-10-17",8,9,15,24,24,"Yes",9,6,5,4
"14099","2017-10-18",2,5,5,10,10,"No",1,4,2,3
"14100","2017-10-18",9,13,20,33,31,"Yes",9,11,7,6
"14101","2017-10-18",5,17,4,21,21,"Yes",2,2,9,8
"14102","2017-10-18",5,8,9,17,17,"Yes",3,6,5,3
"14103","2017-10-18",2,7,1,8,8,"Yes",1,0,4,3
"14104","2017-10-18",7,12,10,22,22,"Yes",5,5,5,7
"14105","2017-10-18",3,6,11,17,17,"No",7,4,3,3
"14106","2017-10-18",1,4,3,7,7,"Yes",1,2,2,2
"14107","2017-10-18",5,17,16,33,23,"No",6,10,8,9
"14108","2017-10-18",2,9,5,14,14,"No",3,2,4,5
"14109","2017-10-19",1,10,7,17,17,"Yes",3,4,6,4
"14110","2017-10-17",5,9,4,13,15,"Yes",3,1,4,5
"14111","2017-10-17",4,6,5,11,12,"No",2,3,3,3
"14112","2017-10-18",1,2,5,7,8,"No",3,2,1,1
"14113","2017-10-19",2,7,5,12,12,"Yes",2,3,4,3
"14114","2017-10-19",5,13,6,19,19,"No",3,3,7,6
"14115","2017-10-19",9,14,11,25,24,"Yes",3,8,5,9
"14116","2017-10-19",1,4,2,6,6,"Yes",1,1,2,2
"14117","2017-10-19",NA,320,0,320,NA,"No",NA,NA,200,120
"14118","2017-10-19",2,4,4,8,9,"Yes",3,1,2,2
"14119","2017-10-19",NA,328,0,328,NA,"Yes",NA,NA,128,200
"14120","2017-10-19",NA,6,0,6,NA,"No",0,0,3,3
"14121","2017-10-19",7,8,1,9,9,"Yes",NA,1,3,5
"14122","2017-10-19",5,6,4,10,10,NA,2,2,3,3
"14123","2017-10-19",5,6,6,12,12,"Yes",4,2,3,3
"14124","2017-10-19",1,2,3,5,5,"Yes",3,0,1,1
"14125","2017-10-19",2,4,7,11,12,"Yes",5,2,2,2
"14126","2017-10-19",1,3,4,7,8,"Yes",1,3,1,2
"14127","2017-10-19",1,2,5,7,7,"Yes",0,5,1,1
"14128","2017-10-19",NA,4,0,4,NA,"No",0,0,2,2
"14129","2017-10-19",3,6,6,12,14,"Yes",2,4,3,3
"14130","2017-10-19",7,11,14,25,25,"No",8,6,4,7
"14131","2017-10-19",2,6,3,9,9,"Yes",2,1,3,3
"14132","2017-10-19",9,17,16,33,33,"Yes",8,8,8,9
"14133","2017-10-19",4,6,5,11,11,"Yes",2,3,4,2
"14134","2017-10-19",5,7,7,14,14,"Yes",7,0,5,2
"14135","2017-10-19",4,7,3,10,10,"No",2,1,4,3
"14136","2017-10-20",10,23,14,37,30,"Yes",6,8,9,14
"14137","2017-10-20",4,9,7,16,15,"Yes",4,3,5,4
"14138","2017-10-20",5,9,3,12,12,"Yes",2,1,4,5
"14139","2017-10-20",6,13,6,19,17,"Yes",2,4,4,9
"14140","2017-10-20",6,13,14,27,29,"Yes",5,9,6,7
"14141","2017-10-20",4,9,3,12,14,"Yes",0,3,5,4
"14142","2017-10-19",NA,2,6,8,NA,"No",3,3,1,1
"14143","2017-10-20",1,2,6,8,8,"Yes",2,4,1,1
"14144","2017-10-20",4,11,11,22,22,"Yes",5,6,4,7
"14145","2017-10-20",2,6,9,15,14,"No",2,7,2,4
"14146","2017-10-20",1,2,2,4,4,"Yes",1,1,1,1
"14147","2017-10-20",4,16,8,24,22,"No",3,5,8,8
"14148","2017-10-20",3,7,6,13,13,"No",2,4,3,4
"14149","2017-10-20",12,19,16,35,56,"No",8,8,9,10
"14150","2017-10-20",2,9,4,13,13,"Yes",2,2,4,5
"14151","2017-10-20",1,2,5,7,7,"Yes",1,4,1,1
"14152","2017-10-20",6,16,10,26,26,"Yes",4,6,9,7
"14153","2017-10-20",1,3,5,8,9,"Yes",3,2,2,1
"14154","2017-10-20",7,19,11,30,30,"No",5,6,8,11
"14155","2017-10-20",4,10,8,18,18,"Yes",4,4,6,4
"14156","2017-10-20",3,5,5,10,14,"No",2,3,2,3
"14157","2017-10-20",9,14,15,29,28,"Yes",7,8,6,8
"14158","2017-10-20",10,21,16,37,42,"No",9,7,11,10
"14159","2017-10-20",1,2,3,5,5,"Yes",2,1,1,1
"14160","2017-10-20",3,7,10,17,18,"No",6,4,3,4
"14161","2017-10-20",4,13,9,22,23,"No",5,4,7,6
"14162","2017-10-20",5,13,12,25,22,"Yes",9,3,6,7
"14163","2017-10-20",11,15,10,25,25,"No",5,5,8,7
"14164","2017-10-20",4,7,7,14,14,"No",2,5,4,3
"14165","2017-10-19",1,2,4,6,6,"Yes",3,1,1,1
"14166","2017-10-21",3,6,4,10,10,"Yes",3,1,3,3
"14167","2017-10-21",3,8,10,18,13,"Yes",1,9,3,5
"14168","2017-10-21",4,8,6,14,17,"Yes",1,5,5,3
"14169","2017-10-21",3,20,17,37,8,"No",12,5,8,12
"14170","2017-10-21",5,16,4,20,22,"Yes",1,3,9,7
"14171","2017-10-21",1,28,4,32,8,"Yes",NA,4,20,8
"14172","2017-10-28",4,7,7,14,21,"Yes",3,4,3,4
"14173","2017-10-21",3,6,9,15,16,"Yes",4,5,3,3
"14174","2017-10-21",2,7,1,8,10,"Yes",0,1,3,4
"14175","2017-10-21",2,5,3,8,9,"Yes",1,2,2,3
"14176","2017-10-21",1,2,1,3,3,"Yes",1,0,1,1
"14177","2017-10-21",4,12,6,18,19,"No",3,3,4,8
"14178","2017-10-21",4,10,2,12,13,"Yes",1,1,5,5
"14179","2017-10-21",6,13,2,15,15,"Yes",1,1,4,9
"14180","2017-10-23",NA,10,0,10,NA,"Yes",NA,NA,9,1
"14181","2017-10-23",NA,40,0,40,NA,"Yes",0,0,20,20
"14182","2017-10-23",NA,40,0,40,NA,"No",0,0,20,20
"14183","2017-10-23",NA,25,0,25,NA,"Yes",NA,NA,15,10
"14184","2017-10-23",5,9,1,10,10,"Yes",0,1,6,3
"14185","2017-10-23",NA,208,0,208,NA,"Yes",NA,NA,208,NA
"14186","2017-10-23",4,6,1,7,9,"No",0,1,2,4
"14187","2017-10-23",NA,6,130,136,NA,"No",55,75,3,3
"14188","2017-10-23",2,4,3,7,12,"Yes",3,0,2,2
"14189","2017-10-23",NA,8,90,98,NA,"Yes",30,60,5,3
"14190","2017-10-23",NA,250,250,500,NA,"No",100,150,100,150
"14191","2017-10-23",6,9,8,17,23,"Yes",7,1,3,6
"14192",NA,NA,402,52,454,NA,"No",22,30,102,300
"14193","2017-10-23",3,7,1,8,8,"Yes",0,1,4,3
"14194","2017-10-23",6,12,7,19,19,"Yes",3,4,6,6
"14195","2017-10-23",5,10,7,17,17,"Yes",3,4,5,5
"14196","2017-10-23",5,8,7,15,22,NA,1,6,4,4
"14197","2017-10-23",2,4,8,12,12,"Yes",4,4,2,2
"14198","2017-10-23",2,8,3,11,7,"Yes",3,0,5,3
"14199","2017-10-23",3,5,9,14,14,"Yes",4,5,2,3
"14200","2017-10-23",NA,0,0,0,NA,"No",NA,NA,NA,NA
"14201","2017-10-23",2,6,2,8,8,"No",0,2,2,4
"14202","2017-10-20",4,7,10,17,17,"Yes",6,4,2,5
"14203","2017-10-25",2,4,1,5,6,"Yes",1,0,1,3
"14204","2017-10-25",4,9,19,28,28,"No",7,12,5,4
"14205","2017-10-25",4,8,3,11,14,"No",0,3,4,4
"14206","2017-10-25",17,10,4,14,17,"Yes",2,2,5,5
"14207","2017-10-25",1,3,4,7,7,"Yes",3,1,1,2
"14208","2017-10-23",3,8,8,16,16,"Yes",2,6,4,4
"14209","2017-10-25",9,15,7,22,2,"No",4,3,9,6
"14210","2017-10-25",2,4,2,6,8,"Yes",1,1,2,2
"14211","2017-10-25",1,2,2,4,4,"Yes",1,1,1,1
"14212","2017-10-25",4,13,3,16,16,"Yes",0,3,7,6
"14213","2017-10-25",NA,9,200,209,NA,"Yes",75,125,2,7
"14214","2017-10-25",5,9,9,18,21,"Yes",5,4,5,4
"14215","2017-10-25",1,4,8,12,12,"Yes",4,4,1,3
"14216","2017-10-25",7,20,10,30,30,"Yes",6,4,9,11
"14217","2017-10-25",7,15,7,22,22,"Yes",4,3,8,7
"14218","2017-10-25",6,8,18,26,26,"Yes",6,12,2,6
"14219",NA,NA,3,256,259,NA,"Yes",150,106,2,1
"14220","2017-10-25",3,7,8,15,15,"Yes",4,4,4,3
"14221","2017-10-25",3,13,7,20,19,"Yes",4,3,7,6
"14222","2017-10-25",2,8,2,10,10,"No",1,1,5,3
"14223","2017-10-25",3,7,7,14,14,"Yes",1,6,4,3
"14224","2017-10-25",NA,8,180,188,NA,"Yes",80,100,2,6
"14225","2017-10-25",3,4,8,12,12,"Yes",3,5,2,2
"14226","2017-10-25",3,7,11,18,19,"Yes",7,4,3,4
"14227","2017-10-14",3,7,4,11,11,"Yes",1,3,4,3
"14228","2017-10-14",1,3,2,5,5,"Yes",2,NA,2,1
"14229","2017-10-19",3,11,4,15,15,"Yes",2,2,5,6
"14230","2017-10-25",4,5,7,12,12,"Yes",2,5,2,3
"14231","2017-10-26",2,4,4,8,6,"No",2,2,2,2
"14232","2017-10-26",NA,545,290,835,NA,"Yes",100,190,250,295
"14233","2017-10-26",2,6,4,10,10,"Yes",2,2,3,3
"14234","2017-10-26",2,7,4,11,11,"No",1,3,4,3
"14235","2017-10-26",NA,12,200,212,NA,"No",100,100,6,6
"14236","2017-10-26",1,2,5,7,7,"Yes",1,4,1,1
"14237","2017-10-26",NA,19,290,309,NA,"No",140,150,5,14
"14238","2017-10-26",3,6,8,14,17,"Yes",3,5,2,4
"14239","2017-10-26",5,11,6,17,17,"Yes",3,3,7,4
"14240","2017-10-26",2,6,4,10,10,"Yes",3,1,2,4
"14241","2017-10-26",7,10,10,20,20,"Yes",1,9,5,5
"14242","2017-10-27",3,5,3,8,8,"Yes",2,1,3,2
"14243","2017-10-27",2,7,3,10,10,"Yes",3,0,6,1
"14244","2017-10-27",8,15,11,26,28,"No",3,8,10,5
"14245","2017-10-27",7,13,10,23,23,"Yes",6,4,6,7
"14246","2017-10-27",5,19,9,28,29,"Yes",4,5,9,10
"14247","2017-10-27",10,19,14,33,32,"Yes",9,5,10,9
"14248","2017-10-27",NA,7,310,317,NA,"Yes",130,180,4,3
"14249","2017-10-27",3,8,10,18,17,"Yes",3,7,4,4
"14250","2017-10-27",4,7,7,14,14,"Yes",4,3,4,3
"14251","2017-10-27",3,8,5,13,12,"Yes",4,1,3,5
"14252","2017-10-27",6,12,16,28,28,"No",13,3,6,6
"14253","2017-10-27",2,4,5,9,9,"Yes",2,3,2,2
"14254","2017-10-27",4,7,5,12,12,"Yes",3,2,4,3
"14255","2017-10-27",NA,17,150,167,NA,"No",70,80,16,1
"14256","2017-10-27",2,6,2,8,8,"No",1,1,3,3
"14257","2017-10-27",6,10,8,18,18,"Yes",3,5,6,4
"14258","2017-10-27",2,5,10,15,14,"Yes",5,5,1,4
"14259","2017-10-27",4,8,4,12,12,"No",2,2,4,4
"14260","2017-10-27",1,2,3,5,5,"Yes",0,3,1,1
"14261","2017-10-27",2,9,10,19,19,"No",4,6,3,6
"14262",NA,3,8,3,11,12,"Yes",2,1,2,6
"14263","2017-10-27",2,4,4,8,8,"No",1,3,2,2
"14264","2017-10-27",1,1,3,4,4,"Yes",2,1,0,1
"14265","2017-10-27",4,11,11,22,22,"No",5,6,5,6
"14266","2017-10-27",NA,6,99,105,NA,"No",45,54,3,3
"14267","2017-10-27",NA,195,0,195,NA,"No",NA,NA,100,95
"14268","2017-10-27",6,13,11,24,24,"No",6,5,7,6
"14269","2017-10-27",4,8,3,11,13,"Yes",3,0,4,4
"14270","2017-10-27",3,7,11,18,19,"Yes",6,5,4,3
"14271","2017-10-19",2,7,7,14,14,"No",2,5,4,3
"14272","2017-10-30",1,4,4,8,8,"Yes",1,3,1,3
"14273","2017-10-30",NA,5,53,58,NA,"Yes",25,28,2,3
"14274","2017-10-30",2,4,2,6,6,"No",1,1,2,2
"14275","2017-10-30",3,4,7,11,11,"Yes",3,4,1,3
"14276","2017-10-30",2,5,3,8,7,"Yes",1,2,1,4
"14277","2017-10-30",6,12,10,22,22,"Yes",5,5,6,6
"14278","2017-10-30",1,3,2,5,5,NA,1,1,1,2
"14279","2017-10-30",2,6,6,12,12,"Yes",4,2,2,4
"14280","2017-10-30",2,5,6,11,10,"Yes",4,2,1,4
"14281","2017-10-30",7,14,12,26,28,"No",5,7,6,8
"14282","2017-10-30",2,4,2,6,6,"Yes",2,0,1,3
"14283","2017-10-30",3,6,9,15,15,"No",4,5,3,3
"14284","2017-10-30",3,8,6,14,15,"Yes",3,3,4,4
"14285","2017-10-27",2,4,2,6,6,"Yes",1,1,2,2
"14286","2017-10-31",5,10,10,20,20,"Yes",5,5,5,5
"14287","2017-10-31",4,7,5,12,12,"No",2,3,3,4
"14288","2017-10-30",3,6,11,17,19,"Yes",5,6,3,3
"14289","2017-10-31",NA,356,0,356,NA,"No",NA,NA,156,200
"14290","2017-10-31",12,20,23,43,42,"Yes",9,14,10,10
"14291","2017-10-31",NA,150,0,150,NA,"Yes",0,0,100,50
"14292","2017-10-31",1,4,4,8,8,"Yes",2,2,2,2
"14293","2017-10-31",2,5,4,9,9,"Yes",2,2,2,3
"14294","2017-10-31",2,6,1,7,7,"Yes",0,1,2,4
"14295","2017-10-31",2,4,2,6,6,"Yes",1,1,2,2
"14296","2017-10-31",1,2,0,2,2,"No",0,0,1,1
"14297","2017-10-31",7,15,8,23,23,"No",3,5,9,6
"14298","2017-10-31",3,7,3,10,10,"Yes",3,0,4,3
"14299","2017-10-31",2,5,1,6,6,"No",1,0,2,3
"14300","2017-11-01",2,5,2,7,7,"Yes",1,1,1,4
"14301","2017-11-01",1,3,1,4,4,"Yes",1,NA,2,1
"14302","2017-11-01",10,15,1,16,16,"No",1,0,10,5
"14303","2017-11-01",5,10,17,27,28,"Yes",4,13,5,5
"14304","2017-11-01",2,2,7,9,7,"No",3,4,1,1
"14305","2017-11-01",2,5,3,8,8,"No",2,1,4,1
"14306","2017-11-01",1,5,3,8,8,"Yes",2,1,1,4
"14307","2017-11-01",NA,110,0,110,NA,"Yes",NA,NA,50,60
"14308","2017-11-01",6,9,7,16,16,"No",3,4,4,5
"14309","2017-11-01",2,6,3,9,9,NA,2,1,4,2
"14310","2017-10-31",3,6,3,9,9,"Yes",2,1,4,2
"14311","2017-11-01",2,2,1,3,3,"No",NA,1,1,1
"14312","2017-11-01",1,5,3,8,8,"Yes",0,3,2,3
"14313","2017-11-01",1,2,4,6,6,"Yes",1,3,1,1
"14314","2017-11-01",3,6,6,12,12,"Yes",4,2,3,3
"14315","2017-11-01",1,3,4,7,6,"Yes",1,3,1,2
"14316","2017-10-31",2,7,13,20,20,"Yes",4,9,5,2
"14317","2017-11-01",5,11,10,21,21,"Yes",5,5,5,6
"14318","2017-11-01",4,7,4,11,11,"Yes",1,3,4,3
"14319","2017-11-01",1,4,3,7,7,"Yes",1,2,3,1
"14320","2017-11-01",2,7,2,9,9,"Yes",1,1,2,5
"14321","2017-11-01",5,10,15,25,20,"Yes",5,10,5,5
"14322","2017-11-01",2,10,10,20,20,"Yes",4,6,5,5
"14323","2017-11-01",3,12,3,15,15,"No",0,3,7,5
"14324","2017-11-02",1,3,5,8,8,"Yes",2,3,1,2
"14325","2017-11-02",2,4,5,9,9,"Yes",1,4,0,4
"14326","2017-11-02",8,16,14,30,30,"Yes",7,7,8,8
"14327","2017-11-02",3,5,9,14,14,"Yes",5,4,3,2
"14328","2017-11-02",2,4,5,9,9,"No",3,2,2,2
"14329","2017-11-02",NA,19,320,339,NA,"No",150,170,10,9
"14330","2017-11-02",1,2,1,3,3,"Yes",1,0,1,1
"14331","2017-11-02",2,5,4,9,9,"Yes",3,1,1,4
"14332","2017-11-03",2,2,10,12,12,"Yes",4,6,1,1
"14333","2017-11-03",1,3,1,4,4,"Yes",1,0,0,3
"14334","2017-11-03",6,13,7,20,20,"No",4,3,6,7
"14335","2017-11-03",3,6,7,13,13,"Yes",2,5,3,3
"14336","2017-11-03",2,6,4,10,9,"No",2,2,3,3
"14337","2017-11-03",NA,80,0,80,NA,"No",NA,NA,78,2
"14338","2017-11-03",1,4,4,8,8,"Yes",2,2,2,2
"14339","2017-11-03",1,6,5,11,11,"Yes",4,1,3,3
"14340","2017-11-03",4,10,9,19,19,"Yes",4,5,4,6
"14341","2017-11-04",NA,13,8,21,NA,"Yes",2,6,8,5
"14342","2017-11-04",NA,14,15,29,NA,"Yes",12,3,8,6
"14343","2017-11-04",NA,20,16,36,NA,"Yes",4,12,11,9
"14344","2017-11-04",2,6,8,14,15,"Yes",5,3,2,4
"14345","2017-11-04",1,4,4,8,9,"Yes",2,2,3,1
"14346","2017-11-06",3,7,5,12,12,"Yes",3,2,4,3
"14347","2017-11-06",NA,0,0,0,NA,"No",NA,NA,NA,NA
"14348","2017-11-07",4,7,13,20,20,"Yes",5,8,3,4
"14349","2017-11-07",1,6,3,9,8,"Yes",2,1,2,4
"14350","2017-11-07",1,2,12,14,6,"Yes",6,6,1,1
"14351","2017-11-06",2,6,6,12,12,"No",2,4,4,2
"14352","2017-11-07",3,8,5,13,13,"No",5,0,4,4
"14353","2017-11-08",2,5,3,8,8,"No",2,1,2,3
"14354","2017-11-08",4,11,7,18,18,"Yes",4,3,4,7
"14355","2017-11-08",1,2,3,5,1,"Yes",2,1,1,1
"14356","2017-11-08",NA,2,40,42,NA,"Yes",25,15,1,1
"14357","2017-11-08",1,3,6,9,9,"No",4,2,1,2
"14358","2017-11-09",4,7,2,9,9,"Yes",2,0,4,3
"14359","2017-11-09",1,4,2,6,6,"No",1,1,2,2
"14360","2017-11-09",1,4,6,10,10,"No",2,4,2,2
"14361","2017-11-09",3,8,7,15,15,"Yes",4,3,3,5
"14362","2017-11-09",1,4,0,4,4,"Yes",0,0,4,0
"14363","2017-11-10",1,3,5,8,8,"No",2,3,1,2
"14364","2017-11-10",4,11,9,20,24,"Yes",4,5,4,7
"14365","2017-11-13",4,8,2,10,9,"No",0,2,4,4
"14366","2017-11-13",1,2,0,2,2,"Yes",0,0,1,1
"14367","2017-11-13",4,8,13,21,21,"Yes",4,9,4,4
"14368","2017-11-13",5,8,6,14,14,"Yes",3,3,3,5
"14369","2017-11-13",NA,27,164,191,NA,"No",64,100,17,10
"14370","2017-11-13",4,8,5,13,13,"Yes",3,2,4,4
"14371","2017-11-13",3,9,12,21,19,"Yes",3,9,5,4
"14372","2017-11-13",9,22,15,37,NA,"No",7,8,12,10
"14373","2017-11-13",4,8,7,15,16,"Yes",3,4,4,4
"14374","2017-11-13",6,13,14,27,27,"Yes",7,7,5,8
"14375","2017-11-14",8,14,10,24,24,"Yes",6,4,8,6
"14376","2017-11-14",4,9,5,14,14,"Yes",2,3,4,5
"14377","2017-11-14",4,0,0,0,11,"Yes",NA,NA,NA,NA
"14378","2017-11-14",2,5,5,10,10,"Yes",1,4,3,2
"14379","2017-11-14",3,6,14,20,22,"No",6,8,3,3
"14380","2017-11-14",2,5,7,12,12,"Yes",3,4,2,3
"14381","2017-11-14",3,9,6,15,15,"Yes",3,3,6,3
"14382","2017-11-15",1,3,0,3,3,"Yes",NA,NA,2,1
"14383","2017-11-15",3,4,4,8,9,"Yes",3,1,2,2
"14384","2017-11-15",NA,6,67,73,NA,"Yes",30,37,1,5
"14385","2017-11-15",3,12,6,18,18,"Yes",4,2,4,8
"14386","2017-11-15",5,8,3,11,11,"Yes",1,2,4,4
"14387","2017-11-15",NA,12,275,287,NA,"Yes",160,115,6,6
"14388","2017-11-15",4,10,4,14,14,"Yes",1,3,4,6
"14389","2017-11-16",7,10,7,17,13,"Yes",3,4,6,4
"14390","2017-11-16",2,6,4,10,10,"Yes",3,1,3,3
"14391","2017-11-16",4,6,7,13,13,"Yes",3,4,3,3
"14392","2017-11-16",1,3,5,8,8,"Yes",2,3,1,2
"14393","2017-11-02",3,6,8,14,14,"Yes",5,3,3,3
"14394","2017-11-07",6,0,0,0,24,"Yes",NA,NA,NA,NA
"14395","2017-11-01",5,11,8,19,19,"Yes",4,4,5,6
"14396","2017-11-09",5,9,10,19,19,"Yes",3,7,5,4
"14397","2017-10-20",3,7,5,12,12,"Yes",2,3,3,4
"14398","2017-10-31",1,3,0,3,3,"Yes",0,0,2,1
"14399","2017-11-09",1,3,2,5,5,"Yes",1,1,1,2
"14400","2017-11-08",4,9,8,17,17,"Yes",4,4,3,6
"14401","2017-11-07",3,8,6,14,14,"Yes",4,2,3,5
"14402","2017-11-01",7,0,0,0,29,"Yes",NA,NA,NA,NA
"14403","2017-11-09",1,2,3,5,5,"Yes",0,3,1,1
"14404","2017-03-21",NA,13,300,313,NA,"No",120,180,6,7
"14405","2017-03-22",NA,7,5,12,NA,"No",2,3,4,3
"14406","2017-03-22",5,18,9,27,23,"No",6,3,9,9
"14407","2017-03-22",NA,176,55,231,NA,"No",25,30,98,78
"14408","2017-03-23",5,10,13,23,26,"No",7,6,5,5
"14409","2017-03-23",6,13,15,28,30,"Yes",5,10,6,7
"14410","2017-03-23",12,24,11,35,41,"No",5,6,12,12
"14411","2017-03-23",11,11,7,18,21,"Yes",1,6,5,6
"14412","2017-03-24",6,18,13,31,37,"Yes",6,7,9,9
"14413","2017-03-23",9,14,4,18,18,"Yes",2,2,9,5
"14414","2017-03-25",NA,10,408,418,NA,"Yes",180,228,3,7
"14415","2017-03-27",NA,270,180,450,NA,"No",80,100,120,150
"14416","2017-03-28",6,10,11,21,21,"Yes",6,5,4,6
"14417","2017-03-29",NA,1150,450,1600,NA,"Yes",200,250,500,650
"14418","2017-03-29",3,8,15,23,23,"Yes",7,8,5,3
"14419","2017-03-30",10,15,8,23,23,"Yes",5,3,5,10
"14420","2017-03-30",15,33,21,54,NA,"Yes",12,9,18,15
"14421","2017-03-31",NA,35,0,35,NA,NA,0,0,15,20
"14422","2017-04-01",6,12,6,18,NA,"Yes",4,2,7,5
"14423","2017-04-03",7,14,11,25,NA,"No",2,9,7,7
"14424","2017-04-03",NA,65,5974,6039,NA,"No",2971,3003,6,59
"14425","2017-04-03",3,10,4,14,NA,"Yes",2,2,3,7
"14426","2017-04-03",3,6,9,15,15,"No",4,5,3,3
"14427","2017-04-04",7,14,25,39,29,"No",13,12,7,7
"14428","2017-04-04",9,15,20,35,35,"Yes",10,10,5,10
"14429","2017-04-04",1,3,3,6,6,"Yes",2,1,2,1
"14430","2017-04-04",10,26,26,52,58,"Yes",11,15,10,16
"14431","2017-04-05",5,15,10,25,25,"Yes",4,6,5,10
"14432","2017-04-06",6,12,8,20,34,"Yes",6,2,6,6
"14433","2017-04-06",10,20,29,49,45,"Yes",13,16,10,10
"14434","2017-04-06",NA,280,0,280,NA,"Yes",0,0,200,80
"14435","2017-04-06",7,14,31,45,45,"No",16,15,7,7
"14436","2017-04-06",9,18,16,34,24,"No",8,8,7,11
"14437","2017-04-07",7,16,11,27,24,"Yes",6,5,7,9
"14438","2017-04-07",NA,55,15,70,NA,"No",5,10,10,45
"14439","2017-04-04",5,10,9,19,19,"No",3,6,5,5
"14440","2017-04-07",8,21,15,36,36,"Yes",7,8,10,11
"14441","2017-04-07",6,14,13,27,27,"Yes",5,8,7,7
"14442","2017-04-08",9,18,4,22,22,"Yes",1,3,12,6
"14443","2017-04-08",6,10,13,23,23,"Yes",5,8,5,5
"14444","2017-04-08",6,13,23,36,40,"No",2,21,8,5
"14445","2017-04-08",8,16,32,48,48,"No",12,20,8,8
"14446","2017-04-08",6,12,8,20,20,"Yes",2,6,5,7
"14447","2017-04-08",4,7,9,16,16,"Yes",2,7,2,5
"14448","2017-04-10",NA,18,110,128,NA,"Yes",50,60,10,8
"14449","2017-04-11",6,14,6,20,30,"Yes",3,3,7,7
"14450","2017-04-11",12,10,20,30,30,"Yes",8,12,4,6
"14451","2017-04-11",16,22,13,35,45,"Yes",5,8,10,12
"14452","2017-04-11",NA,300,85,385,NA,"No",40,45,130,170
"14453","2017-04-14",15,29,16,45,45,"No",9,7,14,15
"14454","2017-04-14",10,16,10,26,NA,"Yes",7,3,10,6
"14455","2017-04-17",10,25,11,36,36,"Yes",6,5,10,15
"14456","2017-04-17",2,5,2,7,7,"Yes",1,1,3,2
"14457","2017-04-18",8,13,17,30,30,"Yes",8,9,7,6
"14458","2017-04-18",NA,19,540,559,NA,"Yes",250,290,8,11
"14459","2017-04-19",NA,17,8193,8210,NA,"No",2561,5632,8,9
"14460","2017-10-13",NA,2,7,9,NA,"No",1,6,1,1
"14461","2017-10-14",5,11,10,21,21,"Yes",4,6,5,6
"14462","2017-10-14",9,19,26,45,45,"Yes",14,12,9,10
"14463","2017-10-14",7,17,14,31,31,"Yes",6,8,7,10
"14464","2017-10-16",NA,393,76,469,NA,"Yes",45,31,183,210
"14465","2017-10-16",6,15,10,25,25,"Yes",4,6,7,8
"14466","2017-10-16",3,10,8,18,20,"Yes",1,7,4,6
"14467","2017-10-16",NA,295,80,375,NA,"No",30,50,125,170
"14468","2017-10-16",9,26,27,53,50,"Yes",12,15,8,18
"14469","2017-10-17",6,10,5,15,20,"Yes",3,2,5,5
"14470","2017-10-17",3,4,6,10,10,"Yes",1,5,2,2
"14471","2017-10-17",NA,7,0,7,NA,"No",0,0,4,3
"14472","2017-10-17",NA,0,0,0,NA,"Yes",NA,NA,NA,NA
"14473","2017-10-17",3,5,4,9,9,"Yes",2,2,3,2
"14474","2017-10-17",5,13,10,23,23,"No",6,4,4,9
"14475","2017-10-14",5,7,13,20,20,"No",9,4,2,5
"14476","2017-10-18",5,8,9,17,17,"Yes",3,6,5,3
"14477","2017-10-19",2,7,5,12,12,"Yes",2,3,4,3
"14478","2017-10-19",9,17,16,33,33,"Yes",8,8,8,9
"14479","2017-10-20",6,13,6,19,17,"Yes",2,4,4,9
"14480","2017-10-20",6,13,14,27,29,"Yes",5,9,6,7
"14481","2017-10-20",2,9,4,13,13,"Yes",2,2,4,5
"14482","2017-10-20",4,10,8,18,18,"Yes",4,4,6,4
"14483",NA,NA,402,52,454,NA,"No",22,30,102,300
"14484",NA,NA,3,256,259,NA,"Yes",150,106,2,1
"14485","2017-10-25",3,4,8,12,12,"Yes",3,5,2,2
"14486","2017-10-14",3,7,4,11,11,"Yes",1,3,4,3
"14487","2017-10-19",3,11,4,15,15,"Yes",2,2,5,6
"14488","2017-10-26",NA,545,290,835,NA,"Yes",100,190,250,295
"14489","2017-10-26",3,6,8,14,17,"Yes",3,5,2,4
"14490","2017-10-26",7,10,10,20,20,"Yes",1,9,5,5
"14491","2017-10-27",2,4,5,9,9,"Yes",2,3,2,2
"14492","2017-10-27",NA,17,150,167,NA,"No",70,80,16,1
"14493","2017-10-27",2,6,2,8,8,"No",1,1,3,3
"14494",NA,3,8,3,11,12,"Yes",2,1,2,6
"14495","2017-10-27",NA,6,99,105,NA,"No",45,54,3,3
"14496","2017-10-27",NA,195,0,195,NA,"No",NA,NA,100,95
"14497","2017-10-30",NA,5,53,58,NA,"Yes",25,28,2,3
"14498","2017-10-30",7,14,12,26,28,"No",5,7,6,8
"14499","2017-10-31",5,10,10,20,20,"Yes",5,5,5,5
"14500","2017-10-31",NA,356,0,356,NA,"No",NA,NA,156,200
"14501","2017-10-31",7,15,8,23,23,"No",3,5,9,6
"14502","2017-11-01",10,15,1,16,16,"No",1,0,10,5
"14503","2017-11-01",5,11,10,21,21,"Yes",5,5,5,6
"14504","2017-11-02",NA,19,320,339,NA,"No",150,170,10,9
"14505","2017-11-04",NA,13,8,21,NA,"Yes",2,6,8,5
"14506","2017-11-04",NA,14,15,29,NA,"Yes",12,3,8,6
"14507","2017-11-09",1,4,6,10,10,"No",2,4,2,2
"14508","2017-11-13",NA,27,164,191,NA,"No",64,100,17,10
"14509","2017-11-15",NA,12,275,287,NA,"Yes",160,115,6,6
"14510","2017-11-01",7,0,0,0,29,"Yes",NA,NA,NA,NA
